diekkáraš	diekkárasj	pron
duobbá% dábbá	duobbá% dábbá	pron
galládat	galládat	pron
iešgiinai	iesjgijnaj	pron
iešguhtege	iesjguhtege	pron
iešguhtenai	iesjguhtenaj	pron
iešguhtet	iesjguhtet	pron
makkáraš	makkárasj	pron
miinai	mijnaj	pron
moanat	månat	pron
ol0lus	ål0lus	pron
ollut	ållut	pron
olus	ålus	pron
olut	ålut	pron
seammahat	siemmahat	pron
soa0mes	soa0mes	pron
uhccán	uhttsán	pron
uhccánaš	uhttsánasj	pron
unnán	unnán	pron
veháš	vehásj	pron
váháš	váhásj	pron
