abai	abáj	pcle
ahteson	ahteson	pcle
aitto	ajto	pcle
almma	alma	pcle
ama	ama	pcle
amal	amál	pcle
amat	amát	pcle
amma	amma	pcle
ammahal	ammahal	pcle
ammahan	ammahan	pcle
ammal	ammal	pcle
ammat	ammat	pcle
ammes	ammes	pcle
appason	appason	pcle
ba	ba	pcle
ban	ban	pcle
bat	bat	pcle
eaigga	iejga	pcle
eiddo	ejdo	pcle
eigga	ejga	pcle
eitto	ejto	pcle
galahal	galáhal	pcle
galahan	galáhan	pcle
galhal	galhal	pcle
ge	ge	pcle
ges	ges	pcle
gis	gis	pcle
goit	gåjt	pcle
goittot	gåjtut	pcle
goittotge	gåjtutge	pcle
got	gåt	pcle
hás	hás	pcle
hal	hal	pcle
han	han	pcle
