guhkkit	guhkket	adv
accasit	attsaset	adv
ađđamahttá	addamahttá	adv
agibeaivvesge	agebeajvvesge	adv
agibeaivvisge	agebeajvvisge	adv
agibeaivái	agebeajváj	adv
agibeaivvi	agebeajvve	adv
agálaččat	agálattjat	adv
ahkásii	ahkásij	adv
aiddo	ajdo	adv
aiddobeliid	ajdubelijd	adv
aiddobáliid	ajdubálijd	adv
aiddonassii	ajdunassij	adv
aiddostassii	ajdustassij	adv
aittoládje	ajtuládje	adv
aittobáliid	ajtubálijd	adv
aittonassii	ajtunassij	adv
aivvefal	ajvefal	adv
aivvestassii	ajvestassij	adv
aivvo	ajvo	adv
ok	åk	adv
aktiivvalaččat	aktijvvalattjat	adv
albmaáimmus	almmaájmus	adv
albmaáimmus	almmaájmus	adv
alddage	aldage	adv
alibuččas	alebuttjas	adv
alibuidda	alebujdda	adv
alibus	alebus	adv
alibužžii	alebudtjij	adv
alimahtes	alemahtes	adv
alitsidjii	aletsidjij	adv
allagassii	allagassij	adv
allagit	allaget	adv
allelačča	allelattja	adv
allelaččat	allelattjat	adv
allelažžii	alleladtjij	adv
allelebbui	allelebbuj	adv
allelii	allelij	adv
alleliidda	allelijdda	adv
allelis	alleles	adv
allil	allel	adv
allin	allen	adv
allugit	alluget	adv
almmaide	almajde	adv
almmatge	almatge	adv
almmake	almake	adv
almmotge	almutge	adv
almmustaga	almustaga	adv
almmá	almá	adv
altteson	alteson	adv
aŋaldagas	aŋáldagas	adv
aŋaldatbajis	aŋáldatbajes	adv
aŋkke	aŋke	adv
arvat	arvvat	adv
arvvoóit	arvoójt	adv
asehisgerddiid	asehisgerddijd	adv
askálagaid	asskálagajd	adv
assájit	assájet	adv
assálagaid	assálagajd	adv
asu	aso	adv
bárralagaid	bárralagajd	adv
atti	atte	adv
bađalassii	badálassij	adv
badjebadjelii	badjebadjelij	adv
badjebadjálagaid	badjebadjálagajd	adv
badjelmeari	badjelmeare	adv
badjelabbui	badjelabbuj	adv
badjelačča	badjelattja	adv
badjelaččas	badjelattjas	adv
badjelažžii	badjeladtjij	adv
badjelebbui	badjelebbuj	adv
badjelii	badjelij	adv
badjeliidda	badjelijdda	adv
badjelis	badjeles	adv
badjelit	badjelet	adv
badjelmearálaččat	badjelmearálattjat	adv
badjeloaivve	badjeloajvve	adv
badjil	badjel	adv
badjin	badjen	adv
badjugassii	badjugassij	adv
badjálagaid	badjálagajd	adv
baholagaid	bahulagajd	adv
bahuid	bahujd	adv
bahuin	bahujn	adv
baháláhkai	baháláhkaj	adv
baica	bajttsa	adv
baicca	bajtsa	adv
baicce	bajtse	adv
baifáhkka	bajffáhkka	adv
baikana	bajkkana	adv
baikanaga	bajkkanaga	adv
bajil	bajel	adv
bajiloaivvi	bajeloajvve	adv
bajibučča	bajebuttja	adv
bajibuččas	bajebuttjas	adv
bajibuin	bajebujn	adv
bajibus	bajebus	adv
bajibužžii	bajebudtjij	adv
bajábeallai	bajábeallaj	adv
bajágeahčai	bajágeahtjaj	adv
bajágeahčen	bajágeahtjen	adv
bajágeaže	bajágeatje	adv
bajásguvlui	bajásguvluj	adv
bajásjulggiid	bajásjulggijd	adv
baljo	baljjo	adv
bastanta	basstanta	adv
bastánta	basstánta	adv
beaitta	biejta	adv
beaiveguovdil	biejvveguovdel	adv
beaivemáhce	biejvvemáhtse	adv
beaivet	biejvvet	adv
beaivváhala	bæjváhala	adv
beaivválaččat	bæjválattjat	adv
bealatkeahttá	bielatkeahttá	adv
beald	bield	adv
beallalaga	biellalaga	adv
beallalagaid	biellalagajd	adv
bealledagus	bielledagus	adv
bealledahkui	bielledahkuj	adv
beallegealdagis	biellegealdages	adv
beallehaddái	biellehaddáj	adv
bealleheakkas	bielleheakkas	adv
bealleheggii	bielleheggij	adv
beallejámas	biellejámas	adv
beallenuvttá	biellenuvttá	adv
beallešaddui	bielletjadduj	adv
beallešattus	bielletjattus	adv
beallestággui	biellestágguj	adv
beallestákkus	biellestákkus	adv
beallevearta	biellevearta	adv
bealljeskaddariid	bielljeskaddarijd	adv
beallálaga	bællálaga	adv
beallálagaid	bællálagajd	adv
bealát	bælát	adv
beanta	bientta	adv
beare	biere	adv
bearehaga	bierehaga	adv
bearrái	bærráj	adv
beatnagahttá	biednagahttá	adv
beavddibui	bievdebuj	adv
beavddibuidda	bievdebujdda	adv
beavddibus	bievdebus	adv
beavddimusas	bievdemusas	adv
beavddimussii	bievdemussij	adv
beavdelaččas	bievddelattjas	adv
beavdelažžii	bievddeladtjij	adv
beavdeleappos	bievddeleappos	adv
beavdelebbui	bievddelebbuj	adv
beavdelii	bievddelij	adv
beavdeliidda	bievddelijdda	adv
beavdelis	bievddeles	adv
beavžžabealde	bievtjabealde	adv
beavžžabeale	bievtjabeale	adv
beallemuttus	biellemuttus	adv
bellolagaid	bellulagajd	adv
belohahkii	beluhahkij	adv
belos	belus	adv
bessejassii	bessejassij	adv
bevnnot	bevnut	adv
biđgolagaid	birggulagajd	adv
bieđđogárremiidda	bieddugárremijdda	adv
bieđđogárremiin	bieddugárremijn	adv
bieđgguid	biergujd	adv
bieggaráigge	bieggarájgge	adv
biehčamahttá	biehtjamahttá	adv
biergonaga	bierggunaga	adv
bikšut	biksjut	adv
bilkkul	bilkul	adv
binnoš	binnusj	adv
binnánaš	binnánasj	adv
binnážiidda	binnátjijdda	adv
birolaččat	birulattjat	adv
biroláhkai	biruláhkaj	adv
birrabonjil	birrabonjel	adv
birračáhcái	birratjáhtsáj	adv
birračázis	birratjátses	adv
birrageavlái	birrageavláj	adv
birrajagi	birrajage	adv
birrajagiid	birrajagijd	adv
birrajorbalassii	birrajorbalassij	adv
birrajorbodahkii	birrajorbodahkij	adv
birralis	birrales	adv
birrasii	birrasij	adv
birrasit	birraset	adv
birzzeoasat	birtseoasat	adv
birzzit	birtset	adv
biššos	bissjus	adv
bivdinmađe	bivddenmade	adv
bivššil	bivsjel	adv
boaittobealde	boajtubealde	adv
boaittobeale	boajtubeale	adv
boaittobeallai	boajtubeallaj	adv
boakkil	boakkel	adv
boalččil	boaltjel	adv
boarásmanbeaivái	boarásmanbeajváj	adv
boarástunbeaivái	boarástunbeajváj	adv
boaššolačča	boassjulattja	adv
boaššolaččas	boassjulattjas	adv
boaššolažžii	boassjuladtjij	adv
boaššoleappos	boassjuleappos	adv
boaššolebbui	boassjulebbuj	adv
boaššolii	boassjulij	adv
boaššoliidda	boassjulijdda	adv
boaššolis	boassjules	adv
boaššul	boassjul	adv
boasttogežiid	boastugetjijd	adv
boastut	boasstut	adv
boatnjáš	boadnjásj	adv
boađi-boađi	boadi-boade	adv
bođđolagaid	båddulagajd	adv
bođohagaid	båduhagajd	adv
bođuid	bådujd	adv
bodnelačča	båddnelattja	adv
bodnelaččas	båddnelattjas	adv
bodnelažžii	båddneladtjij	adv
bodnelii	båddnelij	adv
bodneliidda	båddnelijdda	adv
bodnelis	båddneles	adv
bodnil	båddnel	adv
bogil	bågel	adv
bolkolagaid	bålkkulagajd	adv
bonjil	bånjel	adv
borrančalbmái	bårråntjalmmáj	adv
borranlanjas	bårrånlanjas	adv
boššobealde	båssjubealde	adv
boššobeale	båssjubeale	adv
boššobeallai	båssjubeallaj	adv
boššolii	båssjulij	adv
boššoliidda	båssjulijdda	adv
boššolis	båssjules	adv
botnibui	bådnebuj	adv
botnibuidda	bådnebujdda	adv
botnibus	bådnebus	adv
botnješ	bådnjesj	adv
botnjut	bådnjut	adv
buđđosii	buddusij	adv
buđđosis	budduses	adv
buhtismeahttusit	buhtesmeahttuset	adv
buncut	bunttsut	adv
buođđagasas	buoddagasas	adv
buođđagassii	buoddagassij	adv
buohkanassii	buohkanassij	adv
buohtalagaid	buohtalagajd	adv
buokčagasas	buoktjagasas	adv
buokčagassii	buoktjagassij	adv
buorbot	buorbbut	adv
buorot	buorut	adv
buoril	buorel	adv
buorremealgadii	buorremealgadij	adv
buošágit	buotjáget	adv
buresláhkai	buresláhkaj	adv
báđus	bádus	adv
báhcigassii	báhtsegassij	adv
báhcimassii	báhtsemassij	adv
báhtui	báhtuj	adv
báidegerddiid	bájddegerddijd	adv
báidelanjas	bájddelanjas	adv
báidelatnjii	bájddelatnjij	adv
báifáhkka	bájffáhkka	adv
báikkohagaid	bájkuhagajd	adv
báikkuid	bájkujd	adv
báikkálaččat	bájkálattjat	adv
bálbálddalagaid	bálbbálddalagajd	adv
báldal	bálldal	adv
báldalagaid	bálldalagajd	adv
báldda	bálda	adv
bálddaid	báldajd	adv
bálddalaga	báldalaga	adv
bálddalagaid	báldalagajd	adv
bálddalasjulggiid	báldalasjulggijd	adv
bálddas	báldas	adv
bálddoalgái	báldoalgáj	adv
bálggesráigge	bálgesrájgge	adv
báljo	báljjo	adv
bálloguotti	bálluguotte	adv
bárrahii	bárrahij	adv
bárrahiin	bárrahijn	adv
bárrahis	bárrahes	adv
bártneš	bárnesj	adv
bátnegáskki	bádnegáske	adv
bážas	bátjás	adv
čađa	tjada	adv
čađat	tjadát	adv
čahpunaga	tjahpunaga	adv
čahpunassii	tjahpunassij	adv
čakčačoavjjis	tjaktjatjoavjjes	adv
čakčat	tjaktjat	adv
čalbmegeaiddi	tjalmmegeajdde	adv
čalbmegeaiddus	tjalmmegeajddus	adv
čalbmehálgui	tjalmmehálguj	adv
čalbmeráigge	tjalmmerájgge	adv
čalmmineahkamis	tjalmeneahkames	adv
čalmmálassii	tjalmálassij	adv
čalmmát	tjalmát	adv
časkkát	tjaskát	adv
čavččabealde	tjavtjabealde	adv
čavččabeallai	tjavtjabeallaj	adv
čavga	tjavgga	adv
čeagŋut	tjieggŋut	adv
čeahpálagaid	tjæhpálagajd	adv
čearggosdávttiid	tjiergusdávttijd	adv
čearssil	tjiersel	adv
čeavládit	tjævlládet	adv
čeavlájit	tjævllájet	adv
čezeš	tjetsesj	adv
čieđus	tjiedus	adv
čiegal	tjiegal	adv
čiehkagasas	tjiehkagasas	adv
čiekŋalabbui	tjiegŋalabbuj	adv
čiekŋalasas	tjiegŋalasas	adv
čielga	tjielgga	adv
čielggosnaga	tjielgusnaga	adv
čieročalbmái	tjierutjalmmáj	adv
čihččii	tjihttjij	adv
čikŋagasas	tjigŋagasas	adv
čikŋagassii	tjigŋagassij	adv
čikŋosis	tjigŋuses	adv
čiktagasas	tjiktagasas	adv
čiktagassii	tjiktagassij	adv
čiktasii	tjiktasij	adv
čiktasis	tjiktases	adv
čillil	tjillel	adv
čipperájes	tjipperájes	adv
čirssil	tjirsel	adv
čoahki	tjoahke	adv
čoahkis	tjoahkes	adv
čoahkkái	tjoahkkáj	adv
čoalmmil	tjoalmel	adv
čohkal	tjåhkål	adv
čohkalassii	tjåhkålassij	adv
čohkut	tjåhkut	adv
čomal	tjåmål	adv
čomastahkii	tjåmåstahkij	adv
čomil	tjåmel	adv
čorga	tjårggå	adv
čorpmadievva	tjårmådievva	adv
njálmmedievva	njálmedievva	adv
čorrut	tjårrut	adv
čoruid	tjårujd	adv
čorul	tjårul	adv
čuččot	tjuttjut	adv
čuidnut	tjujnnut	adv
čulle	tjulle	adv
čuoččat	tjuottjat	adv
čuohteveardde	tjuohteveardde	adv
čuollut	tjuollut	adv
čuožžut	tjuodtjut	adv
čálalaččat	tjálálattjat	adv
čálihussii	tjálehussij	adv
čállatbokte	tjállatbokte	adv
čállosupmái	tjállusupmáj	adv
čárvvočalmmiid	tjárvutjalmijd	adv
caggagasas	tsaggagasas	adv
caggagassii	tsaggagassij	adv
caggasii	tsaggasij	adv
caggasis	tsaggases	adv
caggut	tsaggut	adv
cakkasnjálmme	tsakkasnjálme	adv
cakkasnjálmmiid	tsakkasnjálmijd	adv
ceaggut	tsieggut	adv
ceahkkálagaid	tsæhkkálagajd	adv
ceahkkásii	tsæhkkásij	adv
ceahkkásis	tsæhkkáses	adv
cikkil	tsikkel	adv
cikkilmasat	tsikkelmasat	adv
cikkit	tsikket	adv
cirkkil	tsirkel	adv
coahkásit	tsoahkáset	adv
cuoccit	tsuottset	adv
curbmut	tsurmmut	adv
curpmil	tsurmel	adv
dabbelaš	dabbelasj	adv
dabbelii	dabbelij	adv
dabbelis	dabbeles	adv
dabbil	dabbel	adv
dađe	dade	adv
dađi	dade	adv
dađibahábut	dadebahábut	adv
dađis	dades	adv
dađistaga	dadestaga	adv
daiggo	dajgo	adv
daigo	dajggo	adv
dainna	dajna	adv
dainnalágiin	dajnalágijn	adv
dáinnalágiin	dájnalágijn	adv
dainnánaga	dajnánaga	adv
dakkaviđe	dakkavide	adv
dakkaviđi	dakkavide	adv
daninassii	danenassij	adv
dappil	dappel	adv
daška	dassjka	adv
dasalassin	dasálassen	adv
dassái	dassáj	adv
dassážii	dassátjij	adv
dassážiidda	dassátjijdda	adv
dassážis	dassátjes	adv
daste	dasste	adv
dasto	dassto	adv
dastožii	dasstutjij	adv
dasttá	dastá	adv
dasttán	dastán	adv
dasttánaga	dastánaga	adv
davibui	davebuj	adv
davibuidda	davebujdda	adv
davibuin	davebujn	adv
davibus	davebus	adv
davil	davel	adv
davvelačča	davvelattja	adv
davvelaččas	davvelattjas	adv
davvelažžii	davveladtjij	adv
davvelebbui	davvelebbuj	adv
davveleppožii	davveleppotjij	adv
davveleppožis	davveleppotjes	adv
davvelii	davvelij	adv
davveliidda	davvelijdda	adv
davvelis	davveles	adv
davvelit	davvelet	adv
davvenuortin	davvenuorten	adv
davveoarjin	davveoarjen	adv
davvil	davvel	adv
davvin	davven	adv
davvinnuortan	davvennuortan	adv
davvinoarjin	davvenoarjen	adv
davábeallai	davábeallaj	adv
davágeahčai	davágeahtjaj	adv
davágeahčen	davágeahtjen	adv
davágeaže	davágeatje	adv
deahtta	diehtta	adv
deaivása	dæjvvása	adv
dearpamassii	dierppamassij	adv
dearvan	diervvan	adv
deatnoráigge	diednurájgge	adv
deavddihussii	dievdehussij	adv
degomat	degumat	adv
dehal	dehál	adv
deike	dejkke	adv
deikke	dejke	adv
desto	dessto	adv
diebbelaš	diebbelasj	adv
diebbelii	diebbelij	adv
diebbeliidda	diebbelijdda	adv
diebbelis	diebbeles	adv
diebbil	diebbel	adv
dieđinge	diedenge	adv
dieđun	diedun	adv
dieđus	diedus	adv
dieđusge	diedusge	adv
diedoppe	dieduppe	adv
die-doppe	die-dåppe	adv
doppe	dåppe	adv
diehpil	diehpel	adv
diehtevassii	diehtevassij	adv
diehttavassii	diehttavassij	adv
diehttevassii	diehttevassij	adv
dieiggo	diejgo	adv
dieinnalágiin	diejnalágijn	adv
dieinnán	diejnán	adv
dieinnánaga	diejnánaga	adv
dieppit	dieppet	adv
dieppil	dieppel	adv
dieppimustá	dieppemustá	adv
diesttánaga	diestánaga	adv
diibmoviissaid	dijmmuvijssajd	adv
diibmá	dijmmá	adv
diimmuhala	dijmuhala	adv
dimaiddámaid	dimájddámajd	adv
dimiiddámiid	dimijddámijd	adv
divdna	divnna	adv
divohussii	divuhussij	adv
divuhussii	divuhussij	adv
divvosupmái	divvusupmáj	adv
divvumassii	divvumassij	adv
do-doppe	do-dåppe	adv
doaisttážii	doajstátjij	adv
doamadoama	dåmadoama	adv
doamaiddoamaid	dåmajddoamajd	adv
doaresbeallai	doaresbeallaj	adv
doaresčáhcái	doarestjáhtsáj	adv
doaresguvlui	doaresguvluj	adv
doarggatgaccaid	doargatgattsajd	adv
doarvái	doarvváj	adv
dobbelaš	dåbbelasj	adv
dobbeleappos	dåbbeleappos	adv
dobbelebbui	dåbbelebbuj	adv
dobbelii	dåbbelij	adv
dobbeliidda	dåbbelijdda	adv
dobbelin	dåbbelen	adv
dobbelis	dåbbeles	adv
dobbil	dåbbel	adv
dođe	dåde	adv
dodohko	dåduhko	adv
dohkiiddohkiid	dåhkijddohkijd	adv
dohkkemeahttumit	dåhkkemeahttumet	adv
dohko	dåhko	adv
dohko	dåhko	adv
dohkálaččat	dåhkålattjat	adv
doiggo	dåjgo	adv
doigo	dåjggo	adv
doiste	dåjsste	adv
doisttážii	dåjståtjij	adv
dokko	dåkko	adv
dolggal	dålgål	adv
dolin	dålen	adv
dolkamassii	dålkkåmassij	adv
dolágo	dålågo	adv
dolátdovle	dålåtdovle	adv
doŋgget	dåŋget	adv
doppe	dåppe	adv
doppit	dåppet	adv
doppil	dåppel	adv
doppimustá	dåppemustá	adv
dovddolaččat	dåvdulattjat	adv
dovdduheamet	dåvduheamet	adv
dovdomassii	dåvddumassij	adv
dovdovaččat	dåvdduvattjat	adv
dovko	dåvkko	adv
dovle	dåvlle	adv
duhkodagas	duhkudagas	adv
duhkodahkii	duhkudahkij	adv
duhtamassii	duhtamassij	adv
duhtameahttumit	duhtameahttumet	adv
dulppil	dulpel	adv
dumis	dumes	adv
duŋgadassii	duŋggadassij	adv
duobbelii	duobbelij	adv
duobbeliidda	duobbelijdda	adv
duobbelis	duobbeles	adv
duobbil	duobbel	adv
duođabearis	duodabeares	adv
duođai	duodaj	adv
duođaid	duodajd	adv
duođalaččat	duodalattjat	adv
duođas	duodas	adv
duođasin	duodasen	adv
duođi	duode	adv
duogi	duoge	adv
duogis	duoges	adv
duogábeallai	duogábeallaj	adv
duohččagasas	duohttjagasas	adv
duohččagassii	duohttjagassij	adv
duohččasii	duohttjasij	adv
duohččasis	duohttjases	adv
duohkin	duohken	adv
duohkot	duohkut	adv
duohkotdeike	duohkutdejke	adv
duohtaváimmus	duohtavájmus	adv
duoidduohko	duojdoohko	adv
duoiggo	duojgo	adv
duoigo	duojggo	adv
duoihuodjin	duojhoodjen	adv
duoinnánaga	duojnánaga	adv
duojetduodjin	duojetduodjen	adv
duojásii	duojásij	adv
duojážassii	duojátjassij	adv
duojážii	duojátjij	adv
duokkotdákko	duokkutdákko	adv
duokkot	duokkut	adv
duolbut	duolbbut	adv
duolluiddálluid	duollujddállujd	adv
duoppit	duoppet	adv
duoppil	duoppel	adv
duoppildáppil	duoppeldáppel	adv
duoppimustá	duoppemustá	adv
duosttán	duostán	adv
duosttánaga	duostánaga	adv
duosttáš	duostásj	adv
duovkko	duovko	adv
duppallohkkii	duppallohkkij	adv
dušše	dussje	adv
duššefal	dussjefal	adv
duššiid	dussjijd	adv
duššái	dussjáj	adv
duššás	dussjás	adv
duvle	duvlle	adv
dábbelaš	dábbelasj	adv
dábbelebbui	dábbelebbuj	adv
dábbelii	dábbelij	adv
dábbeliidda	dábbelijdda	adv
dábbelis	dábbeles	adv
dábbil	dábbel	adv
dáđi	dáde	adv
dádalle	dádálle	adv
dádeike	dádejke	adv
dáđimielde	dádemielde	adv
dáiggo	dájgo	adv
dáigá	dájggá	adv
dáinnánaga	dájnánaga	adv
dájis	dájes	adv
dákkaviđe	dákkavide	adv
dákkaviđi	dákkavide	adv
dálveleappos	dálvveleappos	adv
dálvelebbui	dálvvelebbuj	adv
dálvelii	dálvvelij	adv
dálveliidda	dálvvelijdda	adv
dálvelis	dálvveles	adv
dálvet	dálvvet	adv
dálvit	dálvvet	adv
dálvvás	dálvás	adv
dánu	dáno	adv
dáppit	dáppet	adv
dáppibui	dáppebuj	adv
dáppibuidda	dáppebujdda	adv
dáppibuin	dáppebujn	adv
dáppibus	dáppebus	adv
dáppil	dáppel	adv
dáppimustá	dáppemustá	adv
dárbahassii	dárbbahassij	adv
dárbbašmeahttumit	dárbasjmeahttumet	adv
dárbbuhemet	dárbuhemet	adv
dássálagaid	dássálagajd	adv
dássážii	dássátjij	adv
dásttánaga	dástánaga	adv
dávjjetdávjá	dávjetdávjá	adv
dávjálagaid	dávjjálagajd	adv
eahkedassii	iehkedassij	adv
eahkes	iehkes	adv
eahketbeallai	iehketbeallaj	adv
eahpegovttolaš	iehpegovttolasj	adv
eahpenjuolga	iehpenjuolga	adv
eahpenjuolgga	iehpenjuolgga	adv
eaktodáhtos	iektudáhtos	adv
eaktodáhtolaččat	iektudáhtolattjat	adv
eallinaga	iellenaga	adv
eambbo	iembo	adv
eambo	iembbo	adv
eambu	iembbo	adv
eamidaš	iemedasj	adv
eamis	iemes	adv
eandalii	ienddalij	adv
eandalit	ienddalet	adv
eanebu	ienebu	adv
eanebuš	ienebusj	adv
eanetbealát	ienetbealát	adv
eanáš	ænásj	adv
earaládje	ieraládje	adv
earalágan	ieralágan	adv
earaláhkai	ieraláhkaj	adv
earaláhkai	ieraláhkaj	adv
earasadjái	ierasadjáj	adv
earasajes	ierasajes	adv
earemuđui	ieremuduj	adv
eareliiggánit	ierelijggánet	adv
earenoamážit	ierenoamátjet	adv
earenomážit	ierenomátjet	adv
earotbealde	ierutbealde	adv
earotbeallai	ierutbeallaj	adv
earretláhkái	ierretláhkáj	adv
earrotbealde	ierrutbealde	adv
earrotbeallai	ierrutbeallaj	adv
earránassii	ærránassij	adv
earáládje	æráládje	adv
earáládje	æráládje	adv
earálágan	ærálágan	adv
earáláhkai	æráláhkaj	adv
earáláhkái	æráláhkáj	adv
earáláhkái	æráláhkáj	adv
easka	iesska	adv
easkabáliid	iesskabálijd	adv
easká	æsská	adv
easkka	ieska	adv
eatnat	iednat	adv
eatnoráiggi	iednurájgge	adv
eavttoheamet	ievtuheamet	adv
ednoš	eddnusj	adv
egeš	egesj	adv
ein	ejn	adv
eisege	ejssege	adv
eivakto	ejvvakto	adv
eivaktu	ejvvaktu	adv
eivve	ejve	adv
eksplisihtalaččat	eksplesihtalattjat	adv
erenoamáš	erenoamásj	adv
erenoamážit	erenoamátjet	adv
erenoamažit	erenoamatjet	adv
erenomážit	erenomátjet	adv
ergo	erggo	adv
eskke	eske	adv
etneš	ednesj	adv
fakŋut	fagŋut	adv
faŋkut	faŋkkut	adv
farggabáliid	fargabálijd	adv
farggamusat	fargamusat	adv
farvealla	farvvealla	adv
fastain	fasstajn	adv
fast-ain	fast-ajn	adv
fastin	fassten	adv
fastin	fassten	adv
fasttain	fastajn	adv
fastten	fasten	adv
fatnagasas	fadnagasas	adv
fatnagassii	fadnagassij	adv
feara	fiera	adv
ferot	ferut	adv
fielttil	fieltel	adv
fiidnáseappot	fijnnáseappot	adv
fiidnážit	fijnnátjet	adv
finjil	finjel	adv
fiskessidjii	fisskessidjij	adv
fitnjalassii	fidnjalassij	adv
fitnjut	fidnjut	adv
fulkkeš	fulkesj	adv
fuođđit	fuoddet	adv
fuolalaččat	fuolalattjat	adv
fuollameahttumit	fuollameahttumet	adv
fággálagaid	fággálagajd	adv
fálta	fállta	adv
fámolaččat	fámulattjat	adv
fárdearva	fárddearva	adv
fárfful	fárful	adv
fárrolaga	fárrulaga	adv
fárrolagaid	fárrulagajd	adv
fárrui	fárruj	adv
fártasabbot	fárttasabbot	adv
fáru	fáro	adv
fásta	fássta	adv
fátmálagaid	fátmálagajd	adv
fávda	fávdda	adv
fávlelačča	fávllelattja	adv
fávlelaččas	fávllelattjas	adv
fávlelažžii	fávlleladtjij	adv
fávleleappos	fávlleleappos	adv
fávlelebbui	fávllelebbuj	adv
fávleleppožii	fávlleleppotjij	adv
fávleleppožis	fávlleleppotjes	adv
fávlelii	fávllelij	adv
fávleliidda	fávllelijdda	adv
fávlelis	fávlleles	adv
fávlil	fávllel	adv
fávllabealde	fávlabealde	adv
fávllabeale	fávlabeale	adv
fávllabeali	fávlabeale	adv
fávllabeallai	fávlabeallaj	adv
fávllibučča	fávlebuttja	adv
fávllibuččas	fávlebuttjas	adv
fávllibui	fávlebuj	adv
fávllibuidda	fávlebujdda	adv
fávllibus	fávlebus	adv
fávllibužžii	fávlebudtjij	adv
fávllimus	fávlemus	adv
gahčagahča	gahtjagahtja	adv
gahperoaivves	gahperoajvves	adv
gahperoaivái	gahperoajváj	adv
gaikomassii	gajkkumassij	adv
gait	gajt	adv
galju	galjjo	adv
gallii	gallij	adv
gallit	gallet	adv
galládassii	galládassij	adv
galmmasnaga	galmasnaga	adv
gaŋgut	gaŋggut	adv
gaŋkkooivviid	gaŋkoojvvijd	adv
gaŋkut	gaŋkkut	adv
ganjalčalmmiid	ganjáltjalmijd	adv
garggunjálmmiid	gargunjálmijd	adv
gaskabazaldagas	gasskabatsaldagas	adv
gaskabazaldahkii	gasskabatsaldahkij	adv
gaskaboddii	gasskaboddij	adv
gaskačázis	gasskatjátses	adv
gaskal	gasskal	adv
gaskalis	gasskales	adv
gaskamearálaččat	gasskamearálattjat	adv
gaskan	gasskan	adv
guovttágaskan	guovtágaskan	adv
gaskaneametteskka	gasskaneametteska	adv
gaskarádjai	gasskarádjaj	adv
gaskasulaide	gasskasulajde	adv
gaskasulain	gasskasulajn	adv
gaskat	gasskat	adv
gaskii	gasskij	adv
gaskka	gaska	adv
gaskkahaga	gaskahaga	adv
gaskkaid	gaskajd	adv
gaskkohagaid	gaskuhagajd	adv
gasku	gassko	adv
gassagassii	gassagassij	adv
gavžut	gavttjut	adv
gavžžil	gavtjel	adv
gazzagasas	gadtsagasas	adv
gazzagassii	gadtsagassij	adv
gazzalagaid	gadtsalagajd	adv
geahčen	giehtjen	adv
geahčálagaid	gæhtjálagajd	adv
geahppadit	giehppadet	adv
geahppagerddiid	giehppagerddijd	adv
geaidagasas	giejddagasas	adv
geaidagassii	giejddagassij	adv
geaidnoráigge	giejnnurájgge	adv
geaigut	giejggut	adv
geallagasas	giellagasas	adv
geallagassii	giellagassij	adv
geardde	gierde	adv
gearddi	gierde	adv
geardumassii	gierddumassij	adv
geassasii	giessasij	adv
geassasis	giessases	adv
geasibui	giesebuj	adv
geasibus	giesebus	adv
geassečoavjjis	giessetjoavjjes	adv
geasseguovdil	giesseguovdel	adv
geasseleappos	giesseleappos	adv
geasselebbui	giesselebbuj	adv
geasselii	giesselij	adv
geasseliidda	giesselijdda	adv
geasselis	giesseles	adv
geasset	giesset	adv
geassit	giesset	adv
geasás	gæsás	adv
geavahanládje	gievahanládje	adv
geavahanláhkai	gievahanláhkaj	adv
geavllil	gievlel	adv
geavrril	gievrel	adv
geavrut	gievrrut	adv
geavzut	gievttsut	adv
geavzzil	gievtsel	adv
geažálassii	gætjálassij	adv
geažát	gætját	adv
geidosii	gejddusij	adv
geidosis	gejdduses	adv
geit	gejt	adv
giđasdálvve	gidásdálvve	adv
giđasgease	gidásgease	adv
giđđalii	giddalij	adv
giđđalis	giddales	adv
giđđat	giddat	adv
giddalagaid	giddalagajd	adv
gieđaguluin	giedagulujn	adv
giehtasesiin	giehtasesijn	adv
giehtalagaid	giehtalagajd	adv
giellagassii	giellagassij	adv
giellasii	giellasij	adv
giellasis	giellases	adv
gieskabále	giesskabále	adv
gieskat	giesskat	adv
gieskkaid	gieskajd	adv
gietkagassii	gietkagassij	adv
gievrru	gievro	adv
gilgalagaid	gilggalagajd	adv
gilggal	gilgal	adv
gilggalis	gilgales	adv
gilgut	gilggut	adv
gilvolagaid	gilvvulagajd	adv
gilvvu	gilvo	adv
girjjálaččat	girjálattjat	adv
gittalagaid	gittalagajd	adv
gittauvssaid	gittauvssajd	adv
givrril	givrel	adv
givrut	givrrut	adv
globálalaččat	glåbålalattjat	adv
goabal	gåbal	adv
goabbasiige	goabbasijge	adv
goabbelii	goabbelij	adv
goabbeliige	goabbelijge	adv
goabbelis	goabbeles	adv
goabbil	goabbel	adv
goabbilge	goabbelge	adv
goaiddá	goajdá	adv
goalmmádassii	goalmádassij	adv
goalmmádis	goalmádes	adv
goamal	gåmal	adv
goaŋkkil	goaŋkel	adv
goaŋkut	goaŋkkut	adv
goappil	goappel	adv
goappilge	goappelge	adv
goappos	goappus	adv
goarjagasas	goarjjagasas	adv
goarjagassii	goarjjagassij	adv
goarjagii	goarjjagij	adv
goarjagis	goarjjages	adv
goarkagii	goarkkagij	adv
goarkagis	goarkkages	adv
goarrumassii	goarrumassij	adv
goaruhussii	goaruhussij	adv
goarvvil	goarvel	adv
goasii	goasij	adv
goasin	goasen	adv
goassai	goassaj	adv
goassige	goassege	adv
goavddil	goavdel	adv
goavkkil	goavkel	adv
goavkut	goavkkut	adv
goavrril	goavrel	adv
goavrut	goavrrut	adv
gobil	gåbel	adv
goggo	gåggo	adv
goigo	gåjggo	adv
goikejulggiid	gåjkkejulggijd	adv
goikevevssiid	gåjkkevevssijd	adv
goit-al	gåjt-al	adv
goitge	gåjtge	adv
gok	gåk	adv
gokčagasas	gåktjågasas	adv
gokčagassii	gåktjågassij	adv
gokko	gåkko	adv
gokkonai	gåkkunaj	adv
gokte	gåkte	adv
goktege	gåktege	adv
goktes	gåktes	adv
golbmasiidgolbmasiid	gålmmåsijdgolmmasijd	adv
golbmii	gålmmij	adv
golgosii	gålggusij	adv
golgosis	gålgguses	adv
gollolagaid	gållulagajd	adv
golmmaidgolmmaid	gålmåjdgolmajd	adv
gomalassii	gåmålassij	adv
gomogazzii	gåmugadtsij	adv
gomolassii	gåmulassij	adv
gomot	gåmut	adv
gomuoivviid	gåmoojvvijd	adv
gonne	gånne	adv
gonnes	gånnes	adv
gopmolassii	gåbmulassij	adv
gopmut	gåbmut	adv
goppos	gåppus	adv
gorrelaččat	gårrelattjat	adv
gorrosupmái	gårrusupmáj	adv
gorrái	gårråj	adv
gos	gås	adv
gosa	gåså	adv
gosii	gåsij	adv
goskkeš	gåskesj	adv
gossai	gåssåj	adv
gostege	gåsstege	adv
gostige	gåsstege	adv
goste	gåsste	adv
got	gåt	adv
govdadit	gåvddådet	adv
govdilasas	gåvddelasas	adv
govdilassii	gåvddelassij	adv
govdosii	gåvddusij	adv
govdosis	gåvdduses	adv
govt	gåvt	adv
gubbarassii	gubbarassij	adv
guđadassii	gudádassij	adv
guđadis	gudádes	adv
guđoldagas	guduldagas	adv
guđoldahkii	guduldahkij	adv
guhkesáiggis	guhkesájgges	adv
guhkessidjii	guhkessidjij	adv
guhkibuččas	guhkebuttjas	adv
guhkibui	guhkebuj	adv
guhkibuidda	guhkebujdda	adv
guhkebuš	guhkebusj	adv
guhkibus	guhkebus	adv
guhkibužžii	guhkebudtjij	adv
guhkiide	guhkijde	adv
guhkiin	guhkijn	adv
guhkkelaččas	guhkkelattjas	adv
guhkkelažžii	guhkkeladtjij	adv
guhkkelebbui	guhkkelebbuj	adv
guhkkeleppožii	guhkkeleppotjij	adv
guhkkeleppožis	guhkkeleppotjes	adv
guhkkelii	guhkkelij	adv
guhkkeliidda	guhkkelijdda	adv
guhkkelis	guhkkeles	adv
guhkkin	guhkken	adv
guhkkin	guhkken	adv
guhkkálagaid	guhkkálagajd	adv
guhkkásii	guhkkásij	adv
guhkáláhkai	guhkáláhkaj	adv
guhttii	guhttij	adv
guita	gujtta	adv
guittot	gujtut	adv
guittotge	gujtutge	adv
guktii	guktij	adv
gullolagaid	gullulagajd	adv
gulámuddui	gulámudduj	adv
gunttus	guntus	adv
guođát	guodát	adv
guoggarassii	guoggarassij	adv
guoibmálagaid	guojmmálagajd	adv
guokkil	guokkel	adv
guoktil	guoktel	adv
guoktásiidguoktásiid	guoktásijdguoktásijd	adv
guorosnaga	guorusnaga	adv
guossot	guossut	adv
guovdat	guovddat	adv
guovdeleappos	guovddeleappos	adv
guovdelebbui	guovddelebbuj	adv
guovdeleppožii	guovddeleppotjij	adv
guovdeleppožis	guovddeleppotjes	adv
guovdelii	guovddelij	adv
guovdelis	guovddeles	adv
guovdil	guovddel	adv
guovdoleappos	guovdduleappos	adv
guovdolebbui	guovddulebbuj	adv
guovdoleppožii	guovdduleppotjij	adv
guovdoleppožis	guovdduleppotjes	adv
guovdolii	guovddulij	adv
guovdolis	guovddules	adv
guovssogeažis	guovsugeatjes	adv
guovttebealčomil	guovtebealtjomel	adv
guovttebealgobil	guovtebealgobel	adv
guovttegávdnái	guovtegávnnáj	adv
guovtteguosmái	guovteguosmáj	adv
guovttejuolgaskii	guovtejuolgaskij	adv
guovtteládje	guovteládje	adv
guovttil	guovtel	adv
guovttá	guovtá	adv
gurrii	gurrij	adv
gusto	gussto	adv
guvdnjut	guvnnjut	adv
guvdnut	guvnnut	adv
guvnnjil	guvnjel	adv
guvrril	guvrel	adv
guvrut	guvrrut	adv
guvttiidguvttiid	guvtijdguvttijd	adv
gáddelačča	gáddelattja	adv
gáddelaččas	gáddelattjas	adv
gáddelaš	gáddelasj	adv
gáddelažžii	gáddeladtjij	adv
gáddelebbui	gáddelebbuj	adv
gáddeleppožii	gáddeleppotjij	adv
gáddeleppožis	gáddeleppotjes	adv
gáddelii	gáddelij	adv
gáddeliidda	gáddelijdda	adv
gáddelis	gáddeles	adv
gáddil	gáddel	adv
gáddolagaid	gáddulagajd	adv
gáidagasas	gájddagasas	adv
gáidagassii	gájddagassij	adv
gákcii	gáktsij	adv
gáktegerddiid	gáktegerddijd	adv
gálgoš	gálggusj	adv
gámajuolggis	gámájuolgges	adv
gánske	gánsske	adv
gánssal	gánsal	adv
gápmagahttá	gábmagahttá	adv
gárgŋut	gárŋŋut	adv
gárkŋil	gárŋel	adv
gárragassii	gárragassij	adv
gárragii	gárragij	adv
gárragis	gárrages	adv
gárrasii	gárrasij	adv
gárrasis	gárrases	adv
gárremaččaide	gárremattjajde	adv
gárremaččain	gárremattjajn	adv
gárremiidda	gárremijdda	adv
gárremiin	gárremijn	adv
gárrenoaivvis	gárrenoajvves	adv
gárssil	gársel	adv
gárvásii	gárvvásij	adv
gáržásii	gárttjásij	adv
gáržásis	gárttjáses	adv
gáttabeali	gáttabeale	adv
gáttabeallai	gáttabeallaj	adv
gáttageahčai	gáttageahtjaj	adv
gáttageahčen	gáttageahtjen	adv
gával	gávál	adv
gávddil	gávdel	adv
gávotgaccaid	gávutgattsajd	adv
gávrril	gávrel	adv
gávrut	gávrrut	adv
gávzzil	gávtsel	adv
hain	hajn	adv
heahkka	hiehkka	adv
heahkkadaga	hiehkkadaga	adv
heahkkat	hiehkkat	adv
heahpatmeahttumit	hiehpatmeahttumet	adv
heaittekeahttái	hiejtekeahttáj	adv
healla	hiella	adv
heaŋgagasas	hieŋggagasas	adv
heaŋgagassii	hieŋggagassij	adv
heaŋgasii	hieŋggasij	adv
heaŋgasis	hieŋggases	adv
hedi	hede	adv
hedii	hedij	adv
heggosii	heggusij	adv
hiđuidháđuid	hidujdhádujd	adv
hiljit	hiljjet	adv
hiljážii	hiljjátjij	adv
hiljážit	hiljjátjet	adv
hiluidháluid	hilujdhálujd	adv
hiluid	hilujd	adv
harbmat	harmmat	adv
harbmadit	harmmadet	adv
hirbmat	hirmmat	adv
hirbmadit	hirmmadet	adv
hirbmosit	hirmmuset	adv
hirpmasit	hirmaset	adv
hirril	hirrel	adv
hoahpohoahpus	hoahpuhoahpus	adv
hohkkái	håhkkåj	adv
huhttagassii	huhttagassij	adv
hui	huj	adv
huiven-hiváste	hujvven-hiváste	adv
hyrbmat	hyrmmat	adv
háhccut	háhttsut	adv
háhttásii	háhttásij	adv
háhttásis	háhttáses	adv
hájilassii	hájelassij	adv
hálga	hálgga	adv
hálooivviid	háloojvvijd	adv
hálssil	hálsel	adv
háltái	hálltáj	adv
hálva	hálvva	adv
háŋkalagaid	háŋkkalagajd	adv
hárččil	hártjel	adv
hárčut	hárttjut	adv
hárjjil	hárjel	adv
hárril	hárrel	adv
hárvelávkkiid	hárvvelávkkijd	adv
hávil	hável	adv
hávskit	hávssket	adv
háválassii	háválassij	adv
hávális	háváles	adv
iđđedis	iddedes	adv
iđđes	iddes	adv
iđedassii	idedassij	adv
iđedis	idedes	adv
iđis	ides	adv
iđitbealli	idetbealle	adv
idjaguovdil	idjaguovdel	adv
iehčanassii	iehtjanassij	adv
iešalddes	ietjalddes	adv
iešalddis	ietjalddes	adv
iešalddiset	ietjalddiset	adv
iešalddán	ietjalddán	adv
iešalddát	ietjalddát	adv
iešdáhtos	iesjdáhtos	adv
iešdáhtus	iesjdáhtus	adv
iešgieđal	iesjgiedal	adv
iešguđetládje	iesjgudetládje	adv
iešguđetláhkai	iesjgudetláhkaj	adv
iešheanalis	iesjheanales	adv
iešheanálaččat	iesjheanálattjat	adv
iešoaivvestanatis	ietjoajvvestanates	adv
iešokto	ietjukto	adv
iežáládje	ietjáládje	adv
iežasláhkái	ietjasláhkáj	adv
iežasláhkai	ietjasláhkaj	adv
ihcalassii	ihtsalassij	adv
ihcalis	ihtsales	adv
ihkin	ihken	adv
ihkku	ihkko	adv
ihtin	ihten	adv
ihttenaš	ihttenasj	adv
ihttin	ihtten	adv
ihánit	ihánet	adv
ijatbeaivái	ijátbeajváj	adv
ijatbeaivvi	ijátbeajvve	adv
ijatbeivviid	ijátbejvvijd	adv
ijatihkku	ijátihkku	adv
ilbmán	ilmmán	adv
ildi	illde	adv
ildása	illdása	adv
illumielain	illumielajn	adv
illágoastta	illágoasta	adv
illávejiid	illávejijd	adv
ilmmiidalmmiid	ilmijdalmijd	adv
imašlaččat	imasjlattjat	adv
imeš	imesj	adv
implisihtalaččat	implesihtalattjat	adv
inta	intta	adv
ipmilmeahttumit	ibmelmeahttumet	adv
irggeš	irgesj	adv
irta	irtta	adv
isidaš	isedasj	adv
iskor	isskur	adv
issorasat	issurasat	adv
jagáš	jagásj	adv
jahkeviissaid	jahkevijssajd	adv
jahkásaččat	jahkásattjat	adv
jaril	jarel	adv
jarkŋil	jarŋel	adv
jaska	jasska	adv
jeahkalahttá	jiehkalahttá	adv
jeavda	jievdda	adv
jeavddalaččat	jievdalattjat	adv
jelgii	jelggij	adv
jergo	jerggo	adv
jierrásit	jierráset	adv
jirpmet	jirmet	adv
jitnosii	jidnusij	adv
jitnosit	jidnuset	adv
jitnoseabbot	jidnuseabbot	adv
joaimmil	joajmel	adv
joavkolaga	joavkkulaga	adv
jođáneappot	jådåneappot	adv
jođánepmosit	jådånepmoset	adv
jođánit	jådånet	adv
jogo	jågo	adv
johtileappot	jåhteleappot	adv
johtilit	jåhtelet	adv
joksege	jåksege	adv
jolga	jålggå	adv
joppa	jåppå	adv
jorbadassii	jårbbådassij	adv
jorbasidjii	jårbbåsidjij	adv
jorbasii	jårbbåsij	adv
jorggotbeliid	jårgutbelijd	adv
jorggotgežiid	jårgutgetjijd	adv
jorgut	jårggut	adv
juhkamassii	juhkamassij	adv
juhkanoaivves	juhkanoajvves	adv
julggal	julgal	adv
juolgesesiin	juolggesesijn	adv
juolgásiid	juolggásijd	adv
justa	jussta	adv
juste	jusste	adv
jábmejassii	jábbmejassij	adv
jáffonaga	jáffunaga	adv
jáfonaga	jáfunaga	adv
jálutbeliid	jálutbelijd	adv
jámas	jámás	adv
jándorviissaid	jánddurvijssajd	adv
jávkkohagas	jávkuhagas	adv
jávkkohahkii	jávkuhahkij	adv
jávkosii	jávkkusij	adv
jávkosis	jávkkuses	adv
jávohaga	jávuhaga	adv
jávvásii	jávvásij	adv
jávvásis	jávváses	adv
kievrru	kievro	adv
kánske	kánsske	adv
lagabuččas	lagábuttjas	adv
lagabui	lagábuj	adv
lagabuidda	lagábujdda	adv
lagabus	lagábus	adv
lagabužžii	lagábudtjij	adv
lahkalagaid	lahkalagajd	adv
lahkaorodettiin	lahkaorodettijn	adv
lahkiidlahkiid	lahkijdlahkijd	adv
lahkkálagaid	lahkkálagajd	adv
lahkosin	lahkusen	adv
lahkosis	lahkuses	adv
largo	larggo	adv
lasi	lase	adv
lasmosii	lassmusij	adv
lasmosis	lassmuses	adv
latnjalagaid	ladnjalagajd	adv
latnjalassii	ladnjalassij	adv
latnjasii	ladnjasij	adv
latnjasis	ladnjases	adv
leabba	liebba	adv
leabbagasas	liebbagasas	adv
leabbagassii	liebbagassij	adv
leabbut	liebbut	adv
leagil	liegel	adv
leaikavuođas	liejkkavuodas	adv
leaikkal	liejkal	adv
leaikkas	liejkas	adv
leaimmil	liejmel	adv
leakkil	liekkel	adv
leamssil	liemsel	adv
leanzut	lienttsut	adv
leanzzil	lientsel	adv
leavttuid	lievtujd	adv
liđbma	lirmma	adv
lihbadjái	lihbadjáj	adv
lihbajis	lihbajes	adv
lihpadjái	lihpadjáj	adv
lihpajis	lihpajes	adv
lihpebadjái	lihpebadjáj	adv
lihpebajis	lihpebajes	adv
liiggás	lijgás	adv
liikka	lijka	adv
liikká	lijká	adv
liktásit	liktáset	adv
loahpadassii	loahpadassij	adv
loahpageahčai	loahpageahtjaj	adv
loahpageahčen	loahpageahtjen	adv
loaidulii	loajddulij	adv
loaidulis	loajddules	adv
loaittuid	loajtujd	adv
loaittul	loajtul	adv
loamil	loamel	adv
loanas	lånas	adv
loažža	loadtja	adv
loažžut	loadtjut	adv
lobiheamit	låbeheamet	adv
lobihemet	låbehemet	adv
logahussii	lågåhussij	adv
logemađe	lågemade	adv
logenear	lågenear	adv
logeneare	lågeneare	adv
logenár	lågenár	adv
loginár	lågenár	adv
logenáre	lågenáre	adv
logádassii	lågådassij	adv
logádis	lågådes	adv
lohkamassii	låhkåmassij	adv
lohkkojupmái	låhkkujupmáj	adv
lohkkosupmái	låhkkusupmáj	adv
lohkásiidlohkásiid	låhkåsijdlohkásijd	adv
loidolii	låjddulij	adv
loidolis	låjddules	adv
loikasit	låjkkåset	adv
loktasii	låktåsij	adv
loktasis	låktåses	adv
loktosii	låktusij	adv
loktosis	låktuses	adv
lotnolaga	lådnulaga	adv
lotnolagaid	lådnulagajd	adv
lossadit	låssådet	adv
lotka	låtkå	adv
lotnolassii	lådnulassij	adv
luhčanaga	luhtjanaga	adv
luhtteorodettiin	luhtteorodettijn	adv
lulde	lullde	adv
lulibui	lulebuj	adv
lulibuidda	lulebujdda	adv
lulibus	lulebus	adv
lulil	lulel	adv
lullelačča	lullelattja	adv
lullelaččas	lullelattjas	adv
lullelaš	lullelasj	adv
lullelažžii	lulleladtjij	adv
lullelebbui	lullelebbuj	adv
lulleleppožii	lulleleppotjij	adv
lulleleppožis	lulleleppotjes	adv
lullelii	lullelij	adv
lulleliidda	lullelijdda	adv
lullelis	lulleles	adv
lullil	lullel	adv
lullin	lullen	adv
lulábeallai	lulábeallaj	adv
lulágeahčai	lulágeahtjaj	adv
lulágeahčen	lulágeahtjen	adv
lulágeaže	lulágeatje	adv
lunddolaččat	lundulattjat	adv
luođđagasas	luoddagasas	adv
luođđagassii	luoddagassij	adv
luođđagii	luoddagij	adv
luođđagis	luoddages	adv
luoddaráigge	luoddarájgge	adv
luohkkálii	luohkkálij	adv
luohkkális	luohkkáles	adv
luohttalagaid	luohttalagajd	adv
luoikkas	luojkas	adv
luoittát	luojtát	adv
luovddaid	luovdajd	adv
luovddalagaid	luovdalagajd	adv
luovos	luovus	adv
luovosvuoji	luovusvuoje	adv
lupmosit	lubmuset	adv
luvvolagaid	luvvulagajd	adv
láddagassii	láddagassij	adv
láddasii	láddasij	adv
láddasis	láddases	adv
láhčamaš	láhtjamasj	adv
láhji	láhje	adv
láhkai	láhkaj	adv
láhkái	láhkáj	adv
láhkežeamen	láhketjeamen	adv
láhppagassii	láhppagassij	adv
láhppasii	láhppasij	adv
láhppasis	láhppases	adv
láhpposii	láhppusij	adv
láhpposis	láhppuses	adv
láigomassii	lájggumassij	adv
láigumassii	lájggumassij	adv
láimmil	lájmel	adv
láitemeahttumit	lájttemeahttumet	adv
láitinláhkai	lájttenláhkaj	adv
lákčut	láktjut	adv
lámas	lámás	adv
lápmálassii	lábmálassij	adv
lášmadit	lássjmadet	adv
láseráigge	láserájgge	adv
láskut	lásskut	adv
lássaráigge	lássarájgge	adv
látnalassii	ládnalassij	adv
lávččil	lávtjel	adv
lávda	lávdda	adv
lávga	lávgga	adv
lávgalagaid	lávggalagajd	adv
lávžálagaid	lávttjálagajd	adv
mađđása	maddása	adv
mađe	made	adv
mađi	made	adv
mahkáš	mahkásj	adv
mahtiin	mahtijn	adv
mahtis	mahtes	adv
mahttái	mahttáj	adv
mai	maj	adv
maid	majd	adv
maiddá	majdá	adv
maiddái	majdáj	adv
maiddái	majdáj	adv
maiddái	majdáj	adv
maidddái	majdddáj	adv
mallosge	mallusge	adv
maŋemuš	maŋemusj	adv
maŋemussii	maŋemussij	adv
maŋimus	maŋemus	adv
maŋimusas	maŋemusas	adv
maŋimussii	maŋemussij	adv
maŋimustá	maŋemustá	adv
maŋimuštá	maŋemusjtá	adv
maŋistaga	maŋestaga	adv
maŋŋegeahčen	maŋŋegeahtjen	adv
maŋŋelgihtii	maŋŋelgihtij	adv
maŋŋelaš	maŋŋelasj	adv
maŋŋelaš	maŋŋelasj	adv
maŋŋelebbui	maŋŋelebbuj	adv
maŋŋeleppožii	maŋŋeleppotjij	adv
maŋŋeleppožis	maŋŋeleppotjes	adv
maŋŋelii	maŋŋelij	adv
maŋŋeliidda	maŋŋelijdda	adv
maŋŋelis	maŋŋeles	adv
maŋŋelis	maŋŋeles	adv
maŋŋemaŋŋálagaid	maŋŋemaŋŋálagajd	adv
maŋŋidii	maŋŋedij	adv
maŋŋil	maŋŋel	adv
maŋŋin	maŋŋen	adv
maŋŋit	maŋŋet	adv
maŋŋiteahket	maŋŋeteahket	adv
maŋŋitgiđa	maŋŋetgida	adv
maŋŋálagaid	maŋŋálagajd	adv
maŋŋásanatis	maŋŋásanates	adv
maŋos	maŋus	adv
maŋosguvlui	maŋusguvluj	adv
maŋosii	maŋusij	adv
maŋábeallai	maŋábeallaj	adv
maŋágeahčai	maŋágeahtjaj	adv
maŋágeahčen	maŋágeahtjen	adv
maŋágeaže	maŋágeatje	adv
maŋágeažes	maŋágeatjes	adv
maŋálgihtii	maŋálgihtij	adv
maŋásguvlui	maŋásguvluj	adv
maŋážassii	maŋátjassij	adv
maŋážussii	maŋátjussij	adv
manin	manen	adv
maninge	manenge	adv
manješ	manjesj	adv
mannolagas	mannulagas	adv
mannolahkii	mannulahkij	adv
markkát	markát	adv
meaddelaš	mieddelasj	adv
meahcabealde	miehtsabealde	adv
meahcabeale	miehtsabeale	adv
meahcabeallai	miehtsabeallaj	adv
meahcceráigge	miehttserájgge	adv
meahccáiaga	mæhttsájaga	adv
mealgadat	mielggadat	adv
mealgadaččas	mielggadattjas	adv
mealgadaš	mielggadasj	adv
mealgadažžii	mielggadadtjij	adv
mealgadii	mielggadij	adv
mealgadis	mielggades	adv
mealgadit	mielggadet	adv
mealgat	mielggat	adv
mearabui	mierabuj	adv
mearabuidda	mierabujdda	adv
mearabus	mierabus	adv
mearkkašahtti	mierkatjahtte	adv
measta	miessta	adv
meastui	miesstuj	adv
meattá	mættá	adv
mehcobealde	mehtsubealde	adv
mehcobeale	mehtsubeale	adv
mehcobeallai	mehtsubeallaj	adv
menddo	mendo	adv
mieđaid	miedajd	adv
mieđil	miedel	adv
mieđabealde	miedabealde	adv
mieđábealde	miedábealde	adv
mieđábeale	miedábeale	adv
mieđábeallai	miedábeallaj	adv
mieđás	miedás	adv
miehtebeaivái	miehtebeajváj	adv
miehtečáhcái	miehtetjáhtsáj	adv
miehtegulgii	miehtegulgij	adv
miehtejohtimii	miehtejohtimij	adv
miehtelii	miehtelij	adv
miehtelis	miehteles	adv
miehtemurrii	miehtemurrij	adv
miehterávdnjái	miehterávnnjáj	adv
miehtil	miehtel	adv
miehtásit	miehtáset	adv
mieigut	miejggut	adv
mielalaččat	mielalattjat	adv
mielalis	mielales	adv
mielastepmosit	mielastepmoset	adv
mielddánátis	mieldánátes	adv
mielddistis	mieldestes	adv
mielde	miellde	adv
mieldi	miellde	adv
mieldeorodettiin	mielldeorodettijn	adv
mieldálagaid	mielldálagajd	adv
mieldámet	mielldámet	adv
miellasepmosit	miellasepmoset	adv
mieláhkui	mieláhkuj	adv
mihus	midus	adv
miilaviissaid	mijlavijssajd	adv
milloseappot	milluseappot	adv
milloseabbot	milluseabbot	adv
millosepmosit	millusepmoset	adv
minddar	mindar	adv
minddár	mindár	adv
mista	missta	adv
moson	måsun	adv
moakkil	moakkel	adv
moalkkil	moalkel	adv
moalkut	moalkkut	adv
moarseš	moarssesj	adv
moddii	måddij	adv
mohkil	måhkel	adv
mojonjálmmiid	måjunjálmijd	adv
mojunjálmmiid	måjunjálmijd	adv
moktege	måktege	adv
moktige	måktege	adv
morseš	mårssesj	adv
moskosii	måsskusij	adv
moskosis	måsskuses	adv
mot	måt	adv
movt	måvt	adv
movtta	måvtå	adv
muđolassii	mudulassij	adv
muđui	muduj	adv
muđuui	mudouj	adv
muđuid	mudujd	adv
muggarassii	muggarassij	adv
muhtemin	muhtemen	adv
muhtimassii	muhtemassij	adv
muhtimin	muhtemen	adv
muhtomin	muhtumen	adv
muhtumassii	muhtumassij	adv
muhtumin	muhtumen	adv
muhtunláhkai	muhtunláhkaj	adv
mulgut	mulggut	adv
muoŧáš	muotásj	adv
murtolassii	murttulassij	adv
muttuid	muttujd	adv
muttágit	muttáget	adv
máddelačča	máddelattja	adv
máddelaččas	máddelattjas	adv
máddelažžii	máddeladtjij	adv
máddelebbui	máddelebbuj	adv
máddelii	máddelij	adv
máddeliidda	máddelijdda	adv
máddelis	máddeles	adv
máddelit	máddelet	adv
máddil	máddel	adv
máddin	mádden	adv
máddinnuortan	máddennuortan	adv
máddinoarjin	máddenoarjen	adv
máddugit	mádduget	adv
máhccagasas	máhttsagasas	adv
máhccagassii	máhttsagassij	adv
máhccevaččat	máhttsevattjat	adv
máhccovuksii	máhttsuvuksij	adv
máhccut	máhttsut	adv
máhcil	máhtsel	adv
mái	máj	adv
máŋggaládje	máŋgaládje	adv
máŋggaláhkai	máŋgaláhkaj	adv
máŋgii	máŋggij	adv
máŋgimusat	máŋggemusat	adv
mánnosaččat	mánnusattjat	adv
mášolaččat	másjulattjat	adv
máttabeallai	máttabeallaj	adv
máttageahčai	máttageahtjaj	adv
máttageahčen	máttageahtjen	adv
máttageaže	máttageatje	adv
máttagit	máttaget	adv
máttibui	máttebuj	adv
máttibuidda	máttebujdda	adv
máttibus	máttebus	adv
máttil	máttel	adv
nabason	nabáson	adv
nađđagasas	naddagasas	adv
nađđagassii	naddagassij	adv
nađo	nado	adv
nalde	nallde	adv
namalassii	namálassij	adv
nammejahkii	nammejahkij	adv
nannosit	nannuset	adv
nappot	napput	adv
nebeš	nebesj	adv
niehkabeallai	niehkabeallaj	adv
nirvut	nirvvut	adv
nirvvil	nirvel	adv
niskkemaŋil	niskemaŋel	adv
nissonahttá	nissunahttá	adv
njagil	njagel	adv
njahpagassii	njahpagassij	adv
njahppagassii	njahppagassij	adv
njahppasii	njahppasij	adv
njahppasis	njahppases	adv
njakčut	njaktjut	adv
njalput	njalpput	adv
njamažahkkát	njamátjahkkát	adv
njaŋgut	njaŋggut	adv
njavččil	njavtjel	adv
njavga	njavgga	adv
njavkkil	njavkel	adv
njeakcut	njiektsut	adv
njealjádassii	njæljjádassij	adv
njealjádis	njæljjádes	adv
njealljásiidnjealljásiid	njælljásijnnjealljásijd	adv
njeavccil	njievttsel	adv
njeazzut	njiedtsut	adv
njeljiidnjeljiid	njeljjijnnjeljijd	adv
njelljii	njelljij	adv
njiellagassii	njiellagassij	adv
njoaiddul	njoajdul	adv
njoalput	njoalpput	adv
njoarostanmuddui	njoarustanmudduj	adv
njoarostanmuttos	njoarustanmuttos	adv
njoarragii	njoarragij	adv
njoarragis	njoarrages	adv
njoaskut	njoasskut	adv
njoazebut	njoatsebut	adv
njoazit	njoatset	adv
njolgelávkái	njålggelávkáj	adv
njolggi	njålge	adv
njozet	njåtset	adv
njulgestaga	njulggestaga	adv
njunnesuoril	njunnesuorel	adv
njunnálagaid	njunnálagajd	adv
njunolassii	njunulassij	adv
njunos	njunus	adv
njunálassii	njunálassij	adv
njunálassii	njunálassij	adv
njunális	njunáles	adv
njunásiid	njunásijd	adv
njuokkil	njuokkel	adv
njuolganaga	njuolgganaga	adv
njuolggabut	njuolgabut	adv
njuolggoseaibbe	njuolguseajbbe	adv
njuolggočilggiid	njuolgutjilggijd	adv
njuolggá	njuolgá	adv
njuolggát	njuolgát	adv
njuolggoluotta	njuolguluotta	adv
njuolgguslaččat	njuolguslattjat	adv
njuolgut	njuolggut	adv
njuorrasit	njuorraset	adv
njuoskkasnaga	njuoskasnaga	adv
njuovahussii	njuovahussij	adv
njuovvamassii	njuovvamassij	adv
njuovvanviđá	njuovvanvidá	adv
njuovžilit	njuovttjelet	adv
njáikkal	njájkal	adv
njáikkul	njájkul	adv
njálgát	njálggát	adv
njálmmálaččat	njálmálattjat	adv
njálmmát	njálmát	adv
njámmagassii	njámmagassij	adv
njámmasii	njámmasij	adv
njámmasis	njámmases	adv
njáŋgut	njáŋggut	adv
njárbadit	njárbbadet	adv
njárggal	njárgal	adv
noađđeselggiid	noaddeselggijd	adv
nođđosii	nåddusij	adv
nođđosis	nådduses	adv
nohkka	nåhkkå	adv
nollut	nållut	adv
norggabealde	nårgåbealde	adv
nudaddjon	nudáddjon	adv
numot	numut	adv
nuogis	nuoges	adv
nuokkevuollái	nuokkevuolláj	adv
nuolos	nuolus	adv
nuoluid	nuolujd	adv
nuortalačča	nuorttalattja	adv
nuortalaččas	nuorttalattjas	adv
nuortalaš	nuorttalasj	adv
nuortalažžii	nuorttaladtjij	adv
nuortaleamos	nuorttaleamos	adv
nuortaleappos	nuorttaleappos	adv
nuortalebbui	nuorttalebbuj	adv
nuortaleppožii	nuorttaleppotjij	adv
nuortaleppožis	nuorttaleppotjes	adv
nuortalii	nuorttalij	adv
nuortaliidda	nuorttalijdda	adv
nuortalis	nuorttales	adv
nuortalit	nuorttalet	adv
nuortan	nuorttan	adv
nuortandavvin	nuorttandavven	adv
nuortanlullin	nuorttanlullen	adv
nuortin	nuortten	adv
nuorttabealde	nuortabealde	adv
nuorttabeale	nuortabeale	adv
nuorttabeallai	nuortabeallaj	adv
nuorttabui	nuortabuj	adv
nuorttabuidda	nuortabujdda	adv
nuorttabus	nuortabus	adv
nuorttageahčai	nuortageahtjaj	adv
nuorttageahčen	nuortageahtjen	adv
nuorttageaže	nuortageatje	adv
nuorttas	nuortas	adv
nuppeaivve	nuppeajvve	adv
nuppeláhkai	nuppeláhkaj	adv
nuppos	nuppus	adv
nuppádassii	nuppádassij	adv
nuppádis	nuppádes	adv
nuskket	nusket	adv
nuvttá	nuvtá	adv
nuvttánaga	nuvtánaga	adv
náđđagasas	náddagasas	adv
náđđagassii	náddagassij	adv
nárvvil	nárvel	adv
návrun	návrrun	adv
oaba	åba	adv
oabanassii	åbanassij	adv
oaidninláhkai	oajnnenláhkaj	adv
oainna	oajna	adv
oainnat	oajnat	adv
oainneman	oajneman	adv
oaivveheamet	oajveheamet	adv
oaivvesnaga	oajvesnaga	adv
oaivvát	oajvát	adv
oalil	oalel	adv
oalleláhkai	oalleláhkaj	adv
oaláhii	oaláhij	adv
oanehassii	oanehassij	adv
oanekassii	oanekassij	adv
oanit	oanet	adv
oapmet	oabmet	adv
oapmit	oabmet	adv
oarjelačča	oarjjelattja	adv
oarjelaččas	oarjjelattjas	adv
oarjelaš	oarjjelasj	adv
oarjelažžii	oarjjeladtjij	adv
oarjeleamos	oarjjeleamos	adv
oarjeleappos	oarjjeleappos	adv
oarjelebbui	oarjjelebbuj	adv
oarjeleppožii	oarjjeleppotjij	adv
oarjeleppožis	oarjjeleppotjes	adv
oarjelii	oarjjelij	adv
oarjeliidda	oarjjelijdda	adv
oarjelis	oarjjeles	adv
oarjelit	oarjjelet	adv
oarjil	oarjjel	adv
oarjin	oarjjen	adv
oarjindavvin	oarjjendavven	adv
oarjinlullin	oarjjenlullen	adv
oarjjabealde	oarjabealde	adv
oarjjabeale	oarjabeale	adv
oarjjabeallai	oarjabeallaj	adv
oarjjageahčai	oarjageahtjaj	adv
oarjjageahčen	oarjageahtjen	adv
oarjjageaže	oarjageatje	adv
oarjjibui	oarjebuj	adv
oarjjibuidda	oarjebujdda	adv
oarjjibus	oarjebus	adv
oarjjil	oarjel	adv
oarjjál	oarjál	adv
oarjjás	oarjás	adv
oarjjásdavás	oarjásdavás	adv
oarjjáslulás	oarjáslulás	adv
oarpmenbeleš	oarmenbelesj	adv
oassálagaid	oassálagajd	adv
oatnebotta	oadnebotta	adv
oavnnjil	oavnjel	adv
oažžunsadjái	oadtjunsadjáj	adv
oažžunsajis	oadtjunsajes	adv
oba	åbå	adv
oba	åbå	adv
obalohkái	åbålohkáj	adv
obanassii	åbånassij	adv
obbanassii	åbbånassij	adv
obba	åbbå	adv
obbagazzii	åbbågadtsij	adv
obbalohkái	åbbålohkáj	adv
obban	åbbån	adv
obbanaga	åbbånaga	adv
ođasnaga	ådåsnaga	adv
ođđasis	åddåses	adv
ođđasit	åddåset	adv
odjorassii	ådjurassij	adv
odne	åddne	adv
ohcanláhkai	åhtsånláhkaj	adv
ohpihii	åhpehij	adv
ohpit	åhpet	adv
oidnolagaid	åjnnulagajd	adv
oidnosii	åjnnusij	adv
oidnosis	åjnnuses	adv
oinnolaččat	åjnulattjat	adv
okcii	åktsij	adv
oktan	åktån	adv
oktanaga	åktånaga	adv
oktanagas	åktånagas	adv
oktanis	åktånes	adv
oktasaččat	åktåsattjat	adv
oktaseametteska	åktåseametteska	adv
okte	åkte	adv
oktege	åktege	adv
oktii	åktij	adv
oktiibuot	åktijbuot	adv
oktiigait	åktijgajt	adv
oktiige	åktijge	adv
oktiinjálmmiid	åktijnjálmijd	adv
oktiiráđiid	åktijrádijd	adv
oktilaččat	åktelattjat	adv
oktilassii	åktelassij	adv
oktilit	åktelet	adv
okto	åkto	adv
okto	åkto	adv
oktonassii	åktunassij	adv
oktooaivvis	åktooajvves	adv
oktoráđálaččat	åkturádálattjat	adv
olahagas	ålåhagas	adv
olahahkii	ålåhahkij	adv
olatmeahttumii	ålåtmeahttumij	adv
olatmeahttumis	ålåtmeahttumes	adv
olggobeale	ålgubeale	adv
olggobeali	ålgubeale	adv
olggobeale	ålgubeale	adv
olggobeallái	ålgubealláj	adv
olggos	ålgus	adv
olggossisa	ålgussisa	adv
olggubui	ålgubuj	adv
olggubuidda	ålgubujdda	adv
olggubus	ålgubus	adv
olggul	ålgul	adv
olgguldasat	ålguldasat	adv
olgolačča	ålggulattja	adv
olgolaččas	ålggulattjas	adv
olgolažžii	ålgguladtjij	adv
olgoleappos	ålgguleappos	adv
olgolebbui	ålggulebbuj	adv
olgoleppožii	ålgguleppotjij	adv
olgoleppožis	ålgguleppotjes	adv
olgolii	ålggulij	adv
olgoliidda	ålggulijdda	adv
olgolis	ålggules	adv
olgoráigge	ålggurájgge	adv
olgul	ålggul	adv
olgulačča	ålggulattja	adv
olgun	ålggun	adv
ollege	ållege	adv
ollenge	ållenge	adv
ollislaččat	ålleslattjat	adv
ollodagas	ålludagas	adv
ollodahkii	ålludahkij	adv
ollonaga	ållunaga	adv
ollu	ållo	adv
ollunága	ållunága	adv
ollásii	ållåsij	adv
ollát	ållåt	adv
olu	ålo	adv
olus	ålus	adv
olámuddui	ålåmudduj	adv
olámuttos	ålåmuttos	adv
on	ån	adv
oŋ	åŋ	adv
oppa	åppå	adv
oppalaččat	åppålattjat	adv
oppalohkái	åppålohkáj	adv
oppanassii	åppånassij	adv
opparat	åppårat	adv
optimalalaččat	åptemalalattjat	adv
orddil	årdel	adv
orot	årut	adv
oskkáldasat	åskåldasat	adv
osohahkii	åsuhahkij	adv
otne	ådne	adv
otnánaga	ådnånaga	adv
ovccádassii	åvttsådassij	adv
ovccádis	åvttsådes	adv
ovdagihtii	åvddågihtij	adv
ovdalgihtii	åvddålgihtij	adv
ovdal	åvddål	adv
ovdalaš	åvddålasj	adv
ovdalaš	åvddålasj	adv
ovdaleappos	åvddåleappos	adv
ovdalebbui	åvddålebbuj	adv
ovdaleppožii	åvddåleppotjij	adv
ovdaleppožis	åvddåleppotjes	adv
ovdalii	åvddålij	adv
ovdaliidda	åvddålijdda	adv
ovdalis	åvddåles	adv
ovdan	åvddån	adv
ovdanruoktot	åvddånruoktot	adv
ovdasanatis	åvddåsanates	adv
ovdabeallái	åvddåbealláj	adv
ovdabealde	åvddåbealde	adv
ovddabealde	åvdåbealde	adv
ovddabeale	åvdåbeale	adv
ovddabeallai	åvdåbeallaj	adv
ovddageahčai	åvdågeahtjaj	adv
ovddageahčen	åvdågeahtjen	adv
ovddalgihtii	åvdålgihtij	adv
ovddas	åvdås	adv
ovddemus	åvdemus	adv
ovddemusat	åvdemusat	adv
ovddemustá	åvdemustá	adv
ovddežis	åvdetjes	adv
ovddibui	åvdebuj	adv
ovddibuidda	åvdebujdda	adv
ovddibus	åvdebus	adv
ovddimustá	åvdemustá	adv
ovddimus	åvdemus	adv
ovddos	åvdus	adv
ovddosguvlui	åvdusguvluj	adv
ovddosguovlluid	åvdusguovllujd	adv
ovddosmaŋás	åvdusmaŋás	adv
ovddosii	åvdusij	adv
ovdelis	åvddeles	adv
ovdán	åvddån	adv
ovstalii	åvsstålij	adv
ovstalis	åvsståles	adv
ovstan	åvsstån	adv
ovsttas	åvstås	adv
ovtta	åvtå	adv
ovttaidovttaid	åvtåjdovttajd	adv
ovttaid-ovttaid	åvtåjd-åvtåjd	adv
ovttafáru	åvtåfáru	adv
ovttajienalaččat	åvtåjienalattjat	adv
ovttaládje	åvtåládje	adv
ovttaláhkai	åvtåláhkaj	adv
ovttaláhkái	åvtåláhkáj	adv
ovttamađe	åvtåmade	adv
ovttamielas	åvtåmielas	adv
ovttamielalaččat	åvtåmielalattjat	adv
ovttas	åvtås	adv
ovttasráđiid	åvtåsrádijd	adv
ovttatládje	åvtåtládje	adv
ovttatláhkái	åvtåtláhkáj	adv
ovttatmano	åvtåtmano	adv
ovttatmanu	åvtåtmanu	adv
ovttatmanos	åvtåtmanos	adv
ovtto	åvto	adv
ovttohii	åvtuhij	adv
ovttotládje	åvtutládje	adv
peanta	pientta	adv
persovnnalaččat	perssuvnalattjat	adv
presto	pressto	adv
raddálagaid	raddálagajd	adv
rahpil	rahpel	adv
rančut	rantjut	adv
rastá	rasstá	adv
rastá	rasstá	adv
ravdal	ravddal	adv
ravdalačča	ravddalattja	adv
ravdalaččas	ravddalattjas	adv
ravdalažžii	ravddaladtjij	adv
ravdaleappos	ravddaleappos	adv
ravdalebbui	ravddalebbuj	adv
ravdaleppožii	ravddaleppotjij	adv
ravdaleppožis	ravddaleppotjes	adv
ravdalii	ravddalij	adv
ravdaliidda	ravddalijdda	adv
ravdalis	ravddales	adv
ravddabui	ravdabuj	adv
ravddabuidda	ravdabujdda	adv
ravddabus	ravdabus	adv
ravddagit	ravdaget	adv
reahccut	riehttsut	adv
reaida	riejdda	adv
reaŋggaš	rieŋgasj	adv
reavžut	rievttjut	adv
riđus	ridus	adv
riddolačča	riddulattja	adv
riddolaččas	riddulattjas	adv
riddolaččas.	riddulattjas.	adv
riddolaš	riddulasj	adv
riddolažžii	ridduladtjij	adv
riddoleappos	ridduleappos	adv
riddoleappos.	ridduleappos.	adv
riddolebbui	riddulebbuj	adv
riddolebbui	riddulebbuj	adv
riddolii	riddulij	adv
riddoliidda	riddulijdda	adv
riddolis	riddules	adv
rievttuid	rievtujd	adv
riikkaidgaskasaččat	rijkajdgaskasattjat	adv
rihccut	rihttsut	adv
rihcojulggiid	rihtsujulggijd	adv
rinčut	rintjut	adv
rindeozaid	rinddeotsajd	adv
ristut	risstut	adv
rittubui	rittubuj	adv
rittubuidda	rittubujdda	adv
rivašilljá	rivatjilljá	adv
rivvosii	rivvusij	adv
roahkil	roahkel	adv
roaibbonjálmmiid	roajbunjálmijd	adv
roaibut	roajbbut	adv
roamššil	roamsjel	adv
roaŋkkil	roaŋkel	adv
roaŋkut	roaŋkkut	adv
roanccil	roantsel	adv
roancut	roanttsut	adv
roavččil	roavtjel	adv
roavkkul	roavkul	adv
roggut	råggut	adv
rokkil	råkkel	adv
romet	råmet	adv
ruibbonjálmmiid	rujbunjálmijd	adv
ruibut	rujbbut	adv
ruksessidjii	ruksessidjij	adv
rumppis	rumpes	adv
rumpái	rumppáj	adv
ruoktot	ruoktut	adv
ruoššabealde	ruossjabealde	adv
ruossalassii	ruossalassij	adv
ruoŧabealde	ruotabealde	adv
ruovttogežiid	ruovtugetjijd	adv
ruovttogillii	ruovtugillij	adv
ruovttoguvlui	ruovtuguvluj	adv
ruovttoluotta	ruovtuluotta	adv
ruovttoládje	ruovtuládje	adv
ruovttotgežiid	ruovtutgetjijd	adv
ruššojit	russjujet	adv
russolassii	russulassij	adv
ruvgalassii	ruvggalassij	adv
ruvžžal	ruvtjal	adv
rábášnaga	rábásjnaga	adv
ráđđasii	ráddasij	adv
ráđđasis	ráddases	adv
rádjai	rádjaj	adv
rádjái	rádjáj	adv
rádjálagaid	rádjálagajd	adv
ráđđálagaid	ráddálagajd	adv
ráfálaččat	ráfálattjat	adv
rái	ráj	adv
ráidnasit	rájnnaset	adv
ráigeráigge	rájggerájgge	adv
ráigge	rájge	adv
ráiggil	rájgel	adv
rájis	rájes	adv
rámppaid	rámpajd	adv
rámskkil	rámskel	adv
šahtain	sjahtajn	adv
šat	sjat	adv
šatain	sjatájn	adv
šet	sjet	adv
šieđus	sjiedus	adv
šiehppun	sjiehppun	adv
šiehppunassii	sjiehppunassij	adv
šiehpus	sjiehpus	adv
šiehput	sjiehput	adv
šlumpa	slumppa	adv
šluppul	sluppul	adv
šnjorrosii	sjnjårrusij	adv
šnjuoggut	sjnjuoggut	adv
šnjuokkil	sjnjuokkel	adv
sadjagassii	sadjagassij	adv
sadjosii	sadjusij	adv
sadjosis	sadjuses	adv
sajis	sajes	adv
sajusláhkai	sajusláhkaj	adv
sallalagaid	sallalagajd	adv
seahkesearválaga	siehkesearválaga	adv
seahkálaga	sæhkálaga	adv
seahkálagaid	sæhkálagajd	adv
seahkalagaid	siehkalagajd	adv
seaidnelačča	siejnnelattja	adv
seaidnelaččas	siejnnelattjas	adv
seaidnelaš	siejnnelasj	adv
seaidnelažžii	siejnneladtjij	adv
seaidneleappos	siejnneleappos	adv
seaidnelebbui	siejnnelebbuj	adv
seaidneleppožii	siejnneleppotjij	adv
seaidneleppožis	siejnneleppotjes	adv
seaidnelii	siejnnelij	adv
seaidneliidda	siejnnelijdda	adv
seaidnelis	siejnneles	adv
seaidnil	siejnnel	adv
seaiga	siejgga	adv
seainna	siejna	adv
seainnibui	siejnebuj	adv
seainnibuidda	siejnebujdda	adv
seainnibus	siejnebus	adv
sealgga	sielga	adv
sealggabeale	sielgabeale	adv
sealggabealde	sielgabealde	adv
sealggabeallái	sielgabealláj	adv
sealggebeale	sielgebeale	adv
sealggebealde	sielgebealde	adv
sealggebeallái	sielgebealláj	adv
selggobeale	selgubeale	adv
selggobealde	selgubealde	adv
selggobeallái	selgubealláj	adv
sealggálassii	sælgálassij	adv
sealgil	sielggel	adv
seammas	siemmas	adv
seammaláhkai	siemmaláhkaj	adv
seammaláhkái	siemmaláhkáj	adv
seammaládje	siemmaládje	adv
seammáláhkai	sæmmáláhkaj	adv
seammáládje	sæmmáládje	adv
seammás	sæmmás	adv
searválaga	særvválaga	adv
searválagaid	særvválagajd	adv
sekundáralaččat	sekundáralattjat	adv
selggo	selgo	adv
selggos	selgus	adv
siđvut	sirvvut	adv
sidjii	sidjij	adv
sieiga	siejgga	adv
sierraláhkai	sierraláhkaj	adv
sierranassii	sierranassij	adv
sihkkarit	sihkkaret	adv
siidolagaid	sijddulagajd	adv
sikkarit	sikkaret	adv
sisaboakkil	sisáboakkel	adv
sisabui	sisábuj	adv
sisabuidda	sisábujdda	adv
sisabus	sisábus	adv
siskabealde	sisskabealde	adv
siskabeallái	sisskabealláj	adv
siskelačča	sisskelattja	adv
siskelaččas	sisskelattjas	adv
siskelaš	sisskelasj	adv
siskelažžii	sisskeladtjij	adv
siskeleamos	sisskeleamos	adv
siskeleappos	sisskeleappos	adv
siskelebbui	sisskelebbuj	adv
siskeleppožii	sisskeleppotjij	adv
siskeleppožis	sisskeleppotjes	adv
siskelii	sisskelij	adv
siskeliidda	sisskelijdda	adv
siskelis	sisskeles	adv
siskelit	sisskelet	adv
siskil	sisskel	adv
siskka	siska	adv
siskkibui	siskebuj	adv
siskkibuidda	siskebujdda	adv
siskkibus	siskebus	adv
siskkil	siskel	adv
siskko	sisko	adv
siskkáldasat	siskáldasat	adv
siskálagaid	sisskálagajd	adv
siste	sisste	adv
sisttánátis	sistánátes	adv
sivjjogaš	sivjugasj	adv
sivvadaččat	sivvadattjat	adv
skaippil	skajpel	adv
skavžut	skavttjut	adv
skavžžil	skavtjel	adv
skeaŋkkas	skieŋkas	adv
skeavžut	skievttjut	adv
skiehkil	skiehkel	adv
skielgut	skielggut	adv
skihčil	skihtjel	adv
skivnnjil	skivnjel	adv
skoavddil	skoavdel	adv
skolppil	skålpel	adv
skuhčut	skuhtjut	adv
skuibbil	skujbel	adv
skuibut	skujbbut	adv
skurdnjut	skurnnjut	adv
skužil	skutjel	adv
smarffil	smarfel	adv
smarvvil	smarvel	adv
smilččil	smiltjel	adv
smuhččut	smuhttjut	adv
smuhčil	smuhtjel	adv
smávvásiid	smávvásijd	adv
sneakta	sniekta	adv
snogil	snågel	adv
snogástahkii	snågåstahkij	adv
snohkut	snåhkut	adv
snolkut	snålkkut	adv
snoril	snårel	adv
snurttul	snurtul	adv
snuvtut	snuvttut	adv
snáhppásit	snáhppáset	adv
snáittil	snájtel	adv
soabbegieđas	soabbegiedas	adv
soabbegihtii	soabbegihtij	adv
soamesiin	soamesijn	adv
sodjagasas	sådjågasas	adv
sodjagassii	sådjågassij	adv
sodjut	sådjut	adv
soggelačča	såggelattja	adv
soggelaččas	såggelattjas	adv
soggelaš	såggelasj	adv
soggelažžii	såggeladtjij	adv
soggeleappos	såggeleappos	adv
soggelebbui	såggelebbuj	adv
soggeleppožii	såggeleppotjij	adv
soggeleppožis	såggeleppotjes	adv
soggelii	såggelij	adv
soggeliidda	såggelijdda	adv
soggelis	såggeles	adv
soggil	såggel	adv
sojil	såjel	adv
sojul	såjul	adv
sokka	såkkå	adv
sokkibui	såkkebuj	adv
sokkibuidda	såkkebujdda	adv
sokkibus	såkkebus	adv
soril	sårel	adv
sorjjakeahttá	sårjåkeahttá	adv
sorragasas	sårrågasas	adv
sorragassii	sårrågassij	adv
sparrolagaid	sparrulagajd	adv
spiehččut	spiehttjut	adv
spiehčil	spiehtjel	adv
spileš	spilesj	adv
spillui	spilluj	adv
starga	stargga	adv
stohporáigge	ståhpurájgge	adv
stáđđásit	stáddáset	adv
suige	sujgge	adv
sulaid	sulájd	adv
sulain	sulájn	adv
sullalagaid	sullalagajd	adv
sullii	sullij	adv
sulli	sulle	adv
sulsullii	sulssullij	adv
summalis	summales	adv
summalit	summalet	adv
suohkadit	suohkadet	adv
suohkkogerddiid	suohkkugerddijd	adv
suohkkojuolggis	suohkkujuolgges	adv
suoibma	suojmma	adv
suoimmal	suojmal	adv
suolggaid	suolgajd	adv
suoli	suole	adv
suolivuoli	suolevuole	adv
suollit	suollet	adv
suollugit	suolluget	adv
suoril	suorel	adv
suvdálaga	suvddálaga	adv
sáhkalagaid	sáhkalagajd	adv
sákkil	sákkel	adv
sálbolagaid	sálbbulagajd	adv
sálbut	sálbbut	adv
sárdnumassii	sárnnumassij	adv
sáttonaga	sáttunaga	adv
sávnnjil	sávnjel	adv
sávvamis	sávvames	adv
teahtta	tiehtta	adv
tiimmahala	tijmahala	adv
uhccán	uhttsán	adv
uhccánaš	uhttsánasj	adv
uhces	uhtses	adv
uhcesii	uhtsesij	adv
uhcibut	uhtsebut	adv
uhcimus	uhtsemus	adv
uhcimusat	uhtsemusat	adv
uhcimusge	uhtsemusge	adv
uhcimustá	uhtsemustá	adv
uhcit	uhtset	adv
uhcán	uhtsán	adv
uhcánaččaid	uhtsánattjajd	adv
uhcánaš	uhtsánasj	adv
uhcánii	uhtsánij	adv
uhtesii	uhtesij	adv
uksalačča	uksalattja	adv
uksalaččas	uksalattjas	adv
uksalaš	uksalasj	adv
uksalažžii	uksaladtjij	adv
uksalebbui	uksalebbuj	adv
uksaleppožii	uksaleppotjij	adv
uksaleppožis	uksaleppotjes	adv
uksalii	uksalij	adv
uksaliidda	uksalijdda	adv
uksalis	uksales	adv
unnibut	unnebut	adv
unnimus	unnemus	adv
unnimusat	unnemusat	adv
unnimustá	unnemustá	adv
unnit	unnet	adv
unnánaččaid	unnánattjajd	adv
unnánii	unnánij	adv
uskelačča	usskelattja	adv
uskelaččas	usskelattjas	adv
uskelaš	usskelasj	adv
uskelažžii	usskeladtjij	adv
uskeleappos	usskeleappos	adv
uskelebbui	usskelebbuj	adv
uskeleppožii	usskeleppotjij	adv
uskeleppožis	usskeleppotjes	adv
uskelii	usskelij	adv
uskeliidda	usskelijdda	adv
uskelis	usskeles	adv
uskil	usskel	adv
uskin	ussken	adv
uskkos	uskus	adv
uvssobealde	uvsubealde	adv
uvssobeale	uvsubeale	adv
uvssobeallai	uvsubeallaj	adv
uvssogeahčai	uvsugeahtjaj	adv
uvssogeahčen	uvsugeahtjen	adv
uvssos	uvsus	adv
vahkkobotta	vahkkubotta	adv
vahkkosaččat	vahkkusattjat	adv
vahkkoviissaid	vahkkuvijssajd	adv
vajos	vajus	adv
vajot	vajut	adv
vakŋut	vagŋut	adv
valjis	valjjes	adv
valjit	valjjet	adv
vaŋkut	vaŋkkut	adv
varasnaga	varásnaga	adv
varga	vargga	adv
vargahui	varggahuj	adv
vargui	vargguj	adv
varrasis	varrases	adv
vatnagasas	vadnagasas	adv
vatnagassii	vadnagassij	adv
váidagahttá	vájddagahttá	adv
vávda	vávdda	adv
veaddagasas	vieddagasas	adv
veaddagassii	vieddagassij	adv
veaddagii	vieddagij	adv
veaddagis	vieddages	adv
veagal	viegal	adv
veahkaválddil	viehkaválddel	adv
veahkkálagaid	væhkkálagajd	adv
veahkájo	væhkájo	adv
veahttasit	viehttaset	adv
veahá	væhá	adv
veaiddalassii	viejdalassij	adv
veaiddalis	viejdales	adv
veaittalassii	viejtalassij	adv
vealggás	vælgás	adv
veallut	viellut	adv
vealttakeahttá	vieltakeahttá	adv
veanzut	vienttsut	adv
veanzzil	vientsel	adv
vearis	vieres	adv
veastal	viesstal	adv
veastalabbos	viesstalabbos	adv
veastalabbui	viesstalabbuj	adv
veastalačča	viesstalattja	adv
veastalaččas	viesstalattjas	adv
veastalažžii	viesstaladtjij	adv
veastalii	viesstalij	adv
veastaliidda	viesstalijdda	adv
veastalis	viesstales	adv
veastan	viesstan	adv
veasttabealde	viestabealde	adv
veasttabeale	viestabeale	adv
veasttabeallai	viestabeallaj	adv
veasttabui	viestabuj	adv
veasttabuidda	viestabujdda	adv
veasttabus	viestabus	adv
veasttal	viestal	adv
veasttas	viestas	adv
veháš	vehásj	adv
vehážiid	vehátjijd	adv
vejolaččat	vejulattjat	adv
velábusnai	velábusnaj	adv
viđadassii	vidádassij	adv
viđadis	vidádes	adv
viehkanlávkái	viehkanlávkáj	adv
vieljaš	vieljjasj	adv
vielttil	vieltel	adv
viesttarbealde	viestarbealde	adv
viesttarbeale	viestarbeale	adv
viesttarbeallai	viestarbeallaj	adv
viesttargeahčai	viestargeahtjaj	adv
viesttargeahčen	viestargeahtjen	adv
viežžanládje	viedtjanládje	adv
vihttii	vihttij	adv
viidnanaga	vijnnanaga	adv
viidnenaga	vijnnenaga	adv
viidáseappot	vijddáseappot	adv
viidát	vijddát	adv
viiddásat	vijdásat	adv
viiddáseappot	vijdáseappot	adv
viimmat	vijmat	adv
viidáset	vijddáset	adv
viidásit	vijddáset	adv
viisásit	vijssáset	adv
viivvuheamet	vijvuheamet	adv
vilbeleš	vilbbelesj	adv
vinjil	vinjel	adv
virramii	virramij	adv
visot	visut	adv
visožit	visutjet	adv
vissásii	vissásij	adv
vitnjalassii	vidnjalassij	adv
vitnjut	vidnjut	adv
vivaš	vivasj	adv
vuhkohagaid	vuhkuhagajd	adv
vuhtii	vuhtij	adv
vuiges	vujgges	adv
vuigestaga	vujggestaga	adv
vulobealde	vulubealde	adv
vulobeale	vulubeale	adv
vulobeallai	vulubeallaj	adv
vulogeahčai	vulugeahtjaj	adv
vulogeahčen	vulugeahtjen	adv
vulogeaže	vulugeatje	adv
vulos	vulus	adv
vuogálaččat	vuogálattjat	adv
vuohččan	vuohttjan	adv
vuohkkasit	vuohkkaset	adv
vuohon	vuohun	adv
vuoiddasnaga	vuojdasnaga	adv
vuoiga	vuojgga	adv
vuoikka	vuojka	adv
vuolibučča	vuolebuttja	adv
vuolibuččas	vuolebuttjas	adv
vuolibui	vuolebuj	adv
vuolibuidda	vuolebujdda	adv
vuolibus	vuolebus	adv
vuolibuš	vuolebusj	adv
vuolibužžii	vuolebudtjij	adv
vuolil	vuolel	adv
vuolimus	vuolemus	adv
vuollai	vuollaj	adv
vuollegaččat	vuollegattjat	adv
vuollelačča	vuollelattja	adv
vuollelaččas	vuollelattjas	adv
vuollelaš	vuollelasj	adv
vuollelaš	vuollelasj	adv
vuollelažžii	vuolleladtjij	adv
vuollelebbui	vuollelebbuj	adv
vuolleleppožii	vuolleleppotjij	adv
vuolleleppožis	vuolleleppotjes	adv
vuollelii	vuollelij	adv
vuolleliidda	vuollelijdda	adv
vuollelis	vuolleles	adv
vuollelit	vuollelet	adv
vuollil	vuollel	adv
vuollin	vuollen	adv
vuollugit	vuolluget	adv
vuollái	vuolláj	adv
vuollálagaid	vuollálagajd	adv
vuolábeallai	vuolábeallaj	adv
vuolágeahčai	vuolágeahtjaj	adv
vuolágeahčen	vuolágeahtjen	adv
vuolágeaže	vuolágeatje	adv
vuonabui	vuonabuj	adv
vuonabuidda	vuonabujdda	adv
vuordagasas	vuorddagasas	adv
vuorjjit	vuorjet	adv
vuosseállái	vuosseálláj	adv
vuoste	vuosste	adv
vuosteasiid	vuossteasijd	adv
vuostebeaivái	vuosstebeajváj	adv
vuostečomil	vuosstetjomel	adv
vuostečáhcái	vuosstetjáhtsáj	adv
vuostegobil	vuosstegobel	adv
vuostegulgii	vuosstegulgij	adv
vuostejohtimii	vuosstejohtimij	adv
vuostelii	vuosstelij	adv
vuostelis	vuossteles	adv
vuostemurrii	vuosstemurrij	adv
vuosteoalgái	vuossteoalgáj	adv
vuosterávdnjái	vuossterávnnjáj	adv
vuostil	vuosstel	adv
vuosttabealde	vuostabealde	adv
vuosttabeale	vuostabeale	adv
vuosttabeallai	vuostabeallaj	adv
vuosttain	vuostajn	adv
vuosttamustá	vuostamustá	adv
vuosttažettiin	vuostatjettijn	adv
vuosttažettiin	vuostatjettijn	adv
vuostten	vuosten	adv
vuosttil	vuostel	adv
vuosttás	vuostás	adv
vuostái	vuosstáj	adv
vuostálagaid	vuosstálagajd	adv
vuotnal	vuodnal	adv
vuotnalačča	vuodnalattja	adv
vuotnalaččas	vuodnalattjas	adv
vuotnalaš	vuodnalasj	adv
vuotnalažžii	vuodnaladtjij	adv
vuotnaleappos	vuodnaleappos	adv
vuotnalebbui	vuodnalebbuj	adv
vuotnaleppožii	vuodnaleppotjij	adv
vuotnaleppožis	vuodnaleppotjes	adv
vuotnalii	vuodnalij	adv
vuotnaliidda	vuodnalijdda	adv
vuotnalis	vuodnales	adv
vuotnámaš	vuodnámasj	adv
vuotton	vuottun	adv
vuovddal	vuovdal	adv
vuovddehussii	vuovdehussij	adv
vuovderáigge	vuovdderájgge	adv
vuovdemassii	vuovddemassij	adv
vuovdimassii	vuovddemassij	adv
vuovdinláhkai	vuovddenláhkaj	adv
vurjjet	vurjet	adv
vurohagaid	vuruhagajd	adv
vurrolagaid	vurrulagajd	adv
vurrolaga	vurrulaga	adv
vurrola	vurrula	adv
vurrol	vurrul	adv
vuvdojupmái	vuvddujupmáj	adv
vácci	váttse	adv
vádjit	vádjet	adv
váibamassii	vájbbamassij	adv
váile	vájle	adv
váilevaččat	vájlevattjat	adv
váillil	vájllel	adv
váimmobáhkasnaga	vájmubáhkasnaga	adv
váimmoguovdo	vájmuguovdo	adv
válbmasii	válmmasij	adv
vánit	vánet	adv
váraid	várájd	adv
váras	várás	adv
vári	váre	adv
váribui	várebuj	adv
váribuidda	várebujdda	adv
váribus	várebus	adv
várrelačča	várrelattja	adv
várrelaččas	várrelattjas	adv
várrelaš	várrelasj	adv
várrelažžii	várreladtjij	adv
várrelebbui	várrelebbuj	adv
várreleppožii	várreleppotjij	adv
várreleppožis	várreleppotjes	adv
várrelii	várrelij	adv
várreliidda	várrelijdda	adv
várrelis	várreles	adv
várril	várrel	adv
várrogasat	várrugasat	adv
vásedin	váseden	adv
vátneviša	vádnevisja	adv
áđamusat	ádámusat	adv
áddemeahttumit	áddemeahttumet	adv
áhčeš	áhtjesj	adv
áhkkorat	áhkkurat	adv
áhkáš	áhkásj	adv
áibbas	ájbas	adv
áiddo	ájdo	adv
áiddobeliid	ájdubelijd	adv
áiggebále	ájgebále	adv
áiggelassii	ájgelassij	adv
áigges	ájges	adv
áiggil	ájgel	adv
áiggokeahttá	ájgukeahttá	adv
áigovaččat	ájgguvattjat	adv
áigá	ájggá	adv
áigálii	ájggálij	adv
áimmuide	ájmujde	adv
áin	ájn	adv
áinnas	ájnas	adv
áinnaš	ájnasj	adv
álbmogassii	álmmugassij	adv
álebuš	álebusj	adv
álelassii	álelassij	adv
álfárot	álffárot	adv
álfárut	álffárut	adv
álggage	álgage	adv
álggogeahčai	álgugeahtjaj	adv
álggogeahčen	álgugeahtjen	adv
álggos	álgus	adv
álgobáliid	álggubálijd	adv
álggugeahčen	álgugeahtjen	adv
álgočalbmái	álggutjalmmáj	adv
álgogeahčai	álggugeahtjaj	adv
álgogeahčen	álggugeahtjen	adv
álgoálggos	álggoálggos	adv
álguige	álggujge	adv
álgáge	álggáge	adv
áli	ále	adv
álohii	áluhij	adv
álolaččat	álulattjat	adv
áloládje	áluládje	adv
álot	álut	adv
álas	álás	adv
álásin	álásen	adv
bealleálásin	bielleálásen	adv
ándagassii	ánddagassij	adv
árabui	árábuj	adv
árabuidda	árábujdda	adv
árabuš	árábusj	adv
árgaiđedis	árggajdedes	adv
árgget	árget	adv
árkkit	árket	adv
árpmoheamit	ármuheamet	adv
árradit	árradet	adv
árvalusas	árvvalusas	adv
ávccá	ávttsá	adv
ávjjul	ávjul	adv
ávjolassii	ávjjulassij	adv
álkibut	álkkebut	adv
álkimusat	álkkemusat	adv
álkit	álkket	adv
buoragit	buoraget	adv
siivvožit	sijvutjet	adv
siivvus	sijvus	adv
siivobut	sijvvubut	adv
siivomusat	sijvvumusat	adv
siivvubut	sijvubut	adv
siivvumusat	sijvumusat	adv
siivvut	sijvut	adv
siivot	sijvvut	adv
vearrut	vierrut	adv
vearrábut	værrábut	adv
vearábut	værábut	adv
vearrámusat	værrámusat	adv
vearámusat	værámusat	adv
julga	julgga	adv
julggabut	julgabut	adv
julggamus	julgamus	adv
julggamusat	julgamusat	adv
julggamusta	julgamusta	adv
stuoribut	stuorebut	adv
stuorimusat	stuoremusat	adv
stuorimustá	stuoremustá	adv
eanemus	ienemus	adv
eanemustá	ienemustá	adv
eanet	ienet	adv
eanot	ienut	adv
farggabut	fargabut	adv
farggamus	fargamus	adv
farggamusat	fargamusat	adv
hárve	hárvve	adv
hárvvet	hárvet	adv
hárvvibut	hárvebut	adv
hárvvimusat	hárvemusat	adv
hárvvit	hárvet	adv
rievttabut	rievtabut	adv
rievttamus	rievtamus	adv
lagabut	lagábut	adv
lagamustá	lagámustá	adv
lagat	lagát	adv
árabut	árábut	adv
áramus	árámus	adv
áramusat	árámusat	adv
áramustá	árámustá	adv
árat	árát	adv
guhkimus	guhkemus	adv
guhkimusat	guhkemusat	adv
guhkimustá	guhkemustá	adv
guhkit	guhket	adv
guhkibut	guhkebut	adv
dávjá	dávjjá	adv
dávjábut	dávjjábut	adv
dávjámusat	dávjjámusat	adv
dávjjibut	dávjebut	adv
dávjjimus	dávjemus	adv
dávjjimustá	dávjemustá	adv
dárkket	dárket	adv
dárkkibut	dárkebut	adv
dárkkit	dárket	adv
dárkkit	dárket	adv
dárkkimusat	dárkemusat	adv
