anglifieret	anglefeerit,anglifierit	v
arvvašit	arvatjit,harvasjit	v
banihit	banedit,bånedit	v
banistit	banestit,bånestit	v
beaggalit	bieggalit,bæggalit	v
bievladit	bievladit,bievlladit	v
biiadit	biejadit,bijádit	v
biiahit	biejadit,bijádit	v
biiastit	biejastit,bijástit	v
bivssastit	bivsastit,snavkastit	v
bloggestit	bloggestit,blåggistit	v
boarásmit	boarásmuvvat,vuorasduvvat	v
borastit	bårstit,båråstit	v
borddašit	bårdatjit,bårdåtjit	v
bosihit	båsodit,båsådit	v
bovdehit	bivddidit,gåhtjodit	v
boŋkalit	båŋŋkkålit,båŋŋkålit	v
bálkáhit	bálkkidit,bálkkit	v
cahkiidit	tsahkkidit,tsahkkijdit	v
deaivvadit	iejvvidit,æjvvalit	v
dovddastit	dåbdåstit,dåvdåstit	v
gallidit	galledit,gallehit	v
galmmašit	galmatjit,tjåskijdit	v
gokčat	gábttjat,gåbttjåt	v
govddidit	gåbdedit,gåvdedit	v
guhkedit	guhkedit,guhkidit	v
gumppostit	gumpostit,gámssit	v
gumppustit	gumpostit,gámssit	v
guoskadit	guoskadit,guosskadit	v
gáludit	gievdadit,gálodit	v
gárvodit	gárvodit,gárvvudit	v
hilggodit	hilgodit,hilgudit	v
humadit	sáhkadit,ságastit	v
illudit	illodit,illudit,ávvudallat	v
jalihit	jaledit,juhtsalit	v
jienihit	jienadit,jienedit	v
joazihit	joatsedit,juhtsalit	v
jorggihit	jårgedit,jårgijdit	v
julahit	juhtsádit,juládit	v
juojgadit	juoiggadit,juoiggahit	v
leađggehit	liergedit,sliergedit	v
leađggihit	liergedit,sliergedit	v
livvudit	livodit,livvodit	v
lokkodit	låkkudit,njalludit	v
náđđadit	nahtadit,navddadit	v
oalistit	goalestit,oalestit	v
ravgadit	ravgadit,ravggadit	v
spiidneguođohit	svijnneguododi,spijnneguododit	v
sárggodit	sárgodit,sárgudit	v
vaiadit	vajádit,vajádit	v
veallahit	vellahit,vællahit	v
válddahit	buojkodit,gåvvidit,váldadit	v
čeakŋuhit	tjieggŋidit,tjiegŋodit	v
čolggahit	tjålggådit,tjålgådit	v
