adopšuvdna	adopsjåvnnå
Afghanistan	Afghanistánna, Afghanistádna
Afghanistan islamlaš dásseváldi	Afghanistánna, Afghanistádna
Afghanistan islámalaš dásseváldi	Afghanistánna, Afghanistádna
Albania	Albádna, Albánna
Albania dásseváldi	Albádna, Albánna
Albánia	Albádna, Albánna
Algeria	Algeria
Algeria demokráhtalaš álbmotdásseváldi	Algeria
alit	alek
alitdohpi	njavllerásse
alitvuodjalasta	njavllerásse
alitvuojaš	stuorvuojatjis
almmifierca	mægástahka, almevierttsa
almmivierca	mægástahka, almevierttsa
ambulánsa	ambulánssa
Andorra	Andårrå
Andorra prinsipáhta	Andårrå
Andorrá	Andårrå
Angola	Angåvllå
Angola dásseváldi	Angåvllå
anteanna	antennja, antænnjo, antännja
Antigua ja Barbuda	Antijgga ja Barbuvdda
aŋŋálakkis	haŋŋá
Aotearoa	Ådå Zealánnda, Aoteárra
appelsiidna	appelsijnna
Argentiinná	Argentijnna
Argentiinná dásseváldi	Argentijnna
Argentina	Argentijnna
Argentina dásseváldi	Argentijnna
Armenia	Armiedna, Armenna
aseksuála	asexuellak, aseksuellak
atninčilgehus	álkkes bagádusásj, åni bagádus, adnembagádusásj, bagádusásj, aktijbiedjambagádus
Australia	Austrálla
Austrália	Austrálla
aviisa	avijssa, tidnik
Azerbaižan	Azerbajádna, Azerbajánna
ábegáhttu	áhppa
áddjá	áddjá
áhčči	áhttje
áhkku	áhkko
áhpedovtta	áhpedavek
áhpehávda	áhpeávdda
áhpespálfu	áhpefálffo
áibmi	ájmme
áiti	njalla
ákšu	áksjo
ákta	ávdda
álbmotmeahcci	luonndoárjudahka
álggaheapmi	álgadibme
álgovuorru	vuostasj oasse
árran	árran
ássanguoibmi	aktanårro
bađošgaccet	badojgattsak
Bahamasullot	Bahábma
Bahrain	Bahrájnna
bahta	bahta
bakku	bákkoj
baloŋŋa	balloaŋŋa
banána	banádna
Bangladesh	Bangladässja, Bangladæssja
Barbados	Barbadåvsså
bargit	bargge
bargolohpi	barggamloahpe
bargooahppi	viddnooahppe
bargoveahka	bargge
basadanlatnja	báda
bassangárri	bassamgárre
baste	bassti
batteriija	bátteriddja, batterijja
báhtter	bátteriddja, batterijja
báiski	skávlle, skákle
báittohat	offsájdda
bákterásttis	stuorrástes, rástes
bárdni	báhttja
bárgidit	bárggedit, bárggeldit
bátnegealas	bádnegella
bátnejuvla	bádnevierra, bádnejuvlla
bátneráhtis	bádnevierra, bádnejuvlla
bátni	bádne
bávgoš	råhkån
beahceloddi	goahppel
beahceloddi	tjuktje
beaiveloddi	biejvvelådde
beaiveruhta	biebbmomávsálvis
beaiveruoktu	mánájåroj
bealjjeoarádat	ålgop bielljerájgge
bealljebunci	bielljesnáhppá
bealljeculci	bielljesnáhppá
bealljerásttis	bielljerástes
beallji	biellje
beana	bena
beaska	muoddá
beassankoarta	bessamkårttå
beassansátni	bessambáhko
beassi	biesse
beasterages	sjvatjik
beavdi	bievdde
beibboš	bejbusj
Belgia	Bælgga, Bälgga
belko	skuolkká
belljosat	jiednabeljas
Benin	Benijnna
bensiidna	bensijnna
bensinstašuvdna	bensinstasjåvnnå
beskkoš	fálffo
beštor	fálffo
beštor	sjvatjik
Bhutan	Bhutádna, Bhutánna
bibbadirri	hudi
biebmomáksu	biebbmomávsálvis
biebmoruhta	biebbmomávsálvis
biegga	biegga
bieggajorri	bieggamilla, bieggajårun, bieggamillo
bieggamillo	bieggamilla, bieggajårun, bieggamillo
bieggamillu	bieggamilla, bieggajårun, bieggamillo
biehkan	boajmásj
biekčavuojaš	vuojatjis
bierdna	biernna
bigán	idjasjkunjok
bihkka	darvve
biikagoašku	sákkásjjudos
biila	bijlla
biilagoavdi	karoassa
bikkobávkos	jullur
bileahttaautomáhtta	billæhttaautomáhtta, biljähttaautomáhtta, besalvisautomáhtta
bileahtta	besalvis, billæhtta, biljähtta
bivttastit	gárvodit
bižus	hudi
bláđet	sláddit
boađus	boados
boaimmáš	boajmásj
boallobeavdi	boallobievdde, tastatuvrra, tangänntabievdde
boanda	båndor
boardda	tráhppá
boazzi	dásse
boddu	båddå
bohttomeahkástat	vuovddemægástahka
bolfegaccet	guossagattsak
Bolivia	Bolijvva
bonju	queer
borjjasvanca	bårjåsvanntsa
Bosnia-Hercegovina	Båssnå ja Herzegovijnna
bovttaš	lunnde
bovttáš	lunnde
Brasil	Brasijlla
Brasilia	Brasijlla
Brunei	Brunedja, Bruniedja
buldagas	ruŋŋka, gárránis, ruovdagis
buldán	ruŋŋka, gárránis, ruovdagis
bulddagas	ruŋŋka, gárránis, ruovdagis
bulddán	ruŋŋka, gárránis, ruovdagis
bulddogas	ruŋŋka, gárránis, ruovdagis
buldogas	ruŋŋka, gárránis, ruovdagis
buldugas	ruŋŋka, gárránis, ruovdagis
Bulgaria	Bulgárra
bumbbaloddi	jieggeloavkko
bumpaloddi	jieggeloavkko
bunásuorsá	stuorvuojatjis
buohccibiila	ambulánssa
buoidecizáš	buojddegattsak
buoidegaccet	buojddegattsak
buollinseaidni	suoddjimsiejnne
buolža	dievvá
buorit juovllat	buorre javla
Buorit juovllat ja lihkolaš ođđa jagi!	Buorre javlla ja buorre ådåjahke!
buorre beaivi	buorre biejvve
buorre iđit	buorre idet
Buorre Sámi álbmotbeaivi!	Vuorbbe Sámij álmmukbiejvijn!
Buriid juovllaid ja lihkolaš ođđa jagi!	Buorre javlla ja buorre ådåjahke!
Burkina Faso	Burkijnna Fásso
bursa	burssa
Burundi	Burunndi
buser	gænssir
busgáhttu	gáhtto
bussá	gáhtto
busse	bussa
buvri	njalla
buvvedat	jullur
cagan	tsagán
cihcefálli	tsihtsehábak
cihceskuolfi	tsihtsesjkunjok
cizášfálli	dihttá
coahkkalit	dieddelit
Colombia	Colåmmbå
čagan	glivi
čalbmeláset	tjalmána, tjalmmeglása
čalbmi	tjalmme
čarkkus	råhkån
čáhcehátna	krádna
čáhcespálfu	råhkån
čáhpesčoavjeviroš	gieddetjuokkun
čáhppat	tjáppat, tjáhppat
čáhppesbuokčá	tjáhppisbuoktje
čáhppesčoavjegáddeviroš	gieddetjuokkun
čáhppesčoavji	gieddetjuokkun
čáhppesčoavžžu	tjáhppistjoavtjoj
čáhppesgaccet	tjáhppisgattsak
čáhppesgáranas	ruŋŋka, gárránis, ruovdagis
čáhppesrásttis	tjáhppisrástes
čáhppesvizar	tjáhppislávllo
čáihni	tjájnne
čálán	tjálan
čálihit	tjáledit, tjáledahttet
čállit sisa	låggit sisi
čáskadanbiila	jáddadimbijlla
čeaksa	tjeksa
čearret	tjierrek
čearrit	tjierrek
čiehkačievččasteapmi	tjiehkatjievtjastibme
čiehkaleavga	tjiehkaslávggá
čiekčanspábba	tjiektjamroahtto, tjiektjambállo
čiekčá	tjiekta
čierastat	tjerastahka
čierggesrásttis	bákterástes, diermmerástes
čievččastit spáppa	vuohtjet roahtov, tjievtjastit roahtov, vuohtjet bállov, tjievtjastit bállov
čievččastit	tjievtjastit
čiksa	riktja
čoađgi	tjoargge
čoaskudeapmi	galmmaskáhppa
čoavji	tjoajvve
čoavžu	ruoppsisjuolgtjoavtjoj
čogu	rájdam
čohkun	rájdam
čujuhit	tsaggat, tjaggat
čujuhuslinnjá	adræssalinnja, adræssasáhtso, adrässalinnja, adrässasáhtso
čukčá	goahppel
čuokkisčoahkku	girkesvuohta, tsahkkisvuohta
čuoldimat	vuojttogilbos, vuojttemgilbos, vuojttemgilpos, vuojttogilpos
čuonanskuolfi	tsihtsesjkunjok
čuonjá	vuovddegássa
čuonji	gássa
čuovga	lámmpo, tjuovgga
čurtebuvssat	truvsa
čurti	bahta
čuvla	vuolppo
dahkaluddat	dahkadallat
dallearka	dállik, tollærkka
darfegoahti	gábmá, lavnnjegoahte
darvi	darvve
davvebiegga	nuorttobiegga, nuortto
dábálaš gáccet	gadtsabidjá
dáhpa	dáhppudallam, vuojtádallam
dáhpehallat	masset
dáhpet	masset
dássedeaddu	jæbddadæddo, jäbddadäddo
deaddilastit	dieddelit
deaddilastit guktii	guokti dieddelit
deaggastoarbmaspálfu	áhpefálffo
dearbmebeskkoš	dermusj
dearbmerásttis	bákterástes, diermmerástes
dearvvašvuohta	varresvuohta
delfiidna	delfijnna
derpmoš	dermusj
dieđáhustávval	tábllo
diehppefiehta	diehppeviehtak
diehtojuohkintávval	tábllo
diehtotávval	tábllo
dieldá	tsagán
dielkoduvvá	duvvo
dieris	dieres
dihtorduolbbus	næhttatábllo, nähttatábllo, sláddimtábllo, sláddijiddje
dihtti	tsihtsehábak
diibmu	kloahkka
dioda	dijåvddå
dirrelihkáš	skillidahka
doapparlihtti	ruhtselihtte
dohkká	doahkko
dolgi	dålgge
dopmonjaman	dubmanjamán
dopmonoavki	dubmanjamán
dorski	jáddi
dovtta	davek, áhpetjuktje
duogŋat	duoggŋat
Duohtavuođa- ja soabahankommišuvdna	Duohtavuohta- ja såbadimkommisjåvnå
duokŋas	duogŋas
duopmár	duobmár
duoršu	stuorvuojatjis
duottarfálli	rievsakhábak
duottargarjá	ruŋŋka, gárránis, ruovdagis
duottarstohpu	várredåhpe
dustet	duosstot
eadni	ieddne
ealligovvateáhter	kino
eallinguoibmi	aktanårro
eanadatsuodjalanguovlu	árjudakduobda
eanansuodjalanguovlu	árjudakduobda
eanasuodjalanguovlu	árjudakduobda
eappel	ehpal
ebel	ehpal
e-boasta	e-poassta, e-påvsstå
el-culci	spihttokontákta, návllekontákta, tsáhkemkontákta
el-čuggestat	siejnnekontákta
elektrovnnalaš poasta	e-poassta, e-påvsstå
eretorrunáigi	ierijtvuohta, ieritvuohta
Eritrea	Eritredja
Etiopia	Etiåvppå
fabrihkka	fabrijkka, fabrihkka
faggi	vagge
fanas	vanntsa
fápmosirdin	fábmodålvudibme
fárgeheapmi	njálmostibme
fearrat	verrat
fidnooahppi	viddnooahppe
fielbmá	vielmes
fiellu	fiello
fierpmádat	værmádahka, värmmádahka
fierrut	fierrot
fierváčoavžžu	fiervvátjoavtjoj
fierváviroš	fiervvátjoavtjoj
fiila	fijlla
fiilu	fijllo
finála	finálla
firkkal	virkal
fiskat	visskat, visská
fiskesbeštor	visskásjvatjik
fiskesgaccebiehtár	buojddegattsak
fiskesgaccet	buojddegattsak
fiskesjievžžan	visskálávllo
fiskesvizar	visskálávllo
flamingot	flamiŋggot
friddjačievččasteapmi	buohttimtjievtjastibme, friddjatjievtjastibme
gaccebiehtár	gadtsabidjá
gaccepaš	gadtsabidjá
gaccet	gadtsabidjá
gahpervizar	tjáhppislávllo
gahpir	gahper
galbmaskábe	galmmaskáhppa
Gambia	Gámmba
garjá	vuoratjis
garramuitu	garraskierro
garraskearru	garraskierro
gaskarádjá	gasskogievlle
gaskarádjá	gasskolinnja
gaskkamuttu vuorru	båddå
gaskkas	gaskas
gavjanjaman	dubmanjamán
gazzareabbá	ráppes
gáddeviroš	skillidahka
gádjegaš	skávlle, skákle
gádjit	skávlle, skákle
gáfebánnu	káffagiebbme
gáfegievdni	káffagiebbme
gáffal	gáffil
gáhkkor	gurtte
gáhkku	gáhkko
gája	skávlle, skákle
gáldu	gálldo
gálggan	rájdam
gálvobiila	gálvvobijlla
gálvofanas	gálvvovanntsa
gáranas	ruŋŋka, gárránis, ruovdagis
gárggogoalsi	guorgojgoalsse
gárnagas	ruŋŋka, gárránis, ruovdagis
gárvodit	gárvodit
geađgerásttis	gierggerástes
geađgerišša	gierggeliejmme
geaksa	tjeksa
geardeviessu	viesso
geavahančilgehus	álkkes bagádusásj, åni bagádus, adnembagádusásj, bagádusásj, aktijbiedjambagádus
geavaheaddjinamma	addnenamma
geavla	træddjo
Georgia	Geårggå
gieddeleivvoš	gieddeurjjá
gieđasteapmi	giedastibme
giehtaanulaš	giehtadoajmme
giehta	giehta
giella	rikkas
gierdoduvvá	duvvo
gierdorásttis	bákterástes, diermmerástes
gievdni	skiello
gievkkan	gievkan
giiragássa	målsudahka
giirakássa	målsudahka
giira	målsun
giirastággu	målsun
giisá	gijssá
giitos eatnat	edna gijtto
gilot	jáddi
gilvobiila	gilposbijlla
gilvvagárdi	salljo
girdi	girdde
girdihámman	girddesalljo
girdihámman	girddesejvudahka
girdisáhpán	náhkkesoadje
girdišillju	girddesalljo
girdišillju	girddesejvudahka
girjelivkkár	girjaksnavkke
girji	girjje
girjoš	goahppel
gistu	gissto
gláse	vinndek
goahcančomaš	njoatsodahka
goahppil	goahppel
goahtemuorra	dägá, dægá
goaivunmašiidna	bállemmasjijnna
goallostit	sjåpkadit, sjåptjadit
goalšoruoššehas	ruohkoávllo
goalšovizar	ruohkoávllo
goarpa	ruŋŋka, gárránis, ruovdagis
goarrut	goarrot
goaskin	goasskem
gohččun	gåhttjom
gohppu	gåhppå
gollegahpir	låddegånågis, gållegahper
govva	gåvvå
govvaráidu	gåvvårájddo
gubbarastit	jållerdit, bullurdit, goabrrot
guhkká	giedjek
guikkut	guojkkagárek
Guinea	Guniddja
gumpegarjá	ruŋŋka, gárránis, ruovdagis
gumpegáranas	ruŋŋka, gárránis, ruovdagis
guoikgáhrit	guojkkagárek
guoikungárri	guojkkagárek
guollebáiski	skávlle, skákle
guollebivdi	guollebivdde
guollečearret	tjierrek
guolli	guolle
guorbmebiila	lásstabijlla
guorga	guorgga
guossagaccet	guossagattsak
guossa	guossa
guossavižár	guossalávllo
guovddáščiekči	gasskatjiektje
guovddášduostuheaddji	gasskatjiektje
guovddášgierdu	gasskogievlle
guovddášsáhcu	gasskolinnja
guovddášsárggis	gasskolinnja
guovssat	guovsak
guovža	biernna
gusagoalsi	gutsákgoalsse
gussagoalsi	gutsákgoalsse
gussa	gussa
guškel	stuorgussjká
guškil	gussjká, sjkussjki
guškil	stuorgussjká
guškkástat	gussjká, sjkussjki
guvgesruoksat	guovggisruoppsat
hahpat	liddno
haŋŋá	haŋŋá
háhka	háhka
háhkan	oasástallam, háhkuhibme
hálka	álkko
hárjehallan	hárjjidallam
hárjeheaddji	hárjjidalle
hávda	ávdda
hávdádeapmi	hávddádibme
hávdesadji	hávddesadje
hearvarássi	giedjek
heasta	hæssta, hässta
heasttafápmu	hässtafábmo, gäsánfábmo, hæsstafábmo, gæsánfábmo
heavvalastit	hivildit, hievvildit
heavval	hievvil, hivil
historjá	histårjjå, histåvrrå
hivssetbábir	hivsikpáhper
hivsset	hivsik
holga	mållahålggå
hurri	hurre
idjarásttis	rássjotsihtse
idjasoadjá	rássjotsihtse
iđidaččat	idetbåros, idedisbiebbmo
iđitbiebmu	idetbåros, idedisbiebbmo
iđitborramuš	idetbåros, idedisbiebbmo
India	Innda
Indonesia	Indonessa, Indoniessa
investeren	oasástallam, háhkuhibme
japánastoarbmaspálfu	Japanstoarmmofálffo
jáddadanbiila	jáddadimbijlla
jáhkka	jáhkka
jávresopmir	skávlle, skákle
jeaggefálli	jieggehábak
jeaggehahpat	jieggeloavkko
jeaggehávut	jieggehábak
jeaggeloatku	jieggeloavkko
jeaggemeahkástat	jieggemægástahka
jiekŋa	jiegŋa
jievjaskuolfi	guvggo
joatkkaoahppu	joarkkaåhpadus
jođihanfápmu	giessemfábmo, dåjmadimfábmo, jådedimfábmo, vuojedimfábmo
jođihanjuvla	giessemvierra, vuojedimvierra, dåjmadimvierra, jådedimvierra
jođihanreaibma	giessemrájppe, dåjmadimrájppe, vuojedimrájppe, jådedimrájppe
jođihanruopma	giessemrájppe, dåjmadimrájppe, vuojedimrájppe, jådedimrájppe
juoksa	juoksa
juolgeláhpi	juolggevuodo
juolgesuorbma	juolggetjuvdde
juolgi	juolgge
juovva	juovva
juvla	juvlla
kaleandar	rijmmo
Kambodja	Kambåddjå
káfebánnu	káffagiebbme
káfegievdni	káffagiebbme
keaksa	tjeksa
kievkkan	gievkan
klássa	klássa
klássa	vinndek
kontaktor	kontaktåvrrå, kontáktur
Kroatia	Kroáhtsa
kulturmuitosuodjaleapmi	kultuvrramujttosuodjalibme, kultuvrramujttosuoddjim
lageš	lagim
lastagaccet	råhtogattsak
Latvia	Lettlánnda, Láttva
lavdnjegoahti	gábmá, lavnnjegoahte
láđđi	ruvdda
láfol	láhul
láhkaásahus	biejadus
láhkán	láhkán
láhken	láhkán
láibi	stummpa
lákcajiekŋa	jiegŋa
lásefaskkon	vinndekrábun
láse	vinndek
lássabáddi	dabrrimbádde
lávdi	fiello
lávgungárri	lávggomgárre
lávlorásttis	rássjotsihtse
lávlorásttis	rástes, lávllorástes
lávvomuorra	dägá, dægá
leaibeloddi	liejbbelådde
leasttut	guobá
leivvoš	gieddeurjjá
lesba	læsbos, läsbos
Liberia	Liberra, Libierra
lidnu	liddno
lieđđi	giedjek
liehppá	sliehppá
Lietuva	Litávva
lihká	ávdda
lihkku beivviin	vuorbbe biejvijn
lihkku riegádanbeivviin	vuorbbe riegádimbiejvijn
lihppu	besalvis, billæhtta, biljähtta
liidnelláš	sjvatjik
liinelláš	sjvatjik
liktenbeavdi	sæjggombievdde
liktenruovdi	sæjggomruovdde
linjáduopmár	linnjaduobmár
liŋka	sváldas
loabáhat	trápsa
loabátgáma	trápsa
loađgu	jieggeloavkko
loavdda	låvda
loddegonagas	låddegånågis, gållegahper
loddejievži	rástes, lávllorástes
loddi	lådde
lohkkabáddi	dabrrimbádde
lohkki	låhkke
lohkuguolli	jáddi
luhkka	njálmmefáhta
lundda	lunnde
luoddagalba	luoddagalbba
luondduduohtadeapmi	luonndorievddadibme
luonddumeahcci	árjudakdajvva
luonddumuitu	luonndomujtto
luopmoruđat	loahpebálkká
luvven	tjoavdádallam
Malaysia	Malájssa
maŋosčievččasteapmi	ruoptotjievtjastibme
massit	masset
máinnus	ilmos
mánáidgárdi	mánájåroj
mánáš	mánásj
mánnáfuolaheapmi	mánájhukso
mánnáfuolahus	mánájhukso
meahkástat	mægástahka, almevierttsa
mearragoaskin	guollegoasskem
meašttir	mässtár, vuojtte
meašttirvuođagilvvut	gilbos, gilpos
miellespálfu	dermusj
miesttarásttis	biestarástásj
miesttarásttis	rássjotsihtse
miesttaskilki	biestarástásj
miesttavizar	biestalávllo
moallalinjá	mållalinnja
moalla	målla
moallastoalpu	mållastoalppa, mållatjuollda
mohkkasaddat	måhkudallat
mohkkasit	måhkudallat
mohtor	motåvrrå
mohtorsihkkel	motorsyhkal
mohtorsykkel	motorsyhkal
molssonkássa	målsudahka
molsson	målsun
molsut	målssot
monni	månne
muitosággi	vuorkkimságge
muoddá	muoddá
muolda	ednam
muoldu	ednam
muorracivkkán	muorraurjjá
muorra	muorra
muvra	muvrra
nállu	nállo
návet	fiekse
nieida	næjttso
niibi	nijbbe
niitocivkkán	urjjá
njalla	njalla
njálbmi	njálmme
njálgát	hálmuga
njálmmušteapmi	njálmostibme
njealjejuvllat (sihkkal)	nieljevierak, nieljejuvlak
njolá	fierosnjáman
njuikunbáddi	gahppambádde, tjællombádde
njukča	sjnjuktja
njunjálat	guorgojgoalsse
njunni	njunnje
njunuščiekči	njunjojtjiektje
njuolggan	el-njuolgan
njuolggogidden	boarkkim
njuolggolaktin	boarkkim
njuorju	nuorjjo
njurggu	njurgoj
noavki	dubmanjamán
Nordlánda	Nordlánnda
oaivi	oajvve
oapmedállu	båndorsijdda
oarri	oarre
ođasmahttit	ådåstuhttet
ođastit	ådåsisdahkat
Ođđa Selánda	Ådå Zealánnda, Aoteárra
ođđasit atnu	ådåsisadnem
ođđasit ráhkadit	ådåsisdahkat
olgguldasbuvssat	båvså
olgoráhppá	tráhppá
olgotráhppá	tráhppá
olju	oalljo
ovdamáksu	åvddåmákso
ovdaskuvla	åvddåskåvllå
ovdogohcci	åskeldisulmusj
ovdogoziheaddji	åskeldisulmusj
pandá	pánndá
queer	queer
racerbiila	gilposbijlla
ravdačiekči	rabddatjiektje
ravdarádjá	rabddalinnja
ravdarádji	rabddalinnja
rádio	radio
rádjat	rájov vaddet
ráhppa	tráhppá
ráhppá	tráhppá
ráidalas	stagán
ráidá	sállja
ráigat	rájggat
ráigeguoskkahat	siejnnekontákta
ránescihci	tjuorristsihtse
ránesgaccebiehtár	guossagattsak
ráneshávda	ávdda
ránesrásttis	stuorrástes, rástes
ráŋggáštusmearka	stráffamærkka, stráffasadje, stráffamärkka
rásáš	giedjek
rásttáš	gierggerástes
rásttis	stuorrástes, rástes
rátkkačiekčan	bessamtjiektjam
rávgoš	ruovggogånågis, fadik, tjehpurislådde
readdju	træddjo
reatká	gaskas
registrerejuvvon párragaskavuohta	registreriduvvam guojmmevuohta, tjáleduvvam guojmmevuohta
rekláma	ilmos
rele	relæddja, reläddja
replihkka	moalgedibme, replihkka, replijkka
replihkka	moalgedibme, replijkka, replihkka
riddospálfu	dermusj
rieban	riebij
rievssatcizáš	rievsaktsitsásj
rievssatfálli	rievsakhábak
riikkajoavku	rijkkajuogos
rikča	ribrri, skájtti
rimsu	rimsso
riššobeaitta	sjoavojberjas, navolberjas
riššu	navol
roahkki	álkko
rohtogaccet	råhtogattsak
rohtomeahkástat	vuovddemægástahka
ruksesguškil	ruoppsisgussjká
ruksesguškkástat	ruoppsisgussjká
ruksesjuolčoavžžu	ruoppsisjuolgtjoavtjoj
ruksesrieban	riebij
ruksessoadjá	rássjotsihtse
rullet	sláddit
ruŋka	ruŋŋka, gárránis, ruovdagis
ruŋku	ruŋŋka, gárránis, ruovdagis
ruohkki	álkko
ruoksat	ruoppsat
ruonábeibboš	ruodnábejbusj
ruonácizáš	ruodnáurbusj
ruonájuolčoavžžu	ruodnájuolgtjoavtjoj, tjoavtjoj
ruoná	ruodná, ruodnat
ruoššaállat	tjoavvetsihtse
ruoššagáranas	vuoratjis
ruovddagas	gierasj
ruovdecihci	ruovddetsitsásj
ruovdecizáš	ruovddetsitsásj
ruovttoluottačievččasteapmi	ruoptotjievtjastibme
ruskalihtti	ruhkelihtte
ruskalihtti	ruhtselihtte
sahá	sáhka
sajáiduhttit	sajájduhttet
sajálduhttit	sajájduhttet
sajušteapmi	oasástallam, háhkuhibme
sasni	sassne
sasti	sassne
sáddet	tjievtjastit
sággeguoskahus	spihttokontákta, návllekontákta, tsáhkemkontákta
sággeguoskkahat	spihttokontákta, návllekontákta, tsáhkemkontákta
sáhpán	sjnjierrá
sáhpánskuolfi	idjasjkunjok
sáibu	soahppo
sáivačuonjá	vuovddegássa
Sámediggeráđđi	sámedikkeráde
sáppahat	stiebila
sávzaloddi	sterra
sávza	sávttsa
seaŋgaliidni	láhkán
seaŋga	sæŋŋga
seavagiella	sevvamgiella
seksuála orientašuvdna	seksuellak luonndo, sexuellak luonndo
seksuála sodju	seksuellak luonndo, sexuellak luonndo
semifinála	semifinálla
sieđgacivkkán	sierggaurjjá
sieđgavizar	rievsaktsitsásj
sierraneapmi	sierranibme
sihkaldat	sigárdahka
sihkkarastinkopiija	lijggemoattádus
sihkkarastinmáŋggus	lijggemoattádus
sihkkarasti	siekrik
sihkkel	syhkal
sihkkut	sihkkot
silbaseargge	sjilla
silki	silkki
(sisa) beassankoarta	bessamkårttå
sisbáidi	skirtusj
sisbuvssat	truvsa
siskkitbeallji	sisŋepbiellje
sisti	sassne
skáhpeloddi	bielljerástes
skáiti	ribrri, skájtti
skállu	skiello
skárfa	skárffa, áhpetjuktje
skihrri	vielggisguovsak, bierŋesguovsak, soahkeguovsak
skilkeskálka	guossalávllo
skiŋgegaccet	buojddegattsak
skire	skirri
skirri	vielggisguovsak, bierŋesguovsak, soahkeguovsak
skoarra	skoarra
skruvvabonjan	skruvvaruovdde
skruvvaruovdi	skruvvaruovdde
skuolfi	guvggo
skuovat	skuova
skutnjaloddi	idjasjkunjok
smávvagoalsi	vuopptagoalsse
snárttal	snárdal
soadjanjálla	guvggo
soahkegaccet	råhtogattsak
soahkesoadjá	rássjotsihtse
soarvi	soarvve
sohkabealledovddaheapmi	sjiervvegåvås, sjiervveåvddånbuktem, sjiervveåvddåjbuktem
sohkabealleidentitehta	sjiervveidentitiehtta, sjiervveidentitäjtta
spábbačiekčangáma	bállotjiektjamgáma, tjiektjamgáma, roahttotjiektjamgáma
spábbačiekčangieddi	roahttotjiektjamsjalljo
spábbačiekčan	roahttotjiektjam, bállotjiektjam
spábba	roahtto, bállo
spáhppal	råhkån
spálfu	fálffo
speallu	spella
spiehkastat	tjuoldos
spiidni	svijnne
spižus	hudi
stárra	sterra
stohkkegaccet	guossagattsak
stohpospálfu	fálffo
stuollu	ståvllå
stuoračoavžžu	glivi
stuoragáiru	stuorskávlle, stuorskákle
stuoraháskil	stuorskájtti
stuorračuonjá	vuovddegássa
stuorrafiehta	viehtak
stuorraguškkástat	stuorgussjká
stuorraskáiti	stuorskájtti
stuorraskárfa	skárffa, áhpetjuktje
stuorraskávli	stuorskávlle, stuorskákle
stuorraskuolfi	liddno
stuorravuojaš	stuorvuojatjis
suddjenbiddi	juolggesuojalm
suhkosat	suvddusa
suodjemeahcci	árjudakduobda
suohkut	guobá
suohpan	sjuohpan
suoidnesuorsá	stuorvuojatjis
suoidni	suojnne
suojus	sjærmma, sjärmma
suorbmagoahti	suormmagoahte
suorgi	suorgge
suorpmas	suormas
suotnjočoavžžu	jieggetjoavtjoj
suotnjočovžžoš	jieggetjoavtjoj
suotnjoliirráš	jieggetjoavtjoj
suotnjoliráš	jieggetjoavtjoj
suovvabohcci	riehpen
sykkel	syhkal
šállja	sállja
šearbma	sjærmma, sjärmma
šilljocihci	tjuorristsihtse
šillju	sjalljo
šimir	sjimer
tallearka	dállik, tollærkka
táhpehallat	vuojtádallat, dáhppudallat, dáhpput
telefovdna	telefåvnnå
toga	tåhka
transolmmoš	transulmusj
transsohkabeallevuohta	transsexualitäjtta, transseksualitiehtta
tráhppa	tráhppá
tráhppá	tráhppá
TV-čájálmas	doahkko
uhcačáihni	tjájnásj
uhcačoavžžu	ruodnájuolgtjoavtjoj, tjoavtjoj
uhcačovžoš	tjåvtjusj
uhcafiehta	diehppeviehtak
uhcagádjegaš	skávlle, skákle
uhcameahkástat	jieggemægástahka
uhcaviroš	tjåvtjusj
uksa	uksa
unnafiehtaš	diehppeviehtak
unnaguškkástat	gussjká, sjkussjki
unnaskávlláš	skávlle, skákle
valáštallan	spårttå, valástallam
vanas	vanntsa
vanca	vanntsa
varraloddi	liejbbelådde
váldoduopmár	oajvveduobmár
vánhemiidruhta	äjgátbálkká, æjgátbálkká
várgeheapmi	njálmostibme
várrehus	várrodus
várresieđga	siergga
várri	várre
váruhus	várrodus
vávvá	doahkko
vázzinravda	váttsáldahka
veahkkebiila	viehkkebijlla
vearromearit	värromierre, værromierre
veažir	miehtjer
vielgat	bedjat, vielggat
viessovovdna	campingvoaŋnna
viessu	goahte
viežžat	viedtjat
vigláčoavžžu	glivi
vilgesskuolfi	guvggo
vintán	vindán
vuoitit	vuojttet
vuoitomoalla	vuojttomålla
vuoitu	vuojttem, vuojtto
vuojaš	vuojatjis
vuoktafiehta	diehppeviehtak
vuoktagaccet	vuopptagattsak
vuoktagoalsi	vuopptagoalsse
vuoktaláfol	vuopptaláhul
vuokta	vuobdda
vuolpu	vuolppo
vuoncáfálli	tjuktjehábak
vuonccis	vuonntsá
vuoraš	vuoratjis
vuoražas	vuoratjis
vuorččis	vuoratjis
vuorká	fijlla
vuorrosátni	moalgedibme, replihkka, replijkka
vuorrosátni	moalgedibme, replijkka, replihkka
vuostálohkki	skáhppo, vuosstáskáhppo
vuostedeaddu	viejinis
vuotta	vuotta
vuovdaleaddji	vuovdde
vuovdečoavžžu	vuovddetjoavtjoj
vuovdegaccet	guossagattsak
vuovdemeahkástat	vuovddemægástahka
vuovdi	vuovdde
vurke nugo	vuorkkit
weblogan	nähttalågån, næhttalågån
