adjektijvva	adjektijvva	w
adnobiergas	adnobiergas	w
adnobivtas	adnobivtas	w
adnogálvvo	adnogálvvo	w
agurkka	agurkka	w	
ahkelasse	ahkelasse	
ahkelasádus	ahkelasádus	
allabasse	allabasse	w
allagåhttse	allagåhttse	w
allalávla	allalávla	w
allatjoarvve	allatjoarvve	w
allavierro	allavierro	w
allaájgge	allaájgge	w
almebálges	almebálges	w
almeguovllo	almeguovllo	w
almenáhkke	almenáhkke	
almerijkka	almerijkka	w
almetjuollda	almetjuollda	w
almevierttsa	almevierttsa	w
almmailmme	almmailmme	w
almmaråbme	almmaråbme	w
almmasuojgge	almmasuojgge	w
almmaš	almasj	w
almmenáhkke	almmenáhkke	w
arvvebalvva	harvvebalvva	w
arvvebivtas	harvvebivtas	w
arvvebålås	harvvebålås	w
arvvedálkke	harvvedálkke	w
arvvemierre	harvvemierre	w
arvvesuodje	harvvesuodje	w
arvvetjalmme	harvvetjalmme	w
arvvevuovdde	harvvevuovdde	w
asebielle	asebielle	w
asstobiejvve	asstobiejvve	w
asstoájgebivdde	asstoájggebivdde	w
asstoájgedoajmma	asstoájggedoajmma	w
asstoájgge	asstoájgge	w
astoájgge	astoájgge	w
astoájggedoajmma	astoájggedoajmma	
avijssa	avijssa	w
avijssadiedádus	avijssadiedádus	w
avijssaålmåj	avijssaålmåj	w
badjebahta	badjebahta	w
badjebielle	badjebielle	w
badjebádne	badjebádne	w
badjebárnne	badjebárnne	w
badjebátsa	badjebátsa	w
badjedille	badjedille	w
badjedásse	badjedásse	w
badjegierdde	badjegierdde	w
badjegoahte	badjegoahte	w
badjegájbbe	badjegájbbe	w
badjelassta	badjelassta	w
badjeluobma	badjeluobma	w
badjelájgge	badjelájgge	w
badjemadda	badjemadda	w
badjeniejdda	badjeniejdda	w
badjeriessjme	badjeriessjme	w
badjerádje	badjerádje	w
badjerádjemierre	badjerádjemierre	w
badjesijdda	badjesijdda	w
badjesábme	badjesábme	w
badjetjála	badjetjála	w
badjeviesso	badjeviesso	w
badjevuovdda	badjevuovdda	w
badjeváhkká	badjeváhkká	w
badjeålmåj	badjeålmåj	w
bahtagiesse	bahtagiesse	w
bahtaliehkko	bahtasliehkko	w
bahtaluovdde	bahtaluovdde	w
bahtarájgge	bahtarájgge	w
bahtasihkko	bahtasihkko	w
bahtačalbmi	bahtatjalmme	w
bahtačoalli	bahtatjoalle	w
bahádahkke	bahádahkke	w
bahádahko	bahádahko w
bahádáhpi	bahádáhpe	w
bahálaš	bahálasj 	w
bahávuohta	bahávuohta	w
balvvadálkke	balvvadálkke	w
barggoahke	barggoahke	
barggobiejvve	barggobiejvve	w
barggobihttá	barggobihttá	
barggobihttá	barggobiehkke	w
barggobirásláhka	barggobirásláhka	w
barggobiráslávddegådde	barggobiráslávddegådde	
barggobiráslávddegådde	barggobirásnammadus	w
barggobivtas	barggobivtas	w
barggobájkke	barggobájkke	w
barggodille	barggodille	w
barggodoajmma	barggodoajmma	w
barggofábmo	barggofábmo	w
barggogirjje	barggogirjje	w
barggoguojmme	barggoguojmme	w
barggogådde	barggogådde	w
barggogåvvå	barggogåvvå	w
barggoielle	barggoielle	w
barggojuohko	barggojuohko	w
barggolávddegådde	barggolávddegådde	
barggolávddegådde	barggonammadus	w	
barggomiella	barggomiella	w
barggomálle	barggomálle	w
barggonjuolgadus	barggonjuolgadus	w
barggorájddo	barggorájddo	w
barggosadje	barggosadje	w
barggosjiehtadus	barggosjiehtadus	w
barggosuodjalus	barggosuodjalus	w
barggosuorgge	barggosuorgge	w
barggovuohke	barggovuohke	w
barggovuorro	barggovuorro	w
barggoájgge	barggoájgge	w
barggoålmåj	barggoålmåj	w
barggoš	bargusj	w
baskesoajvve	baskesoajvve	w
bassebiejvve	bassebiejvve	w
basseålmåj	basseålmåj	w
bassteoajvve	bassteoajvve	
baste	bassti w
bejbusjtsihtse	bejbusjtsihtse	w
berealasj	berealasj	w
biddojuolgge	biddojuolgge	w
biebbmobihttá	biebbmobihttá	
biebbmobihttá	biebbmobiehhke	w
biebbmobuvta	biebbmobuvta	w
biebbmobárnne	biebbmobárnne	w
biebbmodille	biebbmodille	w
biebbmoieddne	biebbmoieddne	w
biebbmoielle	biebbmoielle	w
biebbmolådde	biebbmolådde	w
biebbmománná	biebbmománná	w
biebbmoniejdda	biebbmoniejdda	w
biebbmosládja	biebbmosládja	w
biebbmosállte	biebbmosállte	w
biebbmovádne	biebbmovádne	w
biebbmoáhttje	biebbmoáhttje	w
biedjonjálmme	biedjonjálmme	w
bieggadávdda	bieggadávdda	w
bieggafiello	bieggafiello	w
bieggafálle	bieggafálle	
bieggagadtsa	bieggagadtsa	w
bieggajårre	bieggajårre	w
bieggamillo	bieggamillo	w
bieggaoajvve	bieggaoajvve	w
bieggaskierro	bieggaskierro	w
bieggaullo	bieggaullo	w
bieggaålmåj	bieggaålmåj	w
bieggačoalli	bieggatjoalle	w
biehtselådde	biehtselådde	w
biehtsemihttár	biehtsemihttár	w
biehtsesjaddo	biehtsesjaddo	w
biehtsevuovdde	biehtsevuovdde	w
biejvebarggo	biejvebarggo	w
biejvvebielle	biejvvebielle	w
biejvvebájta	biejvvebájta	w
biejvvebåddå	biejvvebåddå	w
biejvvegirjje	biejvvegirjje	w
biejvvelahkke	biejvvelahkke	w
biejvveláhtto	biejvveláhtto	w
biejvvelådde	biejvvelådde	w
biejvvelåttåsj	biejvvelåttåsj	w
biejvvemåhkke	biejvvemåhkke	w
biejvvetjalmme	biejvvetjalmme	w
biejvvetjalmmesjaddo	biejvvetjalmmesjaddo	w
biekkanjuolla	biekkanjuolla	w
bielggelådde	bielggelådde	w
biellebiejvvedoajmma	biellebiejvvedoajmma	w
biellemuddo	biellemuddo	w
biellemuorra	biellemuorra	w
bielletjuokkes	bielletjuokkes	w
bielljebágge	bielljebágge	w
bielljediehppe	bielljediehppe	w
bielljegoahte	bielljegoahte	w
bielljegoarvve	bielljegoarvve	w
bielljeguoppar	bielljeguoppar	w
bielljegáhttje	bielljegáhttje	
bielljegásse	bielljegásse	w
bielljelassta	bielljelassta	w
bielljemátta	bielljemátta	w
bielljemáttatjårro	bielljemáttatjårro	w
bielljenáhkkesoadje	bielljenáhkkesoadje	w
bielljerájgge	bielljerájgge	w
bielljerástes	bielljerástes	w
bielljesuodje	bielljesuodje	w
bielljetsuodtsa	bielljetsuodtsa	w
biellodaŋássjaddo	biellodaŋássjaddo	w
bielloguodde	bielloguodde	w
biellorásse	biellorásse	w
biellosjaddo	biellosjaddo	w
biellotsitsásj	biellotsitsásj	w
bierbbedákte	bierbbedákte	w
bierbbeladás	bierbbeladás	w
bierggobihttá	bierggobihttá		
bierggobihttá	bierggobiehkke	w	
bierggobillda	bierggobillda	w
bierggobuvta	bierggobuvta	w
bierggobállo	bierggobállo	w
bierggodájgge	bierggodájgge	w
bierggogáhkko	bierggogáhkko	w
bierggohadde	bierggohadde	w
bierggojielle	bierggojielle	w
bierggoliebma	bierggoliebma	w
bierggomihtto	bierggomihtto	w
bierggomálle	bierggomálle	w
bierŋesdoavnnje	bierŋesdoavnnje	w
biessegadna	biessegadna	w
biessegáhkko	biessegáhkko	w
biessenjalle	biessenjalle	w
bietna	biedna	w
bietsegarra	bietsegarra	w
bievddegiehtje	bievddegiehtje	w
bievddegirjje	bievddegirjje	w
bievddeguorra	bievddeguorra	w
bievddelijnne	bievddelijnne	w
bievddenijbbe	bievddenijbbe	w
bievddevierro	bievddevierro	
bievllajahke	bievllajahke	w
bijlarábma	bijlarábma	w
bijlavuoddje	bijllavuoddje	w	
bijnnovahkko	bijnnovahkko	w
bilkádus	bilkkádus	w
birratjuohpadus	birratjuohpadus	w
birásbargge	birásbargge	w
birásbuojdde	birásbuojdde	w
biráslassta	biráslassta	w
biráslavnnje	biráslavnnje	w
birásládde	birásládde	w
birásperspektijvva	birásperspektijvva	w
birásresurssa	birásresurssa	w
birástsuodtsa	birástsuodtsa	w
birásviesso	birásviesso	w
bissobiergas	bissobiergas
bissonjálmme	bissonjálmme
bivddobiergas	bivddobiergas	w
bivddobádde	bivddobádde	w
bivddobájkke	bivddobájkke	w
bivddodille	bivddodille	w
bivddogoartta	bivddogoartta	w
bivddojuolgge	bivddojuolgge	w
bivddoláhka	bivddoláhka	w
bivddomåhkke	bivddomåhkke	w
bivddorågge	bivddorågge	w
bivddosadje	bivddosadje	w
bivddovahtsa	bivddovahtsa	w
bivddovuohke	bivddovuohke	w
bivddoájgge	bivddoájgge	w
bivddoålmåj	bivddoålmåj	w
bivddár	bivdár	w
bivtasbassta	bivtasbassta	w
bivtasgoarro	bivtasgoarro	w
boahkkebierggo	boahkkebierggo	w
boahkkeguolle	boahkkeguolle	w
boahkkodávdda	boahkkodávdda	w
boahkkosadje	boahkkosadje	w
boahtogálldo	boahtogálldo	w
boahtoárvvo	boahtoárvvo	w
boahtteájgge	boahtteájgge	w
boallobievdde	boallobievdde	w
boallodákte	boallodákte	w
boallogálla	boallogálla	w
boallonjuktja	boallonjuktja
boallonjuktja	boallosnjuktja	w
boallooajvve	boallooajvve	w
boallorásse	boallorásse	w
boallorávdde	boallorávdde	w
boaresbárnne	boaresbárnne	w
boaresdárogiella	boaresdárogiella	w
boaresgállárásse	boaresgállárásse	w
boaresmánno	boaresmánno	w
boaresniejdda	boaresniejdda	w
boassjobiellje	boassjobiellje	w
boassjotsagge	boassjotsagge	w
boastoadno	boastoadno	w
brånssåájgge	brånssåájgge	w
bujtteguolle	bujtteguolle	w
buoddojávrre	buodojávrre	w	
buoddosadje	buodosadje	w
buoddotsuodtsa	buodotsuodtsa	w
buohttsesadje	buohttsesadje	
buohttsesáhtto	buohttsesáhtto
buohttseviesso	buohttseviesso
buohča	buohtja	w
buojddedågge	buojddedågge	w
buojddetsitsásj	buojddetsitsásj	w
buorredahkke	buorredahkke	w
buorredahko	buorredahko	w
buorredille	buorredille	w
buorremiella	buorremiella	w
burssarásse	burssarásse	w	
buvtta	buvta	w
bádatjoarvve	bádatjoarvve	
bádnedákte	bádnedákte	w
bádnegarra	bádnegarra	w
bádnegasska	bádnegasska	w
bádnegielas	bádnegielas	w
bádnegárdde	bádnegárdde	w
bádnejiegŋa	bádnejiegŋa	w
bádnemátta	bádnemátta	w
bádneruovdde	bádneruovdde	w
bádnetjuomas	bádnetjuomas	w
bádnetjårro	bádnetjårro	w
bádnevierkka	bádnevierkka	w
bádnevárkka	bádnevárkke	w	
bággodoajmma	bággodoajmma	w
bággovuohke	bággovuohke	w
báhkkadávdda	báhkkadávdda	w
báhkkebåsso	báhkkebåsso
báhkkegijssá	báhkkegijssá 	w
báhpatjiebet	báhpatjiebet	w
báhpavirgge	báhpavirgge	w
báhppagådde	báhppagådde	w
bájkeiset	bájkeiset	w
bájkekásus	bájkekásus	w
bájkesadje	bájkesadje	w
bájkkegådde	bájkkegådde	w
bájkkenamma	bájkkenamma	w
bájkkenammaláhka	bájkkenammaláhka	w
bájnarásse	bájnarásse	
bájnnorásse	bájnnorásse	w
báktedoajmma	báktedoajmma	w
báktefálle	báktefálle	
báktegoarvve	báktegoarvve	w
báktehárjje	báktehárjje	
bákteladnja	bákteladnja	w
bákteláhka	bákteláhka	w
báktesládja	báktesládja	w
báktesállte	báktesállte	w
báldesgiergge	báldesgiergge	w
bálgessuorgge	bálgessuorgge	w
bálgessuorre	bálgessuorre	w
bálgestjuolle	bálgestjuolle	w
bálgestjuovgga	bálgestjuovgga	w
bálkkábargge	bálkkábargge	w
bálkkábivddo	bálkkábivddo	w
bálkkágållo	bálkkágållo	w
bálkkálissta	bálkkálissta	w
bálkkálissto	bálkkálissto	w
bálkkásjiehtadus	bálkkásjiehtadus	w
bálkkátsiehkke	bálkkátsiehkke	w
bálkkávállde	bálkkávállde	w
bálloburssa	bálloburssa	w
bálloskuohppo	bálloskuohppo	w	
bálloskuvddo	bálloskuvddo	w
bállosuodna	bállosuodna	w
bállotjalmme	bállotjalmme	w
bárddebiejvve	bárddebiejvve	w
bárdderuovdde	bárdderuovdde	w
bárkkodávdda	bárkkodávdda	w
bárnnebielle	bárnnebielle	w
bárnneålmåj	bárnneålmåj	w
bárragådde	bárragådde	
bárralåhkojahke	bárralåhkojahke	
bárrogiera	bárrogiera	w
bárrohárjje	bárrohárjje
bárroruohto	bárroruohto	
bárrosáhtso	bárrosáhtso
båddnejiegŋa	båddnejiegŋa	w
båddneskártta	båddneskártta	w
båddnesuossa	båddnesuossa	w
båddneullo	båddneullo
båddneullo	båddnehullo	
bådneniehko	bådneniehko
båhkårásse	båhkårásse
båhkåskálltjo	båhkåskálltjo
båhttjegussa	båhttjegussa	w
båhtålrabán	båhtålrabán	w
båksårabán	båksårabán	w
bårggeduollje	bårggeduollje	w
bårggemánno	bårggemánno		w
bårrenoajdde	bårrenoajdde	w
bårssjogiergge	bårssjogiergge	w
båsskålávkke	båsskålávkke	w
båssotjålggå	båssotjålggå	w
båssoárppo	båssohárppo	w
bæjvásjgådde	bæjvásjgådde	w
bællájjuohkke	bællájjuohkke	
bæssásjbasse	bæssásjbasse	w
bæssásjbiejvve	bæssásjbiejvve	w
bæssásjruohtta	bæssásjruohtta	w
dadneárppo	dadnehárppo	w
dahkojuolgge	dahkojuolgge	w
dahkojávrre	dahkojávrre
dahkoladás	dahkoladás
dahkolahtto	dahkolahtto
dahkonamma	dahkonamma
dahkosájggo	dahkosájggo
dahkovuovdde	dahkovuovdde
darffeboallo	darffeboallo	
darffegoahte	darffegoahte	
darffejiegge	darffejiegge	w
davvebiegga	davvebiegga	w
davveguovllo	davveguovllo	w
davvelådde	davvelådde	w
davvenuortta	davvenuortta	w
davvenuortte	davvenuortte	w
davveoalgge	davveoalgge	w
davveoarjje	davveoarjje	w
davverijkka	davverijkka	w
davveruhtarásse	davveruhtarásse	w
davvesijdda	davvesijdda	w
davvesábme	davvesábme	w
davvesámesijdda	davvesámesijdda	w
daŋásdarffe	daŋásdarffe	w
daŋásruvsso	daŋásruvsso	w
daŋássiergga	daŋássiergga	w
daŋássjaddo	daŋássjaddo	w
diedagådde	diedagådde	
diedasuorgge	diedasuorgge	w
diedaålmåj	diedaålmåj	w
diehppebágge	diehppebágge	w
diehppegálla	diehppegálla	
diehpperásse	diehpperásse
diehtodásse	diehtodásse	w
diehtogirjje	diehtogirjje	w
diehtogálldo	diehtogálldo	w
diehtojuohkke	diehtojuohke
dievdobielle	dievddobielle	w
diggebievdde	diggebievdde	w
diggebájkke	diggebájkke	w
diggegirjje	diggegirjje	w
diggegådde	diggegådde	
diggeviesso	diggehuonaj	w
diggeášši	diggeássje	w
dihkkerásse	dihkkerásse	w
dijddagoanssta	dijddagoanssta	w
dijddaåssko	dijddaåssko	w
diktafiguvrra	diktafiguvrra w
diktafiguvrra	diktagåvås	w
diktagirjje	diktagirjje	w
diktalávllo	diktalávllo	w
diktamihtto	diktamihtto	w
diktatjálle	diktatjálle	w
diktáhtta	diktáhtta	
diktár	diktár
dikŋa	digŋa	w
divggahielmme	divggahielmme	w
doajmmadoalle	doajmmadoalle	w
doajmmaguovllo	doajmmaguovllo	w
doajmmagådde	doajmmagådde	
doajmmagållo	doajmmagållo	w
doajmmajahke	doajmmajahke	w
doajmmasuorgge	doajmmasuorgge	w
doajmmaájgge	doajmmaájgge	w
doajmmaålmåj	doajmmaålmåj	w
doalleristieddne	doalleristieddne	
doalleristáhttje	doalleristáhttje
doallogådde	doallogådde
doallostruktuvrra	doallostruktuvrra	w
doallovuohke	doallovuohke	xxx til hit
doaresbiegga	doaresbiegga
doaresbielle	doaresbielle
doaresbálges	doaresbálges
doaresgáma	doaresgáma
doaresmuorra	doaresmuorra
doaressiejnne	doaressiejnne
doarestjuollda	doarestjuollda
doarjjastivrra	doarjjastivrra
doarrogievrra	doarrogievrra
doavnnjeielle	doavnnjeielle
doavnnjelassta	doavnnjelassta
dudnaguolle	dudnaguolle
dulppobiehtse	dulppobiehtse
dulveájgge	dulveájgge
duobmobiejvve	duobmobiejvve
duobmogirjje	duobmogirjje
duobmoreferáhtta	duobmoreferáhtta
duobmosådnåbiejvve	duobmosådnåbiejvve
duobmovállde	duobmovállde
duodjebiergas	duodjebiergas
duodjedoajmma	duodjedoajmma
duodjekurssa	duodjekurssa
duodjeladnja	duodjeladnja
duodjelávkka	duodjelávkka
duodjeprográmma	duodjeprográmma
duodjerádde	duodjerádde
duolbbabassta	duolbbabassta
duolbbabievdde	duolbbabievdde
duolbbadaŋás	duolbbadaŋás
duolbbaskierro	duolbbaskierro
duolbbasuojnne	duolbbasuojnne
duolbbár	duolbár
duolljebággo	duolljebággo
duorggoielle	duorggoielle
duottarhávvar	duottarhávvar
duottarrijkka	duottarrijkka
duottarsjaddogierdde	duottarsjaddogierdde
duottarvirusj	duottarvirusj
duvdajuolgge	duvdajuolgge
duvdatjanás	duvdatjanás
duvnnerásse	duvnnerásse
dájdabarggo	dájdabarggo
dájdadoajmmagådde	dájdadoajmmagådde
dájdadáhpádus	dájdadáhpádus
dájdamusea	dájdamusea
dájdasuorgge	dájdasuorgge
dájggegárre	dájggegárre
dáktebierggo	dáktebierggo
dákteguodde	dákteguodde
dákteguolle	dákteguolle
dákterigge	dákterigge
dálkasbuvdda	dálkasbuvdda
dálkasgiehta	dálkasgiehta
dálkasnállo	dálkasnállo
dálkkediedádus	dálkkediedádus
dálkkedille	dálkkedille
dálveguolle	dálveguolle
dálveájgge	dálveájgge
dálvvebájkke	dálvvebájkke
dálvvedigge	dálvvedigge
dálvveidja	dálvveidja
dálvvejahke	dálvvejahke
dálvvejáhpe	dálvvejáhpe
dálvvelassta	dálvvelassta
dálvvelådde	dálvvelådde
dálvvemuorra	dálvvemuorra
dálvvenager	dálvvenager
dálvvesijdda	dálvvesijdda
dálvvetjårgge	dálvvetjårgge
dálvveurbbe	dálvveurbbe
dálvveájmmo	dálvveájmmo
dánskagiella	dánsskagiella
dárogiella	dárogiella
dásegierdde	dásegierdde
dássegierdde	dássegierdde
dásseruossa	dásseruossa
dássevállde	dássevállde
dásseárvvo	dásseárvvo
dásseárvvodoajmma	dásseárvvodoajmma
dásseárvvoláhka	dásseárvvoláhka
dásseárvvolávddegådde	dásseárvvolávddegådde
dásseárvvoperspektijvva	dásseárvvoperspektijvva
dáttjagille	dáttjagille
dáttjavágge	dáttjavágge
dávdaálggo	dávdaálggo
dávddabukte	dávddabukte
dávvergijssá	dávvergijssá
dávvertjielgadus	dávvertjielgadus
dávvervuorkká	dávvervuorkká
dåhppåbiergas	dåhppåbiergas
dåhppåsåhkår	dåhppåsåhkår
dålggevuogga	dålggevuogga
dållåboahkko	dållåboahkko
dållåburssa	dållåburssa
dållågierdde	dållågierdde
dållåhiehte	dållåhiehte
dållånjuorssjo	dållånjuorssjo
dållåruovdde	dållåruovdde
dållåsadje	dållåsadje
dålusjdavverijkka	dålusjdavverijkka
dålusjmujtto	dålusjmujtto
dålusjájgge	dålusjájgge
dålåbájta	dålåbájta
dålåhiehte	dålåhiehte
dårvvobájkke	dårvvobájkke
elfábmo	elfábmo
farao	farao
fiehtarbádde	fiehtarbádde
fiervvábuvrre	fiervvábuvrre
fiervváguovllo	fiervváguovllo
fiervváhirssa	fiervváhirssa
fiervvávirusj	fiervvávirusj
fiervá	fiervvá
figuvrra	figuvrra
fijkunmuorra	fijkunmuorra
fijlalissto	fijlalissto
filmmadahkke	filmmadahkke
firkkal	firkal
friddjasadje	friddjasadje
friddjaájgge	friddjaájgge
fuolkkegasskavuohta	fuolkkegasskavuohta
fuolkkegiella	fuolkkegiella
fylkadigge	fylkadigge
fylkagiellda	fylkagiellda
fylkamánne	fylkamánne
fábmodille	fábmodille
fábmogiedde	fábmogiedde
fábmogálldo	fábmogálldo
fáddábirás	fáddábirás
fáddálissto	fáddálissto
fáddánamma	fáddánamma
fágabargge	fágabargge
fágaduovda	fágaduovda
fágagiella	fágagiella
fágagirjje	fágagirjje
fágalihtto	fágalihtto
fágalávddegådde	fágalávddegådde
fágasuorgge	fágasuorgge
fágavirgge	fágavirgge
fáhttsabielle	fáhttsabielle
fárffomárffe	fárffomárffe
fárfforávdde	fárfforávdde
fásstaásse	fásstaásse
gabmodoajmma	gabmodoajmma
gadtsabielle	gadtsabielle
gadtsalådde	gadtsalådde
gadtsaruovdde	gadtsaruovdde
gadtsasuodna	gadtsasuodna
gahperbádde	gahperbádde
gahpermuorjje	gahpermuorjje
gajkkosuola	gajkkosuola
galbaráksá	galbbaráksá
galbbabiehkke	galbbabiehkke
galmaidja	galmaidja
galmma	galma
galmmaladnja	galmmaladnja
garjábiello	garjábiello
garratjievrra	garratjievrra
gaskidja	gaskidja
gassabårgge	gassabårgge
gassamuorra	gassamuorra
gassanisske	gassanisske
gassarásse	gassarásse
gassasuodna	gassasuodna
gasskaahke	gasskaahke
gasskabiejvve	gasskabiejvve
gasskabájkke	gasskabájkke
gasskadálvve	gasskadálvve
gasskagirjje	gasskagirjje
gasskaidja	gasskaidja
gasskaladás	gasskaladás
gasskamierre	gasskamierre
gasskaoabme	gasskaoabme
gasskarijkka	gasskarijkka
gasskarádje	gasskarádje
gasskasiejnne	gasskasiejnne
gasskastággo	gasskastággo
gasskasálgga	gasskasálgga
gasskavahkko	gasskavahkko
gasskaájdde	gasskaájdde
gasskaájgge	gasskaájgge
gasskaárvvo	gasskaárvvo
gasskaålmåj	gasskaålmåj
gatna	gadna
gavvaristjoarvve	gavvaristjoarvve
giedabirásgirjje	giedabirásgirjje
giedafábmo	giedafábmo
giedavuolbállte	giedavuolbállte
gieddebarggo	gieddebarggo
gieddejuobmo	gieddejuobmo
gieddelavnnje	gieddelavnnje
gieddemuorjje	gieddemuorjje
gieddesidno	gieddesidno
gieddesiergga	gieddesiergga
gieddesjaddo	gieddesjaddo
gieddesuojnne	gieddesuojnne
gieddeullo	gieddeullo
giegabahtasihkko	giegabahtasihkko
giegajågŋå	giegajågŋå
gieganjuolla	gieganjuolla
giegatsitsásj	giegatsitsásj
giehpabiejvvelådde	giehpabiejvvelådde
giehpabáddi	giehpabádde
giehpesdávdda	giehpesdávdda
giehpesvihke	giehpesvihke
giehpesvájmmosuodna	giehpesvájmmosuodna
giehpevuolle	giehpevuolle
giehtaduodjevisste	giehtaduodjevisste
giehtaduvvá	giehtaduvvá
giehtadålgge	giehtadålgge
giehtagiehtje	giehtagiehtje
giehtagirjje	giehtagirjje
giehtagárvvo	giehtagárvvo
giehtagávva	giehtagávva
giehtagåtsan	giehtagåtsan
giehtahiergge	giehtahiergge
giehtaladás	giehtaladás
giehtaloahpo	giehtaloahpo
giehtaramás	giehtaramás
giehtaruovdde	giehtaruovdde
giehtarádno	giehtarádno
giehtasielgge	giehtasielgge
giehtavájmmosuodna	giehtavájmmosuodna
giehtaájdde	giehtaájdde
giehtačála	giehtatjála
giehtjemuorra	giehtjemuorra
giehtjesuorgge	giehtjesuorgge
giehtjeurbbe	giehtjeurbbe
gielasbiŋál	gielasbiŋál
gielastjårro	gielastjårro
gieldabargge	gieldabargge
gieldabáhppa	gieldabáhppa
gieldastivraválgga	gieldastivraválgga
gieldastivrra	gieldastivrra
gieldasábme	gieldasábme
gieldasámesijdda	gieldasámesijdda
gieldaválgga	gieldaválgga
giellabargge	giellabargge
gielladiehto	gielladiehto
gielladieđa	gielladieda
gielladutke	gielladutke
giellaguovdásj	giellaguovdásj
giellagurssa	giellagurssa
giellagáddi	giellagádde
giellakurssa	giellakurssa
giellalávddegådde	giellalávddegådde
giellalávggogurssa	giellalávggogurssa
giellamáhtto	giellamáhtto
giellarádde	giellarádde
giellasjiehtadus	giellasjiehtadus
giellastivraválgga	giellastivraválgga
giellastivrra	giellastivrra
giellatjiehppe	giellatjiehppe
giellaviehkke	giellaviehkke
giellaváttesvuohta	giellaváttesvuohta
giellaárbbe	giellaárbbe
gielldabargge	gielldabargge
gielldalávddegådde	gielldalávddegådde
gielldaoasselávddegådde	gielldaoasselávddegådde
gielldastivrra	gielldastivrra
gienesárppo	gienesárppo
gieresdoavnnje	gieresdoavnnje
giereshiergge	giereshiergge
gieresluodda	gieresluodda
gieresrájddo	gieresrájddo
gierggebårre	gierggebårre
gierggegadna	gierggegadna
gierggejuolgge	gierggejuolgge
gierggejårggo	gierggejårggo
gierggeláhke	gierggeláhke
gierggemiehttse	gierggemiehttse
gierggeniehte	gierggeniehte
gierggenoarssa	gierggenoarssa
gierggerástes	gierggerástes
gierggeájgge	gierggeájgge
gieseájgge	gieseájgge
giessebájkke	giessebájkke
giesseguolle	giesseguolle
giessejahke	giessejahke
giessemánno	giessemánno
giessesadje	giessesadje
giessesijdda	giessesijdda
giesseájgge	giesseájgge
gijssárádjo	gijssárádjo
giledoajmmagådde	giledoajmmagådde
gilegirjje	gilegirjje
gileguovdásj	gileguovdásj
gintaljuolgge	gintaljuolgge
girddehávvar	girddehávvar
girddenoajdde	girddenoajdde
girdderukto	girdderukto
girjjebussa	girjjebussa
girjjegiella	girjjegiella
girjjehilldo	girjjehilldo
girjjeladnja	girjjeladnja
girjjeoajvve	girjjeoajvve
girjjerádjo	girjjerádjo
girjjerádjolávddegådde	girjjerádjolávddegådde
girjjerájddo	girjjerájddo
girjjetjálle	girjjetjálle
girjjáš	girjásj
girkkobasse	girkkobasse
girkkobiello	girkkobiello
girkkobivtas	girkkobivtas
girkkobájkke	girkkobájkke
girkkogirjje	girkkogirjje
girkkogárdde	girkkogárdde
girkkohærrá	girkkohærrá
girkkoláhka	girkkoláhka
girkkorádde	girkkorádde
girkkostivraválgga	girkkostivraválgga
girkkostivrra	girkkostivrra
girkkoájdde	girkkoájdde
gittadávver	gittadávver
goadehállde	goadehállde
goadeiemet	goadeiemet
goadeiset	goadeiset
goahppelfálle	goahppelfálle
goahtebiellje	goahtebiellje
goahtelassta	goahtelassta
goahteláhtto	goahteláhtto
goahtemuorra	goahtemuorra
goahtenjálmme	goahtenjálmme
goahtesadje	goahtesadje
goahtetjielgge	goahtetjielgge
goahtetsagge	goahtetsagge
goahttsegoahte	goahttsegoahte
goahttsemuorra	goahttsemuorra
goahttsevuovdde	goahttsevuovdde
goahttseårddå	goahttseårddå
goajvvosoabbe	goajvvosoabbe
goansstalahtto	goansstalahtto
goarŋŋohaŋŋá	goarŋŋohaŋŋá
goasskebielle	goasskebielle
goasstebierggo	goasstebierggo
goavvejahke	goavvejahke
goavvelihkko	goavvelihkko
guddneballo	guddneballo
guddnehibmo	guddnehibmo
gudnajåhto	gudnajåhto
guhkegasska	guhkegasska
guhkesmiella	guhkesmiella
guhkessiejbbe	guhkessiejbbe
guhkestjuovgga	guhkestjuovgga
guhkesájgeperspektijvva	guhkesájgeperspektijvva
guhkesájgge	guhkesájgge
guhkesårjjo	guhkesårjjo
gullogåvvå	gullogåvvå
gullorástes	gullorástes
gullosuodna	gullosuodna
gulmmedákte	gulmmedákte
gulmmeguolgga	gulmmeguolgga
gumpemuorjje	gumpemuorjje
gumpenjuolla	gumpenjuolla
gumperuovdde	gumperuovdde
guoberielle	guoberielle
guobmebårjås	guobmebårjås
guobmeráksá	guobmeráksá
guohtsadaŋás	guohtsadaŋás
guohtsarásse	guohtsarásse
guojkanisske	guojkanisske
guojkaoajvve	guojkaoajvve
guojmmetjiehka	guojmmetjiehka
guoledákte	guoledákte
guoleliebma	guoleliebma
guolevuodja	guolevuodja
guolgabielle	guolgabielle
guollaskuohppo	guollaskuohppo
guollebivdde	guollebivdde
guollebivddo	guollebivddo
guollebivddobájkke	guollebivddobájkke
guollebivddosadje	guollebivddosadje
guollebivddoájgge	guollebivddoájgge
guollebuvrre	guollebuvrre
guollebájkke	guollebájkke
guollebállo	guollebállo
guolledávdda	guolledávdda
guollefálle	guollefálle
guollegoajvvo	guollegoajvvo
guollegoartta	guollegoartta
guollegådde	guollegådde
guollehadde	guollehadde
guollejielle	guollejielle
guollejávrregádde	guollejávrregádde
guollemuorra	guollemuorra
guollenálle	guollenálle
guolleresurssa	guolleresurssa
guollesládja	guollesládja
guolástusgille	guolástusgille
guolástusgádtse	guolástusgádtse
guolástusgådde	guolástusgådde
guolástuslávddegådde	guolástuslávddegådde
guolástusváttesvuohta	guolástusváttesvuohta
guopparielle	guopparielle
guorgajuobmo	guorgajuobmo
guossarásse	guossarásse
guossavuovdde	guossavuovdde
guosseguollebivdde	guosseguollebivdde
guosseoahppe	guosseoahppe
guosseviesso	guosseviesso
guostahievnne	guostahievnne
guottetájgge	guottetájgge
guovddajuohko	guovddajuohko
guovddosielgge	guovddosielgge
guovddáš	guovdásj
guovddášdoaibma	guovdásjdoajmma
guovdásjbájkke	guovdásjbájkke
guovdásjháldadus	guovdásjháldadus
guovdásjsadje	guovdásjsadje
guovllorádje	guovllorádje
guovllotjálle	guovllotjálle
guovloháldadus	guovloháldadus
guovlostivraválgga	guovlostivraválgga
guovlostivrra	guovlostivrra
guovlovuovddelávddegådde	guovlovuovddelávddegådde
guovvamánno	guovvamánno
gurbmá	gurmmá
gurmmálådde	gurmmálådde
gurranjálmme	gurranjálmme
gussagoalsse	gussagoalsse
gussaielle	gussaielle
gutna	gudna
gáddeguorra	gáddeguorra
gáddejuobmo	gáddejuobmo
gáddeoalgge	gáddeoalgge
gádderuossta	gádderuossta
gádderuvsso	gádderuvsso
gáddesuojnne	gáddesuojnne
gáddevirusj	gáddevirusj
gáddobuohttse	gáddobuohttse
gáddosuodna	gáddosuodna
gáhkkogárre	gáhkkogárre
gáhttjogálvvo	gáhttjogálvvo
gáhttomuorra	gáhttomuorra
gáhttosielgge	gáhttosielgge
gájbbebádne	gájbbebádne
gájbevuolle	gájbevuolle
gájtsabájnno	gájtsabájnno
gájtsamielkke	gájtsamielkke
gájtsamuorjje	gájtsamuorjje
gájtsaskálltjo	gájtsaskálltjo
gájtsatjivgga	gájtsatjivgga
gájttsaieddne	gájttsaieddne
gálbegadtsa	gálbegadtsa
gálbenáhkke	gálbenáhkke
gálberásse	gálberásse
gálbetjiebet	gálbetjiebet
gállabiejvvelådde	gállabiejvvelådde
gállajærjjá	gállajærjjá
gálldogirjje	gálldogirjje
gálldosájtte	gálldosájtte
gállodiehkke	gállodiehkke
gállodákte	gállodákte
gállofiello	gállofiello
gállogiergge	gállogiergge
gállábárnne	gállábárnne
gálvvogijssá	gálvvogijssá
gálvvojåhto	gálvvojåhto
gálvvojårre	gálvvojårre
gálvvorádjo	gálvvorádjo
gámaduodde	gámaduodde
gámasuojnne	gámasuojnne
gárddedoallo	gárddedoallo
gárddesadje	gárddesadje
gárgobåddne	gárgobåddne
gárgogoalsse	gárgogoalsse
gárgooahtse	gárgooahtse
gárregiehtje	gárregiehtje
gárunrájgge	gárunrájgge
gárvestjanás	gárvestjanás
gáskatjahkesrásse	gáskatjahkesrásse
gássabårre	gássabårre
gássagierdde	gássagierdde
gássaresurssa	gássaresurssa
gássaráksá	gássaráksá
gásstajuolgge	gásstajuolgge
gásstanamma	gásstanamma
gásstaristieddne	gásstaristieddne
gásstaristáhttje	gásstaristáhttje
gáttobielle	gáttobielle
gávllovuoján	gávllovuoján
gávlobielle	gávlobielle
gávvasuodna	gávvasuodna
gåbbåbisso	gåbbåbisso
gåddebiellje	gåddebiellje
gåddebielljerásse	gåddebielljerásse
gåddebivddo	gåddebivddo
gåddebálges	gåddebálges
gåddegiella	gåddegiella
gåddemiesse	gåddemiesse
gådderågge	gådderågge
gåddesarves	gåddesarves
gådtjåbårre	gådtjåbårre
gådtjåráhkko	gådtjåráhkko
gåjkkebierggo	gåjkkebierggo
gåjkkedákte	gåjkkedákte
gåjkkedálkke	gåjkkedálkke
gåjkkeguolle	gåjkkeguolle
gåjkkemielkke	gåjkkemielkke
gåjkkemuorra	gåjkkemuorra
gålggodávdda	gålggodávdda
gållebahta	gållebahta
gållebejbusj	gållebejbusj
gålledåjdde	gålledåjdde
gållegiehta	gållegiehta
gållejuolgge	gållejuolgge
gållemedállja	gållemedállja
gållerásse	gållerásse
gållerávdde	gållerávdde
gållerågge	gållerågge
gållesuormas	gållesuormas
gålletsihtse	gålletsihtse
gålleåhttse	gålleåhttse
gålloárvvo	gålloárvvo
gårnnebuvta	gårnnebuvta
gårnnegarra	gårnnegarra
gårnnegihppo	gårnnegihppo
gårnnehirssa	gårnnehirssa
gårnneoajvve	gårnneoajvve
gårnneráddje	gårnneráddje
gårnnesjaddo	gårnnesjaddo
gårnnesládja	gårnnesládja
gårnnetjalmme	gårnnetjalmme
gårnnetsihtse	gårnnetsihtse
gårnnevuorkká	gårnnevuorkká
gårnneájtte	gårnneájtte
gårtjenisske	gårtjenisske
gårtjeoajvve	gårtjeoajvve
gåtsantjuovgga	gåtsantjuovgga
gåvvågirjje	gåvvågirjje
gåvvålassta	gåvvålassta
gåvvårukto	gåvvårukto
gåvvårájddo	gåvvårájddo
gåvvåtjuolle	gåvvåtjuolle
gåvvåvállde	gåvvåvállde
hektográmma	hektográmma
hiedebiejvve	hiedebiejvve
hiehtedille	hiehtedille
hiehtegoahte	hiehtegoahte
hiehtegássta	hiehtegássta
hiehteviehkke	hiehteviehkke
hielmmelassta	hielmmelassta
hievnesávttsa	hievnesávttsa
hievnneielle	hievnneielle
hilggogálvvo	hilggogálvvo
hillagáhkko	hillagáhkko
hirssagårnne	hirssagårnne
hirssavisste	hirssavisste
hoavkkát	hoavkát
huksenássje	huksenássje
hádjarásse	hádjarásse
hádjavuojdas	hádjavuojdas
hárddodille	hárddodille
hárddodålgge	hárddodålgge
hárddoládde	hárddoládde
hárjjehirssa	hárjjehirssa
hárrenjálmme	hárrenjálmme
hátna	hádna
hávddebiello	hávddebiello
hávddebájkke	hávddebájkke
hávdderågge	hávdderågge
hávgarásse	hávgarásse
hávvesadje	hávvesadje
ibmebielle	ibmebielle
idedisbiejvve	idedisbiejvve
idedisidja	idedisidja
idetbiejvve	idetbiejvve
idetbieleidja	idetbieleidja
idetbåddå	idetbåddå
idetidja	idetidja
idetviejgge	idetviejgge
idjagállo	idjagállo
idjalahkke	idjalahkke
idjalådde	idjalådde
idjarávgga	idjarávgga
idjasadje	idjasadje
idjastállo	idjastállo
idjatjårgge	idjatjårgge
ieddnebielle	ieddnebielle
ieddnesjaddo	ieddnesjaddo
iednebiejvve	iednebiejvve
iednevihke	iednevihke
iehketbieleidja	iehketbieleidja
iehketgurssa	iehketgurssa
iehketidja	iehketidja
iehketláhtto	iehketláhtto
iehketmáles	iehketmáles
iehketroadde	iehketroadde
iehketviejgge	iehketviejgge
iehpediehto	iehpediehto
iehpedoajvvo	iehpedoajvvo
iehpedårvvo	iehpedårvvo
iehpeguddne	iehpeguddne
iehpegullo	iehpegullo
iehpeåhtso	iehpeåhtso
iehpeåssko	iehpeåssko
iellegåvvå	iellegåvvå
iellesilbba	iellesilbba
iellevuodja	iellevuodja
iemeálmmugaperspektijvva	iemeálmmugaperspektijvva
iemeårro	iemeårro
iesjgåvvå	iesjgåvvå
iesjvuohke	iesjvuohke
iesjárvvo	iesjárvvo
illobiejvve	illobiejvve
inkoatijvva	inkoatijvva
instituhtta	instituhtta
irggebárnne	irggebárnne
isetgiellda	isetgiellda
israellasj	israellasj
jageájgge	jageájgge
jahkebielle	jahkebielle
jahkediedádus	jahkediedádus
jahkedoajmma	jahkedoajmma
jahkegierdde	jahkegierdde
jahkegirjje	jahkegirjje
jahkegurssa	jahkegurssa
jahkeladnja	jahkeladnja
jahkelåhke	jahkelåhke
jahkesjaddo	jahkesjaddo
jahketjoahkke	jahketjoahkke
jahketjuohte	jahketjuohte
jallasoajvve	jallasoajvve
jiednabárro	jiednabárro
jiednagierdde	jiednagierdde
jiednagirjje	jiednagirjje
jiednaguodde	jiednaguodde
jiednagåvvå	jiednagåvvå
jiednasiejnne	jiednasiejnne
jiednaskierro	jiednaskierro
jieggebåsskå	jieggebåsskå
jieggedarffe	jieggedarffe
jieggefálle	jieggefálle
jieggegieva	jieggegieva
jieggelåttemuorjje	jieggelåttemuorjje
jieggemuorjje	jieggemuorjje
jieggeullo	jieggeullo
jieggevirusj	jieggevirusj
jiegŋaguolle	jiegŋaguolle
jiegŋajårre	jiegŋajårre
jiegŋalådde	jiegŋalådde
jiegŋaájgge	jiegŋaájgge
jienastuslåhko	jienastuslåhko
jiesstadájgge	jiesstadájgge
jietna	jiedna
jietnabáddi	jiednabádde
joajmmevárre	joajmmevárre
julevsábme	julevsábme
julevsámegiella	julevsámegiella
julevsámesijdda	julevsámesijdda
juobmosjaddo	juobmosjaddo
juolggebielgge	juolggebielgge
juolggeduodde	juolggeduodde
juolggegiella	juolggegiella
juolggegávva	juolggegávva
juolggeladás	juolggeladás
juolggelahkke	juolggelahkke
juolggeláhpe	juolggeláhpe
juolggemuorra	juolggemuorra
juolggemánná	juolggemánná
juolggemátta	juolggemátta
juolggeramás	juolggeramás
juolggesuormma	juolggesuormma
juolggesuorre	juolggesuorre
juolggetjuvdde	juolggetjuvdde
juolggevájmmosuodna	juolggevájmmosuodna
juolggeájtte	juolggeájtte
juolggáš	juolgásj
juotna	juodna
jábmahábme	jábmahábme
jábmamánná	jábmamánná
jábmaájmmo	jábmaájmmo
jáffosåhkår	jáffosåhkår
jáffotjalmme	jáffotjalmme
jávrebåddne	jávrebåddne
jávrreguolle	jávrreguolle
jávrregádde	jávrregádde
jåddobuoddo	jåddobuoddo
jågåbåddne	jågåbåddne
jåhkåbuojda	jåhkåbuojda
jåhkågádde	jåhkågádde
jåhkåliehke	jåhkåliehke
jåhkånjálmme	jåhkånjálmme
jåhkårájgge	jåhkårájgge
jåhkårågge	jåhkårågge
jåhkåsadje	jåhkåsadje
jåhkåsuorgge	jåhkåsuorgge
jåhtogievlle	jåhtogievlle
jåhtoguolle	jåhtoguolle
jåhtoluossa	jåhtoluossa
jåhttelådde	jåhttelådde
jåhttenásste	jåhttenásste
jåhttesábme	jåhttesábme
jåhttesámelissta	jåhttesámelissta
jålleálldo	jålleálldo
jårggåbiegga	jårggåbiegga
jårrebiegga	jårrebiegga
jårreladás	jårreladás
kaniidna	kanijnna
kapellárasuodna	kapellárasuodna
kausatijvva	kausatijvva
ketchup-bohtal	ketchup-båhtål
kilográmma	kilográmma
kilomehtar	kilomehtar
kilomehtarruhta	kilomehtarruhta
kilomehter	kilomehter
kilomehterruhta	kilomehterruhta
klássaladnja	klássaladnja
klássalávdde	klássalávdde
kárttagåvvå	kárttagåvvå
kássabårre	kássabårre
kásushábme	kásushábme
ladnjagåvvå	ladnjagåvvå
ladnjasárggo	ladnjasárggo
ladásgasska	ladásgasska
ladásnijbbe	ladásnijbbe
ladássuojnne	ladássuojnne
ladásvuolssje	ladásvuolssje
lahttorijkka	lahttorijkka
lassediedádus	lassediedádus
lassenamma	lassenamma
lassevierro	lassevierro
lassevájkudus	lassevájkudus
lasseájgge	lasseájgge
lasseárvvo	lasseárvvo
lasseárvvovierro	lasseárvvovierro
lasstabårjås	lasstabårjås
lasstamuorra	lasstamuorra
lasstarásse	lasstarásse
lasstasålgge	lasstasålgge
lasstavuovdde	lasstavuovdde
latiidna	latijnna
lavnnjegierdde	lavnnjegierdde
lavnnjegoahte	lavnnjegoahte
lavnnjejiegge	lavnnjejiegge
lađas	ladás
lađđi	ladde
leapma	liebma
lektor	lektur
lektoráhta	lekturáhta
liebmaájtte	liebmaájtte
lieggabåhtål	lieggabåhtål
lieggarijkka	lieggarijkka
liehkejiehkke	liehkejiehkke
liejbbelådde	liejbbelådde
liekkasfábmo	liekkasfábmo
liekkassådjo	liekkassådjo
liepma	liebma
lihkkoluossa	lihkkoluossa
liidna	lijnna
lijggehiergge	lijggehiergge
lijggeruhta	lijggeruhta
lijggesivva	lijggesivva
lijggeviehkke	lijggeviehkke
lijggeáhkká	lijggeáhkká
lijkkagárvvo	lijkkagárvvo
lijkkavárjjo	lijkkavárjjo
lijkkedihkke	lijkkedihkke
lijkkegiera	lijkkegiera
lijnnatjielgge	lijnnatjielgge
lijnnebivtas	lijnnebivtas
lijnneoajvve	lijnneoajvve
linssasuodna	linssasuodna
liturgga	liturgga
livvasadje	livvasadje
loaddaárppo	loaddaárppo
loahppagiehtje	loahppagiehtje
loahppaárvvalus	loahppaárvvalus
lullebiegga	lullebiegga
lullenáhkkesoadje	lullenáhkkesoadje
lullerijkka	lullerijkka
lullesábme	lullesábme
lummaluojtte	lummaluojtte
luoddamåhkke	luoddamåhkke
luoddaárppo	luoddaárppo
luodoielle	luodoielle
luodonávdde	luodonávdde
luondobálges	luondobálges
luondofábmo	luondofábmo
luondogiedde	luondogiedde
luondogiergge	luondogiergge
luondoguovdásj	luondoguovdásj
luondoluossa	luondoluossa
luondomiehttse	luondomiehttse
luondomåjvve	luondomåjvve
luondoresurssa	luondoresurssa
luondorijkka	luondorijkka
luondoæládus	luondoæládus
luopma	luobma
luossabivdde	luossabivdde
luossabivddo	luossabivddo
luossabivddosadje	luossabivddosadje
luossabájkke	luossabájkke
luossadivrre	luossadivrre
luossagiera	luossagiera
luossaguolle	luossaguolle
luossagárdde	luossagárdde
luossajåhkå	luossajåhkå
luossaláhkalávddegådde	luossaláhkalávddegådde
luossavuodna	luossavuodna
luosstegådde	luosstegådde
luosstetjuohppe	luosstetjuohppe
luovassijdda	luovassijdda
luovastjårå	luovastjårå
luovveasske	luovveasske
lábmelådde	lábmelådde
lábmelåttebiesse	lábmelåttebiesse
lágafábmo	lágafábmo
láhkagirjje	láhkagirjje
láhkahærrá	láhkahærrá
láhkalávddegådde	láhkalávddegådde
láhkamærrádus	láhkamærrádus
láhkarievddadus	láhkarievddadus
láhkasuodjalus	láhkasuodjalus
láhkaålmåj	láhkaålmåj
láhttogártta	láhttogártta
lájbbebårre	lájbbebårre
lájbbefiello	lájbbefiello
lájggogasskavuohta	lájggogasskavuohta
lájggomákso	lájggomákso
lájggoviessosadje	lájggoviessosadje
lájreduvvá	lájreduvvá
lájreskierro	lájreskierro
lájvesmielkke	lájvesmielkke
lámeájgge	lámeájgge
lássalávdde	lássalávdde
láttebárnne	láttebárnne
látteáksjo	látteáksjo
lávddegådde	lávddegådde
lávddegåddemálle	lávddegåddemálle
lávggolihtte	lávggolihtte
lávkkeoajvve	lávkkeoajvve
lávlla	lávla
lávvogoahte	lávvogoahte
láđđi	ládde
låddebiebbmo	låddebiebbmo
låddebivddo	låddebivddo
låddebádde	låddebádde
låddelávdde	låddelávdde
låhkkebirás	låhkkebirás
låhkkeiepper	låhkkeiepper
låhkkerabán	låhkkerabán
låhkoguolle	låhkoguolle
låhkomierre	låhkomierre
låssåmiella	låssåmiella
låssåájmmo	låssåájmmo
låttebiesse	låttebiesse
låttegadtsa	låttegadtsa
låttegálla	låttegálla
låttetjalmme	låttetjalmme
låttetjivgga	låttetjivgga
mannevuovdda	mannevuovdda
mannjebielle	mannjebielle
matematihkkagirjje	matematihkkagirjje
mađđa	madda
maŋáš	maŋásj
maŋŋebárdde	maŋŋebárdde
maŋŋedilljá	maŋŋedilljá
maŋŋegiehtje	maŋŋegiehtje
maŋŋeguovdásjtjiektje	maŋŋeguovdásjtjiektje
maŋŋejuolgge	maŋŋejuolgge
maŋŋejuvlla	maŋŋejuvlla
maŋŋejuvlladoajmma	maŋŋejuvlladoajmma
maŋŋelassta	maŋŋelassta
maŋŋelåhkke	maŋŋelåhkke
maŋŋemadda	maŋŋemadda
maŋŋeoassi	maŋŋeoasse
maŋŋesiejnne	maŋŋesiejnne
maŋŋeskoahtta	maŋŋeskoahtta
maŋŋetjiektje	maŋŋetjiektje
maŋŋetjuovgga	maŋŋetjuovgga
maŋŋeurbbe	maŋŋeurbbe
maŋŋeáksil	maŋŋeáksel
maŋŋi	maŋŋe
mašiidna	masjijnna
miehtebiegga	miehtebiegga
miehtemiella	miehtemiella
miehteájdde	miehteájdde
miehtseielle	miehtseielle
miehtseviehkkebargge	miehtseviehkkebargge
miehtseáddjá	miehtseáddjá
miehttsebijlaluodda	miehttsebijlaluodda
miehttsebivddo	miehttsebivddo
miehttsebuvta	miehttsebuvta
miehttsedoajmma	miehttsedoajmma
miehttsedoalle	miehttsedoalle
miehttsedoallo	miehttsedoallo
miehttsefievrro	miehttsefievrro
miehttsegahpermuorjje	miehttsegahpermuorjje
miehttsegiedde	miehttsegiedde
miehttsehállde	miehttsehállde
miehttseielle	miehttseielle
miehttseluodda	miehttseluodda
miehttselådde	miehttselådde
miehttsemanne	miehttsemanne
miehttsemáhtto	miehttsemáhtto
miehttseresurssa	miehttseresurssa
miehttsesuorgge	miehttsesuorgge
miehttseviehkkebarggekurssa	miehttseviehkkebarggekurssa
miehttsevirusj	miehttsevirusj
mielavállde	mielavállde
mielkkebuvta	mielkkebuvta
mielkkeiepper	mielkkeiepper
mielkkeráksá	mielkkeráksá
miellabuohttseláhka	miellabuohttseláhka
mierddebuoddo	mierddebuoddo
mierkkátjuovgga	mierkkátjuovgga
mierká	mierkká
mierreruhta	mierreruhta
mierreájgge	mierreájgge
mierreájggemákso	mierreájggemákso
miesebårggå	miesebårggå
miesegahper	miesegahper
mieseieddne	mieseieddne
miesenáhkke	miesenáhkke
miessemánno	miessemánno
miessetjårå	miessetjårå
miesseálldo	miesseálldo
mihttobádde	mihttobádde
mihttoglássa	mihttoglássa
mihttolássa	mihttolássa
mihttolávve	mihttolávve
mihttolåhko	mihttolåhko
mihttomierre	mihttomierre
mihttosoabbe	mihttosoabbe
miidna	mijnna
minerálalijgge	minerálalijgge
minerálaláhka	minerálaláhka
minerálaresurssa	minerálaresurssa
moarssehadde	moarssehadde
moarsserásse	moarsserásse
mujttogiergge	mujttogiergge
mujttonjuolgadus	mujttonjuolgadus
mujttosárnne	mujttosárnne
muoddááddjá	muoddááddjá
muodobirásbádde	muodobirásbádde
muohtabálges	muohtabálges
muohtabårggå	muohtabårggå
muohtogåvvå	muohtogåvvå
muohtotjåhkkå	muohtotjåhkkå
muorjjejahke	muorjjejahke
muorjjemiehttse	muorjjemiehttse
muorjjesládja	muorjjesládja
muorrabasste	muorrabasste
muorrabielle	muorrabielle
muorragárdde	muorragárdde
muorralådde	muorralådde
muorramiehttse	muorramiehttse
muorramátta	muorramátta
muorrasládja	muorrasládja
muorraullo	muorraullo
muottábielle	muottábielle
museasijdda	museasijdda
museasuorgge	museasuorgge
máhkabielle	máhkabielle
máhtsobádde	máhtsobádde
máhttsobádde	máhttsobádde
májnnodahko	májnnodahko
máksomierre	máksomierre
máksosadje	máksosadje
málesnárre	málesnárre
málesrádde	málesrádde
mállegárre	mállegárre
málmmagiedde	málmmagiedde
mánnogasska	mánnogasska
mánnágijssá	mánnágijssá
mánnágássta	mánnágássta
mánnágådde	mánnágådde
mánnálåhko	mánnálåhko
mánotjalmme	mánotjalmme
mánáboahkko	mánáboahkko
mánágoahtenjálbmi	mánágoahtenjálmme
mánágoahti	mánágoahte
mánáš	mánásj
márffedájgge	márffedájgge
márffelihtte	márffelihtte
márffeságge	márffeságge
máttabalvva	máttabalvva
máttabiegga	máttabiegga
máttabielle	máttabielle
máttabádne	máttabádne
máttagiehtje	máttagiehtje
máttanuortte	máttanuortte
máttaoarjje	máttaoarjje
máttarijkka	máttarijkka
máttarmáddo	máttarmáddo
máttaráddjá	máttaráddjá
máttaráhkko	máttaráhkko
máttarájgge	máttarájgge
máttasábme	máttasábme
månnebákte	månnebákte
månneráksá	månneráksá
månnesadje	månnesadje
månnetjoagge	månnetjoagge
nagerdárbbo	nagerdárbbo
nammabiejvve	nammabiejvve
nammagalbba	nammagalbba
nammaloahppa	nammaloahppa
nammaláhka	nammaláhka
nammaláđđi	nammaládde
nammasijddo	nammasijddo
nammavahkko	nammavahkko
nettohadde	nettohadde
nettovuohke	nettovuohke
niehkkediehkke	niehkkediehkke
niehttegarjjá	niehttegarjjá
niejddabielle	niejddabielle
niejddagihppo	niejddagihppo
niejddagirkko	niejddagirkko
niejddamánná	niejddamánná
nielgehiehte	nielgehiehte
nielggejahke	nielggejahke
nierrabieles	nierrabieles
nierragievlle	nierragievlle
nierratjåhkkå	nierratjåhkkå
nierratjålggåráksá	nierratjålggåráksá
niesstebiesse	niesstebiesse
niesstelávkka	niesstelávkka
niesstesoarvve	niesstesoarvve
nievresdálkke	nievresdálkke
nievrredálkke	nievrredálkke
nievrremiella	nievrremiella
nijbbegiehtje	nijbbegiehtje
nijbbesjimer	nijbbesjimer
nisskebádde	nisskebádde
nisskeládde	nisskeládde
nisskemátta	nisskemátta
nisskesuodna	nisskesuodna
nissunaperspektijvva	nissunaperspektijvva
nissunbarggosadje	nissunbarggosadje
nissunbielle	nissunbielle
nissunbivtas	nissunbivtas
nissunperspektijvva	nissunperspektijvva
njagoájdde	njagoájdde
njammemánná	njammemánná
njoammelruovdde	njoammelruovdde
njoammelrásse	njoammelrásse
njoammelsuojnne	njoammelsuojnne
njoammodávdda	njoammodávdda
njoasskerájgge	njoasskerájgge
njoatsesjuohko	njoatsesjuohko
njoađve	njoarvve
njoađvi	njoarvve
njuktjamánno	njuktjamánno
njukča	njuktja
njuorgesguolle	njuorgesguolle
njuorssjodållå	njuorssjodållå
njuosskaladnja	njuosskaladnja
njuovvelávkke	njuovvelávkke
njuovvesjaddo	njuovvesjaddo
njuvtjamánno	njuvtjamánno
njáhcu	njáhtso
njáhká	njáhká
njáhtsogáma	njáhtsogáma
njáhtsomuohta	njáhtsomuohta
njálbmeoalli	njálmmeoalle
njálbmi	njálmme
njálla	njálla
njálmebihttá	njálmebihttá
njálmedoarro	njálmedoarro
njálmmebirásdiehkke	njálmmebirásdiehkke
njálmmeguoddo	njálmmeguoddo
njálmmemájnne	njálmmemájnne
njálmmeruovdde	njálmmeruovdde
njálmmerájgge	njálmmerájgge
njálmmeskoavdde	njálmmeskoavdde
njálmmesoahte	njálmmesoahte
njálmmesuorre	njálmmesuorre
njálmmesågge	njálmmesågge
njálmmetjiehka	njálmmetjiehka
njárga	njárgga
njávveguolgga	njávveguolgga
njávvi	njávve
noajddebiergas	noajddebiergas
noajddegoanssta	noajddegoanssta
noajddegádtse	noajddegádtse
noajddeáhkko	noajddeáhkko
noarssarásse	noarssarásse
noarssasjaddo	noarssasjaddo
nubbegiella	nubbegiella
nulppogahper	nulppogahper
nuohttebahta	nuohttebahta
nuohttebujtte	nuohttebujtte
nuohttegoahte	nuohttegoahte
nuorragierdde	nuorragierdde
nuorragierddedásse	nuorragierddedásse
nuortabielle	nuortabielle
nuortagiehtje	nuortagiehtje
nuortanásste	nuortanásste
nuorttabiegga	nuorttabiegga
nuorttadavvebiegga	nuorttadavvebiegga
nuorttanásste	nuorttanásste
nuorttarijkka	nuorttarijkka
nuorttasijdda	nuorttasijdda
nuorttasábme	nuorttasábme
nuorttatsihtse	nuorttatsihtse
nuoskesdávdda	nuoskesdávdda
nábár	nábár
nággu	nággo
náhkkebivtas	náhkkebivtas
náhkkegiera	náhkkegiera
náhkkesoadje	náhkkesoadje
náhkkevuovdde	náhkkevuovdde
náhkki	náhkke
náhpetjoalle	náhpetjoalle
náhpi	náhpe
náhppa	náhppa
náhppi	náhppe
náhpu	náhpo
nákkisvuohta	nákkesvuohta
nálle	nálle
nálli	nálle
nállogoahte	nállogoahte
nállojiegŋa	nállojiegŋa
nállomuorra	nállomuorra
nállosjalmme	nállosjalmme
nállu	nállo
námmetjoarvve	námmetjoarvve
námmi	námme
nárri	nárre
náránaš	náránasj
náráš	nárásj
násstegállo	násstegállo
násstetjoahkke	násstetjoahkke
násstetoarnna	násstetoarnna
náste	násste
násti	násste
nástton	nástun
návdi	návdde
návleoažži	návlleoadtje
návli	návlle
návlleoajvve	návlleoajvve
návste	návsste
návsti	návsste
oabmegoahte	oabmegoahte
oabmemánno	oabmemánno
oadtjegiehtje	oadtjegiehtje
oadtjevuodja	oadtjevuodja
oahppagirjje	oahppagirjje
oahppaárvvo	oahppaárvvo
oahppogirjje	oahppogirjje
oahppogirjjetjálle	oahppogirjjetjálle
oahppolihtto	oahppolihtto
oahpposadje	oahpposadje
oahpposuorgge	oahpposuorgge
oajvvebádne	oajvvebádne
oajvvebávtjas	oajvvebávtjas
oajvvedoajmma	oajvvedoajmma
oajvvedákte	oajvvedákte
oajvvedávdda	oajvvedávdda
oajvvegálla	oajvvegálla
oajvveiset	oajvveiset
oajvvemátta	oajvvemátta
oajvvenjuolgadus	oajvvenjuolgadus
oajvverájddo	oajvverájddo
oajvveskálltjo	oajvveskálltjo
oajvvetjála	oajvvetjála
oajvvetjåhkkå	oajvvetjåhkkå
oajvvevihke	oajvvevihke
oajvvevuorre	oajvvevuorre
oajvvevárkka	oajvvevárkka
oajvveártta	oajvveártta
oajvveålmåj	oajvveålmåj
oajvveæládus	oajvveæládus
oalggebiegga	oalggebiegga
oalggebihttá	oalggebihttá
oalggebuvta	oalggebuvta
oalggebádde	oalggebádde
oalggediehkke	oalggediehkke
oalggedoajmma	oalggedoajmma
oalggedákte	oalggedákte
oalggedålgge	oalggedålgge
oalggejåhkå	oalggejåhkå
oalggeladás	oalggeladás
oalggemuorra	oalggemuorra
oalggenårås	oalggenårås
oalggenåråsdiehkke	oalggenåråsdiehkke
oalggenåråsváhkká	oalggenåråsváhkká
oalggetjalmme	oalggetjalmme
oalggeviellja	oalggeviellja
oalleláhke	oalleláhke
oarjjebiegga	oarjjebiegga
oarjjedavve	oarjjedavve
oarjjedavvebiegga	oarjjedavvebiegga
oarjjelsábme	oarjjelsábme
oarjjelsámegiella	oarjjelsámegiella
oarjjelulle	oarjjelulle
oarjjerijkka	oarjjerijkka
oarjjerádje	oarjjerádje
oarjjesámegiella	oarjjesámegiella
oarjjevuodna	oarjjevuodna
oarrebivgge	oarrebivgge
oarremuorjje	oarremuorjje
oarrevahkko	oarrevahkko
oassebielle	oassebielle
oassemierre	oassemierre
oasseprográmma	oasseprográmma
oassesuorgge	oassesuorgge
oassevállde	oassevállde
oasseålmåj	oasseålmåj
oassálasste	oassálasste
oavddodahko	oavddodahko
passijvva	passijvva
perspektijvva	perspektijvva
plánaláhkalávddegådde	plánaláhkalávddegådde
pressadiedádus	pressadiedádus
prográmma	prográmma
prográmmasládja	prográmmasládja
prográmmastivraválgga	prográmmastivraválgga
prográmmastivrra	prográmmastivrra
prográmmasuorgge	prográmmasuorgge
pálbma	pálmma
pálmmamuorra	pálmmamuorra
párra	párra
rabásájgge	rabásájgge
raddebádde	raddebádde
raddediehkke	raddediehkke
raddevuovdda	raddevuovdda
radnadållå	radnadållå
ragátájgge	ragátájgge
rahkkehiergge	rahkkehiergge
ramásguolgga	ramásguolgga
ratna	radna
referánssa	referánssa
renesánssa	renesánssa
ressurssa	ressurssa
resurssa	resurssa
resurssadille	resurssadille
resurssarámma	resurssarámma
ridnelådde	ridnelådde
ridnelåttebiesse	ridnelåttebiesse
ridnemánno	ridnemánno
riebmobiejvve	riebmobiejvve
riebmomáles	riebmomáles
riebmosálla	riebmosálla
riebmotjála	riebmotjála
riehpenjávrre	riehpenjávrre
rievdadus	rievddadus
rievddejiegŋa	rievddejiegŋa
riggeielle	riggeielle
riggetjalmme	riggetjalmme
rihtabielle	rihtabielle
rijkabiejvve	rijkabiejvve
rijkaguojmme	rijkaguojmme
rijkagådde	rijkagådde
rijkaoasselávddegådde	rijkaoasselávddegådde
rijkarádde	rijkarádde
rijkkaoasselávddegådde	rijkkaoasselávddegådde
rijmmagiergge	rijmmagiergge
rissjagåhppe	rissjagåhppe
rissjoladnja	rissjoladnja
ristieddne	ristieddne
ristáhttje	ristáhttje
rivggoniejdda	rivggoniejdda
rivggovuolppo	rivggovuolppo
roahtogoallo	roahtogoallo
roassjmevihke	roassjmevihke
roavggoskuohppo	roavggoskuohppo
ruhtadoalle	ruhtadoalle
ruhtadoallo	ruhtadoallo
ruhtagijssá	ruhtagijssá
ruhtagáhttjo	ruhtagáhttjo
ruhtagálldo	ruhtagálldo
ruhtalåhko	ruhtalåhko
ruhtarádjo	ruhtarádjo
ruhtarásse	ruhtarásse
ruhtaviehkke	ruhtaviehkke
ruhtavádne	ruhtavádne
ruhtaådåstus	ruhtaådåstus
ruhtačiehká	ruhtatjiehká
ruktaburssa	ruktaburssa
ruktatjoarvve	ruktatjoarvve
ruobbejiegŋa	ruobbejiegŋa
ruohttagálles	ruohttagálles
ruohttaiehket	ruohttaiehket
ruossahievnne	ruossahievnne
ruossanásste	ruossanásste
ruossatjoarvve	ruossatjoarvve
ruossaájdde	ruossaájdde
ruossačiehka	ruossatjiehka
ruossjaboajmásj	ruossjaboajmásj
ruossjaniejdda	ruossjaniejdda
ruossjanjoammel	ruossjanjoammel
ruovddedoallo	ruovddedoallo
ruovddegáma	ruovddegáma
ruovddegåbbå	ruovddegåbbå
ruovddehávve	ruovddehávve
ruovddeluodda	ruovddeluodda
ruovddenávlle	ruovddenávlle
ruovddesjilla	ruovddesjilla
ruovddetjuollda	ruovddetjuollda
ruovddetsihtse	ruovddetsihtse
ruovddeájgge	ruovddeájgge
ruovddáš	ruovdásj
ruvssogálla	ruvssogálla
ráddeviesso	ráddeviesso
ráddeålmåj	ráddeålmåj
rádjebássa	rádjebássa
rádjejåhkå	rádjejåhkå
rádjesjiehtadus	rádjesjiehtadus
rádjesuodjalus	rádjesuodjalus
rádjeájdde	rádjeájdde
rádjeárvvo	rádjeárvvo
rádjoladnja	rádjoladnja
rádna	ráddna
ráfesjiehtadus	ráfesjiehtadus
rággebáldes	rággebáldes
rággeguolle	rággeguolle
rággeluossa	rággeluossa
ráhpporågge	ráhpporågge
rájddogåvvå	rájddogåvvå
rájddohiergge	rájddohiergge
rájggeoajvve	rájggeoajvve
rájggesuohkko	rájggesuohkko
rákkoguolle	rákkoguolle
rámmasuorgge	rámmasuorgge
ráserásse	ráserásse
rássegiedde	rássegiedde
rássegåbbå	rássegåbbå
rásselávkke	rásselávkke
rásseoajvve	rásseoajvve
rássesjaddo	rássesjaddo
råbevuolle	råbevuolle
råhkåjáffo	råhkåjáffo
råhkårásse	råhkårásse
råhtojærjjá	råhtojærjjá
råhtolavnnje	råhtolavnnje
råhtosuojnne	råhtosuojnne
råhttodávdda	råhttodávdda
råvajáffo	råvajáffo
råvajærjjá	råvajærjjá
råvasuojnne	råvasuojnne
sadjehábme	sadjehábme
sadjásasjbargge	sadjásasjbargge
sadjásasjvirgge	sadjásasjvirgge
sahkkoálldo	sahkkoálldo
sahkolassta	sahkolassta
sahkourbbe	sahkourbbe
sahtesadje	sahtesadje
sarvarásse	sarvarásse
sarvatjoarvve	sarvatjoarvve
saŋásjdávdda	saŋásjdávdda
sidnoáhpe	sidnoáhpe
siebebielle	siebebielle
siehpebårdde	siehpebårdde
siejbbelahkke	siejbbelahkke
siejbbenásste	siejbbenásste
siejnebielle	siejnebielle
siejnneguorra	siejnneguorra
siejnnehirssa	siejnnehirssa
siejnnerádno	siejnnerádno
siejnnerávdde	siejnnerávdde
siekteruovdde	siekteruovdde
siekŋa	siegŋa
sielgebielle	sielgebielle
sielgeduohke	sielgeduohke
sielggeieddne	sielggeieddne
sielggevihke	sielggevihke
sierggabiejvvelådde	sierggabiejvvelådde
sierggasjaddo	sierggasjaddo
sierggaskierre	sierggaskierre
sierggatsihtse	sierggatsihtse
sierrabuvta	sierrabuvta
sierrafievrro	sierrafievrro
sierraguovllo	sierraguovllo
sierragurssa	sierragurssa
sierralasádus	sierralasádus
sierraláhka	sierraláhka
sierraláhki	sierraláhke
sierraárvvo	sierraárvvo
siessábielle	siessábielle
siesáš	siesásj
sieđga	siergga
sijdaiset	sijdaiset
sijddaguojmme	sijddaguojmme
sijddaguosse	sijddaguosse
sijddastivrra	sijddastivrra
sijddodoajmma	sijddodoajmma
siktajáffo	siktajáffo
siktalájbbe	siktalájbbe
silbbasijddo	silbbasijddo
silledákte	silledákte
sisbiellje	sisbiellje
sisbirás	sisbirás
sisbivtas	sisbivtas
sisdávdda	sisdávdda
sisgáhtto	sisgáhtto
sisrijkka	sisrijkka
sissiejnne	sissiejnne
sisvihke	sisvihke
sisájmmo	sisájmmo
sjaddodieda	sjaddodieda
sjaddogierdde	sjaddogierdde
sjaddogierddeavve	sjaddogierddeavve
sjaddogárdde	sjaddogárdde
sjaddomuorra	sjaddomuorra
sjaddoviesso	sjaddoviesso
sjaddovisste	sjaddovisste
sjaddovuodja	sjaddovuodja
sjiehtadusbielle	sjiehtadusbielle
sjnjilltjamánno	sjnjilltjamánno
skoaddedákte	skoaddedákte
skoarrojåhkå	skoarrojåhkå
skuhtjetjiehka	skuhtjetjiehka
skuhči	skuhtje
skáhpelådde	skáhpelådde
skájddegiehtje	skájddegiehtje
skárrebielle	skárrebielle
skåvllåvádtse	skåvllåvádtse
slubbojuolgge	slubbojuolgge
slubborásse	slubborásse
sládjavádne	sládjavádne
smáhkkomuorra	smáhkkomuorra
smávvagirdde	smávvagirdde
smávvagoalsse	smávvagoalsse
smávvaielle	smávvaielle
smávvamánná	smávvamánná
smávvaoabme	smávvaoabme
smávvaskávlle	smávvaskávlle
smávvaviesso	smávvaviesso
snarreoajvve	snarreoajvve
snálldooajvve	snálldooajvve
snårreoajvve	snårreoajvve
soadjedålgge	soadjedålgge
soadjegiehtje	soadjegiehtje
soadjetjiehka	soadjetjiehka
soadjetjuollda	soadjetjuollda
soahkerástes	soahkerástes
soahkevuovdde	soahkevuovdde
soahtegasskaájgge	soahtegasskaájgge
soahtegárdde	soahtegárdde
soahtejahke	soahtejahke
soahtelasse	soahtelasse
soahterásse	soahterásse
soahteájgge	soahteájgge
spánsskadávdda	spánsskadávdda
stijlasuorgge	stijlasuorgge
stivraválgga	stivraválgga
stivrralahtto	stivrralahtto
stivrrasadje	stivrrasadje
stivrrár	stivrár
struktuvrra	struktuvrra
stuorabasste	stuorabasste
stuoradiggeválgga	stuoradiggeválgga
stuoralådde	stuoralådde
stuoresvuodaájgge	stuoresvuodaájgge
stuorradiggediedádus	stuorradiggediedádus
stuorradiggeválgga	stuorradiggeválgga
stuorrafiehta	stuorrafiehta
stuorrafábmoájgge	stuorrafábmoájgge
stuorralådde	stuorralådde
stuorraoabme	stuorraoabme
stuorrarástes	stuorrarástes
stuorrasájdde	stuorrasájdde
stuorraulle	stuorraulle
stuorravassje	stuorravassje
stuorravuojasj	stuorravuojasj
stuorravállde	stuorravállde
stuorraválldeájgge	stuorraválldeájgge
stággogiera	stággogiera
stággoruddne	stággoruddne
stággotsagge	stággotsagge
stáhtabargge	stáhtabargge
stáhtagirkko	stáhtagirkko
stáhtahábme	stáhtahábme
stáhtalahtto	stáhtalahtto
stáhtarádde	stáhtarádde
stáhtatjálle	stáhtatjálle
stáhtatjállelávddegådde	stáhtatjállelávddegådde
stáhtavuovdde	stáhtavuovdde
stáhtavállde	stáhtavállde
stállegájnno	stállegájnno
stáloburssa	stáloburssa
stálobåsskå	stálobåsskå
stálonjárgga	stálonjárgga
stávvaljuohko	stávvaljuohko
stávvalsáhtso	stávvalsáhtso
stáđisvuohta	stádesvuohta
stáđđi	stádde
ståhkketjoarvve	ståhkketjoarvve
ståvllåbiellje	ståvllåbiellje
substánssa	substánssa
suhpebiejvvelådde	suhpebiejvvelådde
suodjegahper	suodjegahper
suodjeivnne	suodjeivnne
suodjevuovdde	suodjevuovdde
suodnabájnne	suodnabájnne
suodnabárkko	suodnabárkko
suohkanabargge	suohkanabargge
suohkanbargge	suohkanbargge
suohkanbáhppa	suohkanbáhppa
suohkanstivrra	suohkanstivrra
suohkungierdde	suohkungierdde
suojnnebiejvvelådde	suojnnebiejvvelådde
suojnnegiedde	suojnnegiedde
suojnnemánno	suojnnemánno
suojnneruhtarásse	suojnneruhtarásse
suojnnesjaddo	suojnnesjaddo
suojnnetjalmme	suojnnetjalmme
suoksamuddo	suoksamuddo
suopma	suobma
suormmagiehtje	suormmagiehtje
suormmaladás	suormmaladás
suormmalávdde	suormmalávdde
suormmarásse	suormmarásse
suormmavádtse	suormmavádtse
suorrefálle	suorrefálle
suotna	suodna
suotnacuozza	suodnatsuodtsa
suotnačuolbma	suodnatjuolmma
suovasbierggo	suovasbierggo
suovasdållå	suovasdållå
suovasguolle	suovasguolle
suovddelassta	suovddelassta
suovddelåhkke	suovddelåhkke
suovvabuvrre	suovvabuvrre
suovvarájgge	suovvarájgge
suvrraguolle	suvrraguolle
suvrralájbbe	suvrralájbbe
suvrramielkke	suvrramielkke
sábbát	sábbát
sádjá	sádjá
sáfta	sáfta
ságadoalle	ságadoalle
sággegahper	sággegahper
sággetjoarvve	sággetjoarvve
sággi	ságge
sáhcu	sáhtso
sáhka	sáhka
sáhkavuorro	sáhkavuorro
sáhkku	sáhkko
sáhppelassta	sáhppelassta
sáhpperáhkko	sáhpperáhkko
sáhppi	sáhppe
sáhtsobihttá	sáhtsobihttá
sáhtsodahkke	sáhtsodahkke
sáhttogirdde	sáhttogirdde
sáhttoålmåj	sáhttoålmåj
sáhttu	sáhtto
sáhtán	sáhtán
sáibu	sájbbo
sáidi	sájdde
sáigu	sájggo
sáiti	sájtte
sáiva	sájvva
sájbbogiergge	sájbbogiergge
sájddebájkke	sájddebájkke
sájddebåsso	sájddebåsso
sájggovuolppo	sájggovuolppo
sájttesoabbe	sájttesoabbe
sájvvabivddo	sájvvabivddo
sájvvabivddoláhka	sájvvabivddoláhka
sájvvaguolle	sájvvaguolle
sálaš	sálasj
sálbma	sálmma
sálga	sálgga
sálla	sálla
sállteguolle	sállteguolle
sálltelihtte	sálltelihtte
sállteláhka	sállteláhka
sálltesuojnne	sálltesuojnne
sálltetjalmme	sálltetjalmme
sálltetjuovttja	sálltetjuovttja
sálmmagirjje	sálmmagirjje
sálti	sállte
sálvu	sálvvo
sámebivtas	sámebivtas
sámebárnne	sámebárnne
sámediggerádde	sámediggerádde
sámediggeválgga	sámediggeválgga
sámedikkeválgga	sámedikkeválgga
sámeduodje	sámeduodje
sámegille	sámegille
sámeguovloplakáhtta	sámeguovloplakáhtta
sámegáhkko	sámegáhkko
sámelávddegådde	sámelávddegådde
sámemánná	sámemánná
sámenamma	sámenamma
sámeniejdda	sámeniejdda
sámesijdda	sámesijdda
sámevuodna	sámevuodna
sámevuohta	sámevuohta
sámeválggastivraválgga	sámeválggastivraválgga
sámeválggastivrra	sámeválggastivrra
sámidiggi	sámedigge
sámigiella	sámegiella
sámiláhka	sámeláhka
sámimusea	sámemusea
sámivuohta	sámevuohta
sápmi	sábme
sárdi	sárdde
sárdni	sárnne
sárgatjielgge	sárgatjielgge
sárgi	sárgge
sárgu	sárggo
sárnneålmåj	sárnneålmåj
sárri	sárre
sátta	sátta
sáttagådde	sáttagådde
sáttaålmåj	sáttaålmåj
sávdni	sávnne
sávlalådde	sávlalådde
sávtsabierggo	sávtsabierggo
sávtsamielkke	sávtsamielkke
sávtsarásse	sávtsarásse
sávtsaskálltjo	sávtsaskálltjo
sávttsabierggo	sávttsabierggo
sávttsadoallo	sávttsadoallo
sávttsaieddne	sávttsaieddne
sávttsatjårå	sávttsatjårå
sávza	sávttsa
sávzzanáhkki	sávtsanáhkke
sáđga	sárgga
sáđgi	sárgge
sådnåbiejvve	sådnåbiejvve
såggerájgge	såggerájgge
såhkåbielle	såhkåbielle
såhkåbuolvva	såhkåbuolvva
såhkågådde	såhkågådde
såhkånamma	såhkånamma
såhkårdávdda	såhkårdávdda
sårmmebájkke	sårmmebájkke
telefongirjje	telefongirjje
telefonguovdásj	telefonguovdásj
telefongållo	telefongållo
telefonnummar	telefonnummar
telefáksa	telefáksa
telegrámma	telegrámma
teáhter	teáhter
teáhterbargge	teáhterbargge
tiedjabasste	tiedjabasste
tjaktjadálvve	tjaktjadálvve
tjaktjagiesse	tjaktjagiesse
tjaktjaidja	tjaktjaidja
tjaktjamielkkerásse	tjaktjamielkkerásse
tjaktjamánno	tjaktjamánno
tjalmasmielkke	tjalmasmielkke
tjalmmebádne	tjalmmebádne
tjalmmegiehtje	tjalmmegiehtje
tjalmmegulmme	tjalmmegulmme
tjalmmegáhkká	tjalmmegáhkká
tjalmmegålle	tjalmmegålle
tjalmmeieddne	tjalmmeieddne
tjalmmeluobma	tjalmmeluobma
tjalmmeluosste	tjalmmeluosste
tjalmmemuorra	tjalmmemuorra
tjalmmeramás	tjalmmeramás
tjalmmerigge	tjalmmerigge
tjalmmevihke	tjalmmevihke
tjalmmeáhkko	tjalmmeáhkko
tjibbeladás	tjibbeladás
tjibbeskálltjo	tjibbeskálltjo
tjidtjeoajvve	tjidtjeoajvve
tjidtjeráksá	tjidtjeráksá
tjiebetdákte	tjiebetdákte
tjiebetlijnne	tjiebetlijnne
tjiebetmátta	tjiebetmátta
tjiebetnávdde	tjiebetnávdde
tjiebettjuohppe	tjiebettjuohppe
tjiehkabádne	tjiehkabádne
tjiehkadahkke	tjiehkadahkke
tjiehkagiehtje	tjiehkagiehtje
tjiehkajuolgge	tjiehkajuolgge
tjielgadusbarggo	tjielgadusbarggo
tjielggamielkke	tjielggamielkke
tjielggatjårå	tjielggatjårå
tjielggebádde	tjielggebádde
tjielggedákte	tjielggedákte
tjielggegárre	tjielggegárre
tjielggesuodna	tjielggesuodna
tjielggetjårro	tjielggetjårro
tjievrravuolpporásse	tjievrravuolpporásse
tjievttjeballe	tjievttjeballe
tjievttjeladás	tjievttjeladás
tjievttjesuodna	tjievttjesuodna
tjikteárppo	tjikteárppo
tjoahkkebájkke	tjoahkkebájkke
tjoallegiehtje	tjoallegiehtje
tjoallenámme	tjoallenámme
tjoarvvebasste	tjoarvvebasste
tjoarvvebielle	tjoarvvebielle
tjoarvvebágge	tjoarvvebágge
tjoarvvedahkke	tjoarvvedahkke
tjoarvvedákte	tjoarvvedákte
tjoarvvedáktegåhpe	tjoarvvedáktegåhpe
tjoarvvedåhppå	tjoarvvedåhppå
tjoarvvegiella	tjoarvvegiella
tjoarvvegiersse	tjoarvvegiersse
tjoarvvelahkke	tjoarvvelahkke
tjoarvvemátta	tjoarvvemátta
tjoarvverigge	tjoarvverigge
tjoarvvesuorre	tjoarvvesuorre
tjoarvvesárggo	tjoarvvesárggo
tjoarvvetsuodtsa	tjoarvvetsuodtsa
tjuoggorásse	tjuoggorásse
tjuohtejahke	tjuohtejahke
tjuojkaieddne	tjuojkaieddne
tjuojkaájgge	tjuojkaájgge
tjuokkesmierre	tjuokkesmierre
tjuokkessáhtso	tjuokkessáhtso
tjuolmmamuorra	tjuolmmamuorra
tjuomasladnja	tjuomasladnja
tjuormasguoppar	tjuormasguoppar
tjuorvasjienastus	tjuorvasjienastus
tjuovgasgálldo	tjuovgasgálldo
tjuovggabálkko	tjuovggabálkko
tjuovggabárro	tjuovggabárro
tjuovggafábmo	tjuovggafábmo
tjuovggagåvvå	tjuovggagåvvå
tjuovggajahke	tjuovggajahke
tjurrorásse	tjurrorásse
tjuvddevuokse	tjuvddevuokse
tjálabájkke	tjálabájkke
tjálarájddo	tjálarájddo
tjáppagirjje	tjáppagirjje
tjåhkkoságge	tjåhkkoságge
tjåhkkåjiehkke	tjåhkkåjiehkke
tjårmmånjuolgadus	tjårmmånjuolgadus
tjåråielle	tjåråielle
tjåttådávdda	tjåttådávdda
tjåttårájgge	tjåttårájgge
tjævrrábiedjo	tjævrrábiedjo
tjævrráruovdde	tjævrráruovdde
tráktor	tráktur
trákturdájggo	trákturdájggo
tsiehkkemuorra	tsiehkkemuorra
tsinnarájgge	tsinnarájgge
tsirggogirdde	tsirggogirdde
tsissanávlle	tsissanávlle
tsitsásjfálle	tsitsásjfálle
tsitsásjmielkke	tsitsásjmielkke
tsuohppaladnja	tsuohppaladnja
tsuovkkasáhtso	tsuovkkasáhtso
tv-prográmma	tv-prográmma
tákta	tákta
uhtsamánná	uhtsamánná
uhtsatsihtse	uhtsatsihtse
uhtsavirusj	uhtsavirusj
uksabieles	uksabieles
uksabiellje	uksabiellje
uksabáddi	uksabádde
uksagasska	uksagasska
uksarájgge	uksarájgge
ullooajvve	ullooajvve
unnamánná	unnamánná
unnanijbásj	unnanijbásj
vahkkolahkke	vahkkolahkke
vahkkoloahppa	vahkkoloahppa
vahkoloahppa	vahkoloahppa
vaksiidna	vaksijnna
valljevádne	valljevádne
valvveielle	valvveielle
varragáhkko	varragáhkko
varrajiesska	varrajiesska
varrajåhto	varrajåhto
varralijkke	varralijkke
varrasuodna	varrasuodna
varrasåhkår	varrasåhkår
varratjoarvve	varratjoarvve
varračuolbma	varratjuolmma
varásmáles	varásmáles
videobiergas	videobiergas
videobáddi	videobádde
vieddemuorjje	vieddemuorjje
viehkkebargge	viehkkebargge
viehkkedoajmma	viehkkedoajmma
viehkkeprográmma	viehkkeprográmma
viehkkeruhta	viehkkeruhta
viehtjersjalmme	viehtjersjalmme
viejggefálle	viejggefálle
viejkkebåsun	viejkkebåsun
vielggegirjje	vielggegirjje
vielljabielle	vielljabielle
vieresålmåj	vieresålmåj
vierkkadálkas	vierkkadálkas
vierredahkke	vierredahkke
vierredahko	vierredahko
vierrodille	vierrodille
vierrofriddjavuohta	vierrofriddjavuohta
vierrogiella	vierrogiella
vierrogiesse	vierrogiesse
vierrogirjje	vierrogirjje
vierrogoartta	vierrogoartta
vierroguodde	vierroguodde
vierrojahke	vierrojahke
vierroláhka	vierroláhka
vierromákse	vierromákse
vierrovállde	vierrovállde
viessogálvvo	viessogálvvo
viessolájggo	viessolájggo
viessorásse	viessorásse
viessosadje	viessosadje
viidna	vijnna
villebierggo	villebierggo
vinjotjoarvve	vinjotjoarvve
virggedoalle	virggedoalle
virggegasskavuohta	virggegasskavuohta
virggeguovllo	virggeguovllo
virggegájbbádus	virggegájbbádus
virggeresurssa	virggeresurssa
virggeájgge	virggeájgge
virggeålmåj	virggeålmåj
visstelájggo	visstelájggo
visumvállde	visumvállde
vivvabielle	vivvabielle
vuobmegille	vuobmegille
vuodjadájgge	vuodjadájgge
vuodjagáhkko	vuodjagáhkko
vuodjaiepper	vuodjaiepper
vuodjalassta	vuodjalassta
vuodjalájbbe	vuodjalájbbe
vuodjarásse	vuodjarásse
vuodjaskáhppo	vuodjaskáhppo
vuodjačalbmi	vuodjatjalmme
vuodnabivdde	vuodnabivdde
vuodnabivddo	vuodnabivddo
vuodnabåsso	vuodnabåsso
vuodnagille	vuodnagille
vuodnagádde	vuodnagádde
vuoggastággo	vuoggastággo
vuohppabielle	vuohppabielle
vuohtarájppe	vuohtarájppe
vuohččicuozza	vuohttjetsuodtsa
vuohčču	vuohttjo
vuojŋŋanguovdásj	vuojŋŋanguovdásj
vuoksátjårå	vuoksátjårå
vuoledubme	vuoledubme
vuolgasadje	vuolgasadje
vuolgga	vuolga
vuollebahta	vuollebahta
vuollebielle	vuollebielle
vuollebádne	vuollebádne
vuollebátsa	vuollebátsa
vuolledásse	vuolledásse
vuolledávdda	vuolledávdda
vuollegiehtje	vuollegiehtje
vuollehadde	vuollehadde
vuollelassta	vuollelassta
vuolleluobma	vuolleluobma
vuollemadda	vuollemadda
vuollemåhkke	vuollemåhkke
vuolleramás	vuolleramás
vuolleriessjme	vuolleriessjme
vuollerijkka	vuollerijkka
vuollerádje	vuollerádje
vuolleviesso	vuolleviesso
vuollevuovdda	vuollevuovdda
vuollevájmmo	vuollevájmmo
vuolpporásse	vuolpporásse
vuonjalálldo	vuonjalálldo
vuorbádus	vuorbbádus
vuorkkágåvvå	vuorkkágåvvå
vuorkkásadje	vuorkkásadje
vuorká	vuorkká
vuorkágåvvå	vuorkágåvvå
vuorrolávla	vuorrolávla
vuorrovájkudus	vuorrovájkudus
vuossamåhkke	vuossamåhkke
vuosstebiegga	vuosstebiegga
vuosstebielle	vuosstebielle
vuosstegiehtje	vuosstegiehtje
vuossteháhko	vuossteháhko
vuosstemiella	vuosstemiella
vuosstevájkudus	vuosstevájkudus
vuosstálåhkke	vuosstálåhkke
vuotna	vuodna
vuotnabahta	vuodnabahta
vuotnanjálbmi	vuodnanjálmme
vuovddaduvvá	vuovddaduvvá
vuovddatjålggåráksá	vuovddatjålggåráksá
vuovddebargge	vuovddebargge
vuovddebarggo	vuovddebarggo
vuovddedoallo	vuovddedoallo
vuovddedoalloláhka	vuovddedoalloláhka
vuovddegådde	vuovddegådde
vuovddegåhttse	vuovddegåhttse
vuovddejiegge	vuovddejiegge
vuovddesidno	vuovddesidno
vuovddesiergga	vuovddesiergga
vuovddevállde	vuovddevállde
vádnedávdda	vádnedávdda
váhkkádiehkke	váhkkádiehkke
váhkkádákti	váhkkádákte
vájmmoarvusmahtte	vájmmoarvusmahtte
vájmmodiehkke	vájmmodiehkke
vájmmogåhpe	vájmmogåhpe
vájmmosivva	vájmmosivva
vájmmoskoadde	vájmmoskoadde
vájmmosuodna	vájmmosuodna
vájmmovihke	vájmmovihke
vájmovuolle	vájmovuolle
válggadigge	válggadigge
válggajahke	válggajahke
válggaladnja	válggaladnja
válggalissta	válggalissta
válggaláhkalávddegådde	válggaláhkalávddegådde
válggalávddegådde	válggalávddegådde
válgganammagådde	válgganammagådde
válgganjuolgaduslávddegådde	válgganjuolgaduslávddegådde
válggastivraválgga	válggastivraválgga
válggastivrra	válggastivrra
válldegådde	válldegådde
válldesuorgge	válldesuorgge
válldeájgge	válldeájgge
váreduohke	váreduohke
váreniejdda	váreniejdda
várevuolle	várevuolle
várregiehtje	várregiehtje
várrelahtto	várrelahtto
várreláhka	várreláhka
várrerájddo	várrerájddo
várresidno	várresidno
várresiergga	várresiergga
várrestivraválgga	várrestivraválgga
várrestivrra	várrestivrra
várresuojnne	várresuojnne
várretjåhkkå	várretjåhkkå
várreålmåj	várreålmåj
ábegáhtto	ábegáhtto
áddjábielle	áddjábielle
ádjábåsskå	ádjábåsskå
áhkkobielle	áhkkobielle
áhkábiddo	áhkábiddo
áhkárguolle	áhkárguolle
áhpebiegga	áhpebiegga
áhpebivddo	áhpebivddo
áhpeguolle	áhpeguolle
áhpeguollebájkke	áhpeguollebájkke
áhttjebielle	áhttjebielle
áhttjeråhkke	áhttjeråhkke
áhčči	áhttje
ájajuobmo	ájajuobmo
ájddeguorra	ájddeguorra
ájgegållo	ájgegållo
ájgeájádus	ájgeájádus
ájggegasskavuohta	ájggegasskavuohta
ájggegirjje	ájggegirjje
ájggegållo	ájggegållo
ájggehábme	ájggehábme
ájggelåhko	ájggelåhko
ájggemierre	ájggemierre
ájggemuddo	ájggemuddo
ájggerámma	ájggerámma
ájggetjála	ájggetjála
ájmmegoahte	ájmmegoahte
ájmmesjalmme	ájmmesjalmme
ájmmesuojnne	ájmmesuojnne
ájmmogierdde	ájmmogierdde
ájmmogåjkko	ájmmogåjkko
ájmmojåhtålus	ájmmojåhtålus
ájmmoladnja	ájmmoladnja
ájmmopoassta	ájmmopoassta
ájmmosloahtta	ájmmosloahtta
ájmmosuodjalus	ájmmosuodjalus
ájtteguovddo	ájtteguovddo
ájáhus	ájádus
áksebasste	áksebasste
áksjodoavnnje	áksjodoavnnje
áksjogilkka	áksjogilkka
áksjogårkkå	áksjogårkkå
áksjosjimer	áksjosjimer
áksjoskuohppo	áksjoskuohppo
áktor	áktur
ákšu	áksjo
álgga	álga
álggogurssa	álggogurssa
álggogálldo	álggogálldo
álggohábme	álggohábme
álggoidja	álggoidja
álggoielle	álggoielle
álggojahke	álggojahke
álggolassta	álggolassta
álggoliehke	álggoliehke
álggolåhko	álggolåhko
álggománno	álggománno
álggoráhkko	álggoráhkko
álggoslijvve	álggoslijvve
álggosálmma	álggosálmma
álggourbbe	álggourbbe
álggovahkko	álggovahkko
álggovuolga	álggovuolga
álggovuovdde	álggovuovdde
álggoájgge	álggoájgge
álldobiello	álldobiello
álldoieddne	álldoieddne
álldosijdda	álldosijdda
álltárgárdde	álltárgárdde
álltárlájbbe	álltárlájbbe
ámmátvuoddje	ámmátvuoddje
ámmátålmåj	ámmátålmåj
árahávdde	árahávdde
áralassta	áralassta
árametállaájgge	árametállaájgge
áratjaktja	áratjaktja
árbbediehto	árbbediehto
árbbedávdda	árbbedávdda
árbbeguodde	árbbeguodde
árbbejuohko	árbbejuohko
árbbeláhka	árbbeláhka
árbbeoabme	árbbeoabme
árbbesuddo	árbbesuddo
árbbevierro	árbbevierro
árbbevállde	árbbevállde
árkkabissma	árkkabissma
árkkarádjo	árkkarádjo
ármmomáles	ármmomáles
ármoájgge	ármoájgge
árradálvve	árradálvve
árragiesse	árragiesse
árraidet	árraidet
árrangiergge	árrangiergge
árrasábme	árrasábme
árratjaktja	árratjaktja
árvvodásse	árvvodásse
árvvodávver	árvvodávver
árvvofábmo	árvvofábmo
árvvonamma	árvvonamma
árvvovuohke	árvvovuohke
árvádus	árvvádus
ássjebielle	ássjebielle
ássjegirjje	ássjegirjje
ássjeguoddo	ássjeguoddo
ássjegållo	ássjegållo
ássjelissto	ássjelissto
ássjesuorgge	ássjesuorgge
ássjevuoddje	ássjevuoddje
ássjeålmåj	ássjeålmåj
ásskemuorra	ásskemuorra
ávkkeguodde	ávkkeguodde
ávkkegálvvo	ávkkegálvvo
ávkkesjaddo	ávkkesjaddo
ávvobievdde	ávvobievdde
ávvofárro	ávvofárro
ávvolávla	ávvolávla
ávvotjuorvas	ávvotjuorvas
ávvotjála	ávvotjála
åbbåbivtas	åbbåbivtas
åbbådálkke	åbbådálkke
åbbågårnne	åbbågårnne
ådåsgåvvå	ådåsgåvvå
åhketjuolmma	åhketjuolmma
åhtsåbieles	åhtsåbieles
åhtsåliehkko	åhtsåliehkko
ålggobarggo	ålggobarggo
ålggobivtas	ålggobivtas
ålggobájkke	ålggobájkke
ålggodoajmma	ålggodoajmma
ålggolávdde	ålggolávdde
ålggomusea	ålggomusea
ålggorijkalasj	ålggorijkalasj
ålggorijkka	ålggorijkka
ålggoviehkke	ålggoviehkke
ålggoviesso	ålggoviesso
ålggovisste	ålggovisste
ålgobielle	ålgobielle
ållesgåvvå	ållesgåvvå
ållesierre	ållesierre
ållesmielkke	ållesmielkke
ållessuodjalus	ållessuodjalus
ållestjiehka	ållestjiehka
ållesvierrosábme	ållesvierrosábme
ållesájgge	ållesájgge
ållesárvvo	ållesárvvo
årddesiergga	årddesiergga
årronásste	årronásste
åsskoguojmme	åsskoguojmme
åsskoviellja	åsskoviellja
åvddåbarggo	åvddåbarggo
åvddåbielle	åvddåbielle
åvddåbádne	åvddåbádne
åvddådiedádus	åvddådiedádus
åvddågiehtje	åvddågiehtje
åvddågurssa	åvddågurssa
åvddågáddo	åvddågáddo
åvddågådde	åvddågådde
åvddågåvvå	åvddågåvvå
åvddåjuolgge	åvddåjuolgge
åvddåkurssa	åvddåkurssa
åvddålåhkke	åvddålåhkke
åvddåmanne	åvddåmanne
åvddåsijddo	åvddåsijddo
åvddåtjuovgga	åvddåtjuovgga
åvddåvuovdda	åvddåvuovdda
åvdåsgådde	åvdåsgådde
åvdåstjuodtjo	åvdåstjuodtjo
åvdåsvásstádus	åvdåsvásstádus
åvdåsvásstádussuorgge	åvdåsvásstádussuorgge
åvdåsålmåj	åvdåsålmåj
æjgáthálldo	æjgáthálldo
čagar	tjagár
čahki	tjahke
čakča	tjaktja
čalbmi	tjalmme
čalmmas	tjalmas
čalán	tjalán
čanas	tjanás
časkkis	tjaskes
časttas	tjastas
čeabet	tjiebet
čeahppivuohta	tjiehppevuohta
čearru	tjierro
čeavli	tjievlle
čeavrris	tjievres
čeavránáhkki	tjævrránáhkke
čeavži	tjievttje
čibbi	tjibbe
čiegar	tjiegar
čiehka	tjiehka
čiehkagoahtemuorra	tjiehkagoahtemuorra
čiehká	tjiehká
čiehpas	tjiehpas
čiehppa	tjiehppa
čiekči	tjiektje
čielggadus	tjielgadus
čielgi	tjielgge
čieras	tjieras
čierri	tjierre
čievra	tjievrra
čilla	tjilla
čilvi	tjilvve
čipma	tjibma
čivga	tjivgga
čivgagoahti	tjivggagoahte
čivra	tjivrra
čivttasmuorra	tjivtasmuorra
čišká	tjissjká
čižži	tjidtje
čoaggi	tjoagge
čoahkki	tjoahkke
čoahkkár	tjoahkkár
čoahkáš	tjoahkásj
čoalbmi	tjoalmme
čoalli	tjoalle
čoarvi	tjoarvve
čoađgi	tjoargge
čohkka	tjåhkkå
čolga	tjålggå
čolgaráksá	tjålggåráksá
čora	tjårå
čorbma	tjårmmå
čorgatvuohta	tjårggåtvuohta
čorgi	tjårgge
čorru	tjårro
čoska	tjåsskå
čotta	tjåttå
čuhti	tjuhte
čulku	tjulkko
čuoggáš	tjuoggásj
čuohki	tjuohke
čuohpadus	tjuohpadus
čuohpahus	tjuohpadus
čuohpan	tjuohpan
čuohppi	tjuohppe
čuoigi	tjuojgge
čuoika	tjuojkka
čuokkar	tjuokkar
čuokkis	tjuokkes
čuokkisčála	tjuokkestjála
čuolbma	tjuolmma
čuolda	tjuollda
čuoldadiagrámma	tjuolldadiagrámma
čuolddabáddi	tjuoldabádde
čuolddavuotta	tjuoldavuotta
čuomas	tjuomas
čuopma	tjuobma
čuorpmas	tjuormas
čuorpmasčalbmi	tjuormastjalmme
čuorvvas	tjuorvas
čuovga	tjuovgga
čuovgasuonjar	tjuovggasuonjar
čuovgatvuohta	tjuovggatvuohta
čuovggas	tjuovgas
čuovvu	tjuovvo
čuovža	tjuovttja
čuska	tjusska
čussi	tjusse
čuvdi	tjuvdde
čuvku	tjuvkko
čáihni	tjájhnne
čála	tjála
čálli	tjálle
čátná	tjádná
šaddu	sjaddo
šalbmi	sjalmme
šallju	sjalljo
šallu	sjallo
šiehtadus	sjiehtadus
šiehtadusruhta	sjiehtadusruhta
šiehtadusrámma	sjiehtadusrámma
šiehtadusvuohki	sjiehtadusvuohke
šielbmá	sjielmmá
šilla	sjilla
šimir	sjimer
širáffa	sjiráffa
šišká	sjissjká
šlahtti	slahtte
šliipa	slijppa
šliiveassi	slijvveasse
šliivi	slijvve
šlimbbar	slimbar
šloahtta	sloahtta
šlubbu	slubbo
šládja	sládja
šlákta	slákta
šnjarvi	sjnjarvve
šnjierrá	sjnjierrá
šnjilža	sjnjilltja
šnjilži	sjnjilltje
šuddi	sjudde
šuhči	sjuhtje
šurra	sjurra
šámppu	sjámpo
šárra	sjárra
