                                   100%
0%>>>>>>>>>>>>>>>>>>>>>>>>>>>>>>>>
guhkkit	guhkket
accasit	attsaset
ađđamahttá	addamahttá
agibeaivvesge	agebeajvvesge
agibeaivvisge	agebeajvvisge
agibeaivái	agebeajváj
agibeaivvi	agebeajvve
agálaččat	agálattjat
ahkásii	ahkásij
aiddo	ajdo
aiddobeliid	ajdubelijd
aiddobáliid	ajdubálijd
aiddonassii	ajdunassij
aiddostassii	ajdustassij
aittoládje	ajtuládje
aittobáliid	ajtubálijd
aittonassii	ajtunassij
aivvefal	ajvefal
aivvestassii	ajvestassij
aivvo	ajvo
ok	åk
aktiivvalaččat	aktijvvalattjat
albmaáimmus	almmaájmus
albmaáimmus	almmaájmus
alddage	aldage
alibuččas	alebuttjas
alibuidda	alebujdda
alibus	alebus
alibužžii	alebudtjij
alimahtes	alemahtes
alitsidjii	aletsidjij
allagassii	allagassij
allagit	allaget
allelačča	allelattja
allelaččat	allelattjat
allelažžii	alleladtjij
allelebbui	allelebbuj
allelii	allelij
alleliidda	allelijdda
allelis	alleles
allil	allel
allin	allen
allugit	alluget
almmaide	almajde
almmatge	almatge
almmake	almake
almmotge	almutge
almmustaga	almustaga
almmá	almá
altteson	alteson
aŋaldagas	aŋáldagas
aŋaldatbajis	aŋáldatbajes
aŋkke	aŋke
arvat	arvvat
arvvoóit	arvoójt
asehisgerddiid	asehisgerddijd
askálagaid	asskálagajd
assájit	assájet
assálagaid	assálagajd
asu	aso
bárralagaid	bárralagajd
atti	atte
bađalassii	badálassij
badjebadjelii	badjebadjelij
badjebadjálagaid	badjebadjálagajd
badjelmeari	badjelmeare
badjelabbui	badjelabbuj
badjelačča	badjelattja
badjelaččas	badjelattjas
badjelažžii	badjeladtjij
badjelebbui	badjelebbuj
badjelii	badjelij
badjeliidda	badjelijdda
badjelis	badjeles
badjelit	badjelet
badjelmearálaččat	badjelmearálattjat
badjeloaivve	badjeloajvve
badjil	badjel
badjin	badjen
badjugassii	badjugassij
badjálagaid	badjálagajd
baholagaid	bahulagajd
bahuid	bahujd
bahuin	bahujn
baháláhkai	baháláhkaj
baica	bajttsa
baicca	bajtsa
baicce	bajtse
baifáhkka	bajffáhkka
baikana	bajkkana
baikanaga	bajkkanaga
bajil	bajel
bajiloaivvi	bajeloajvve
bajibučča	bajebuttja
bajibuččas	bajebuttjas
bajibuin	bajebujn
bajibus	bajebus
bajibužžii	bajebudtjij
bajábeallai	bajábeallaj
bajágeahčai	bajágeahtjaj
bajágeahčen	bajágeahtjen
bajágeaže	bajágeatje
bajásguvlui	bajásguvluj
bajásjulggiid	bajásjulggijd
baljo	baljjo
bastanta	basstanta
bastánta	basstánta
beaitta	biejta
beaiveguovdil	biejvveguovdel
beaivemáhce	biejvvemáhtse
beaivet	biejvvet
beaivváhala	bæjváhala
beaivválaččat	bæjválattjat
bealatkeahttá	bielatkeahttá
beald	bield
beallalaga	biellalaga
beallalagaid	biellalagajd
bealledagus	bielledagus
bealledahkui	bielledahkuj
beallegealdagis	biellegealdages
beallehaddái	biellehaddáj
bealleheakkas	bielleheakkas
bealleheggii	bielleheggij
beallejámas	biellejámas
beallenuvttá	biellenuvttá
beallešaddui	bielletjadduj
beallešattus	bielletjattus
beallestággui	biellestágguj
beallestákkus	biellestákkus
beallevearta	biellevearta
bealljeskaddariid	bielljeskaddarijd
beallálaga	bællálaga
beallálagaid	bællálagajd
bealát	bælát
beanta	bientta
beare	biere
bearehaga	bierehaga
bearrái	bærráj
beatnagahttá	biednagahttá
beavddibui	bievdebuj
beavddibuidda	bievdebujdda
beavddibus	bievdebus
beavddimusas	bievdemusas
beavddimussii	bievdemussij
beavdelaččas	bievddelattjas
beavdelažžii	bievddeladtjij
beavdeleappos	bievddeleappos
beavdelebbui	bievddelebbuj
beavdelii	bievddelij
beavdeliidda	bievddelijdda
beavdelis	bievddeles
beavžžabealde	bievtjabealde
beavžžabeale	bievtjabeale
beallemuttus	biellemuttus
bellolagaid	bellulagajd
belohahkii	beluhahkij
belos	belus
bessejassii	bessejassij
bevnnot	bevnut
biđgolagaid	birggulagajd
bieđđogárremiidda	bieddugárremijdda
bieđđogárremiin	bieddugárremijn
bieđgguid	biergujd
bieggaráigge	bieggarájgge
biehčamahttá	biehtjamahttá
biergonaga	bierggunaga
bikšut	biksjut
bilkkul	bilkul
binnoš	binnusj
binnánaš	binnánasj
binnážiidda	binnátjijdda
birolaččat	birulattjat
biroláhkai	biruláhkaj
birrabonjil	birrabonjel
birračáhcái	birratjáhtsáj
birračázis	birratjátses
birrageavlái	birrageavláj
birrajagi	birrajage
birrajagiid	birrajagijd
birrajorbalassii	birrajorbalassij
birrajorbodahkii	birrajorbodahkij
birralis	birrales
birrasii	birrasij
birrasit	birraset
birzzeoasat	birtseoasat
birzzit	birtset
biššos	bissjus
bivdinmađe	bivddenmade
bivššil	bivsjel
boaittobealde	boajtubealde
boaittobeale	boajtubeale
boaittobeallai	boajtubeallaj
boakkil	boakkel
boalččil	boaltjel
boarásmanbeaivái	boarásmanbeajváj
boarástunbeaivái	boarástunbeajváj
boaššolačča	boassjulattja
boaššolaččas	boassjulattjas
boaššolažžii	boassjuladtjij
boaššoleappos	boassjuleappos
boaššolebbui	boassjulebbuj
boaššolii	boassjulij
boaššoliidda	boassjulijdda
boaššolis	boassjules
boaššul	boassjul
boasttogežiid	boastugetjijd
boastut	boasstut
boatnjáš	boadnjásj
boađi-boađi	boadi-boade
bođđolagaid	båddulagajd
bođohagaid	båduhagajd
bođuid	bådujd
bodnelačča	båddnelattja
bodnelaččas	båddnelattjas
bodnelažžii	båddneladtjij
bodnelii	båddnelij
bodneliidda	båddnelijdda
bodnelis	båddneles
bodnil	båddnel
bogil	bågel
bolkolagaid	bålkkulagajd
bonjil	bånjel
borrančalbmái	bårråntjalmmáj
borranlanjas	bårrånlanjas
boššobealde	båssjubealde
boššobeale	båssjubeale
boššobeallai	båssjubeallaj
boššolii	båssjulij
boššoliidda	båssjulijdda
boššolis	båssjules
botnibui	bådnebuj
botnibuidda	bådnebujdda
botnibus	bådnebus
botnješ	bådnjesj
botnjut	bådnjut
buđđosii	buddusij
buđđosis	budduses
buhtismeahttusit	buhtesmeahttuset
buncut	bunttsut
buođđagasas	buoddagasas
buođđagassii	buoddagassij
buohkanassii	buohkanassij
buohtalagaid	buohtalagajd
buokčagasas	buoktjagasas
buokčagassii	buoktjagassij
buorbot	buorbbut
buorot	buorut
buoril	buorel
buorremealgadii	buorremealgadij
buošágit	buotjáget
buresláhkai	buresláhkaj
báđus	bádus
báhcigassii	báhtsegassij
báhcimassii	báhtsemassij
báhtui	báhtuj
báidegerddiid	bájddegerddijd
báidelanjas	bájddelanjas
báidelatnjii	bájddelatnjij
báifáhkka	bájffáhkka
báikkohagaid	bájkuhagajd
báikkuid	bájkujd
báikkálaččat	bájkálattjat
bálbálddalagaid	bálbbálddalagajd
báldal	bálldal
báldalagaid	bálldalagajd
báldda	bálda
bálddaid	báldajd
bálddalaga	báldalaga
bálddalagaid	báldalagajd
bálddalasjulggiid	báldalasjulggijd
bálddas	báldas
bálddoalgái	báldoalgáj
bálggesráigge	bálgesrájgge
báljo	báljjo
bálloguotti	bálluguotte
bárrahii	bárrahij
bárrahiin	bárrahijn
bárrahis	bárrahes
bártneš	bárnesj
bátnegáskki	bádnegáske
bážas	bátjás
čađa	tjada
čađat	tjadát
čahpunaga	tjahpunaga
čahpunassii	tjahpunassij
čakčačoavjjis	tjaktjatjoavjjes
čakčat	tjaktjat
čalbmegeaiddi	tjalmmegeajdde
čalbmegeaiddus	tjalmmegeajddus
čalbmehálgui	tjalmmehálguj
čalbmeráigge	tjalmmerájgge
čalmmineahkamis	tjalmeneahkames
čalmmálassii	tjalmálassij
čalmmát	tjalmát
časkkát	tjaskát
čavččabealde	tjavtjabealde
čavččabeallai	tjavtjabeallaj
čavga	tjavgga
čeagŋut	tjieggŋut
čeahpálagaid	tjæhpálagajd
čearggosdávttiid	tjiergusdávttijd
čearssil	tjiersel
čeavládit	tjævlládet
čeavlájit	tjævllájet
čezeš	tjetsesj
čieđus	tjiedus
čiegal	tjiegal
čiehkagasas	tjiehkagasas
čiekŋalabbui	tjiegŋalabbuj
čiekŋalasas	tjiegŋalasas
čielga	tjielgga
čielggosnaga	tjielgusnaga
čieročalbmái	tjierutjalmmáj
čihččii	tjihttjij
čikŋagasas	tjigŋagasas
čikŋagassii	tjigŋagassij
čikŋosis	tjigŋuses
čiktagasas	tjiktagasas
čiktagassii	tjiktagassij
čiktasii	tjiktasij
čiktasis	tjiktases
čillil	tjillel
čipperájes	tjipperájes
čirssil	tjirsel
čoahki	tjoahke
čoahkis	tjoahkes
čoahkkái	tjoahkkáj
čoalmmil	tjoalmel
čohkal	tjåhkål
čohkalassii	tjåhkålassij
čohkut	tjåhkut
čomal	tjåmål
čomastahkii	tjåmåstahkij
čomil	tjåmel
čorga	tjårggå
čorpmadievva	tjårmådievva
njálmmedievva	njálmedievva
čorrut	tjårrut
čoruid	tjårujd
čorul	tjårul
čuččot	tjuttjut
čuidnut	tjujnnut
čulle	tjulle
čuoččat	tjuottjat
čuohteveardde	tjuohteveardde
čuollut	tjuollut
čuožžut	tjuodtjut
čálalaččat	tjálálattjat
čálihussii	tjálehussij
čállatbokte	tjállatbokte
čállosupmái	tjállusupmáj
čárvvočalmmiid	tjárvutjalmijd
caggagasas	tsaggagasas
caggagassii	tsaggagassij
caggasii	tsaggasij
caggasis	tsaggases
caggut	tsaggut
cakkasnjálmme	tsakkasnjálme
cakkasnjálmmiid	tsakkasnjálmijd
ceaggut	tsieggut
ceahkkálagaid	tsæhkkálagajd
ceahkkásii	tsæhkkásij
ceahkkásis	tsæhkkáses
cikkil	tsikkel
cikkilmasat	tsikkelmasat
cikkit	tsikket
cirkkil	tsirkel
coahkásit	tsoahkáset
cuoccit	tsuottset
curbmut	tsurmmut
curpmil	tsurmel
dabbelaš	dabbelasj
dabbelii	dabbelij
dabbelis	dabbeles
dabbil	dabbel
dađe	dade
dađi	dade
dađibahábut	dadebahábut
dađis	dades
dađistaga	dadestaga
daiggo	dajgo
daigo	dajggo
dainna	dajna
dainnalágiin	dajnalágijn
dáinnalágiin	dájnalágijn
dainnánaga	dajnánaga
dakkaviđe	dakkavide
dakkaviđi	dakkavide
daninassii	danenassij
dappil	dappel
daška	dassjka
dasalassin	dasálassen
dassái	dassáj
dassážii	dassátjij
dassážiidda	dassátjijdda
dassážis	dassátjes
daste	dasste
dasto	dassto
dastožii	dasstutjij
dasttá	dastá
dasttán	dastán
dasttánaga	dastánaga
davibui	davebuj
davibuidda	davebujdda
davibuin	davebujn
davibus	davebus
davil	davel
davvelačča	davvelattja
davvelaččas	davvelattjas
davvelažžii	davveladtjij
davvelebbui	davvelebbuj
davveleppožii	davveleppotjij
davveleppožis	davveleppotjes
davvelii	davvelij
davveliidda	davvelijdda
davvelis	davveles
davvelit	davvelet
davvenuortin	davvenuorten
davveoarjin	davveoarjen
davvil	davvel
davvin	davven
davvinnuortan	davvennuortan
davvinoarjin	davvenoarjen
davábeallai	davábeallaj
davágeahčai	davágeahtjaj
davágeahčen	davágeahtjen
davágeaže	davágeatje
deahtta	diehtta
deaivása	dæjvvása
dearpamassii	dierppamassij
dearvan	diervvan
deatnoráigge	diednurájgge
deavddihussii	dievdehussij
degomat	degumat
dehal	dehál
deike	dejkke
deikke	dejke
desto	dessto
diebbelaš	diebbelasj
diebbelii	diebbelij
diebbeliidda	diebbelijdda
diebbelis	diebbeles
diebbil	diebbel
dieđinge	diedenge
dieđun	diedun
dieđus	diedus
dieđusge	diedusge
diedoppe	dieduppe
die-doppe	die-dåppe
doppe	dåppe
diehpil	diehpel
diehtevassii	diehtevassij
diehttavassii	diehttavassij
diehttevassii	diehttevassij
dieiggo	diejgo
dieinnalágiin	diejnalágijn
dieinnán	diejnán
dieinnánaga	diejnánaga
dieppit	dieppet
dieppil	dieppel
dieppimustá	dieppemustá
diesttánaga	diestánaga
diibmoviissaid	dijmmuvijssajd
diibmá	dijmmá
diimmuhala	dijmuhala
dimaiddámaid	dimájddámajd
dimiiddámiid	dimijddámijd
divdna	divnna
divohussii	divuhussij
divuhussii	divuhussij
divvosupmái	divvusupmáj
divvumassii	divvumassij
do-doppe	do-dåppe
doaisttážii	doajstátjij
doamadoama	dåmadoama
doamaiddoamaid	dåmajddoamajd
doaresbeallai	doaresbeallaj
doaresčáhcái	doarestjáhtsáj
doaresguvlui	doaresguvluj
doarggatgaccaid	doargatgattsajd
doarvái	doarvváj
dobbelaš	dåbbelasj
dobbeleappos	dåbbeleappos
dobbelebbui	dåbbelebbuj
dobbelii	dåbbelij
dobbeliidda	dåbbelijdda
dobbelin	dåbbelen
dobbelis	dåbbeles
dobbil	dåbbel
dođe	dåde
dodohko	dåduhko
dohkiiddohkiid	dåhkijddohkijd
dohkkemeahttumit	dåhkkemeahttumet
dohko	dåhko
dohko	dåhko
dohkálaččat	dåhkålattjat
doiggo	dåjgo
doigo	dåjggo
doiste	dåjsste
doisttážii	dåjståtjij
dokko	dåkko
dolggal	dålgål
dolin	dålen
dolkamassii	dålkkåmassij
dolágo	dålågo
dolátdovle	dålåtdovle
doŋgget	dåŋget
doppe	dåppe
doppit	dåppet
doppil	dåppel
doppimustá	dåppemustá
dovddolaččat	dåvdulattjat
dovdduheamet	dåvduheamet
dovdomassii	dåvddumassij
dovdovaččat	dåvdduvattjat
dovko	dåvkko
dovle	dåvlle
duhkodagas	duhkudagas
duhkodahkii	duhkudahkij
duhtamassii	duhtamassij
duhtameahttumit	duhtameahttumet
dulppil	dulpel
dumis	dumes
duŋgadassii	duŋggadassij
duobbelii	duobbelij
duobbeliidda	duobbelijdda
duobbelis	duobbeles
duobbil	duobbel
duođabearis	duodabeares
duođai	duodaj
duođaid	duodajd
duođalaččat	duodalattjat
duođas	duodas
duođasin	duodasen
duođi	duode
duogi	duoge
duogis	duoges
duogábeallai	duogábeallaj
duohččagasas	duohttjagasas
duohččagassii	duohttjagassij
duohččasii	duohttjasij
duohččasis	duohttjases
duohkin	duohken
duohkot	duohkut
duohkotdeike	duohkutdejke
duohtaváimmus	duohtavájmus
duoidduohko	duojdoohko
duoiggo	duojgo
duoigo	duojggo
duoihuodjin	duojhoodjen
duoinnánaga	duojnánaga
duojetduodjin	duojetduodjen
duojásii	duojásij
duojážassii	duojátjassij
duojážii	duojátjij
duokkotdákko	duokkutdákko
duokkot	duokkut
duolbut	duolbbut
duolluiddálluid	duollujddállujd
duoppit	duoppet
duoppil	duoppel
duoppildáppil	duoppeldáppel
duoppimustá	duoppemustá
duosttán	duostán
duosttánaga	duostánaga
duosttáš	duostásj
duovkko	duovko
duppallohkkii	duppallohkkij
dušše	dussje
duššefal	dussjefal
duššiid	dussjijd
duššái	dussjáj
duššás	dussjás
duvle	duvlle
dábbelaš	dábbelasj
dábbelebbui	dábbelebbuj
dábbelii	dábbelij
dábbeliidda	dábbelijdda
dábbelis	dábbeles
dábbil	dábbel
dáđi	dáde
dádalle	dádálle
dádeike	dádejke
dáđimielde	dádemielde
dáiggo	dájgo
dáigá	dájggá
dáinnánaga	dájnánaga
dájis	dájes
dákkaviđe	dákkavide
dákkaviđi	dákkavide
dálveleappos	dálvveleappos
dálvelebbui	dálvvelebbuj
dálvelii	dálvvelij
dálveliidda	dálvvelijdda
dálvelis	dálvveles
dálvet	dálvvet
dálvit	dálvvet
dálvvás	dálvás
dánu	dáno
dáppit	dáppet
dáppibui	dáppebuj
dáppibuidda	dáppebujdda
dáppibuin	dáppebujn
dáppibus	dáppebus
dáppil	dáppel
dáppimustá	dáppemustá
dárbahassii	dárbbahassij
dárbbašmeahttumit	dárbasjmeahttumet
dárbbuhemet	dárbuhemet
dássálagaid	dássálagajd
dássážii	dássátjij
dásttánaga	dástánaga
dávjjetdávjá	dávjetdávjá
dávjálagaid	dávjjálagajd
eahkedassii	iehkedassij
eahkes	iehkes
eahketbeallai	iehketbeallaj
eahpegovttolaš	iehpegovttolasj
eahpenjuolga	iehpenjuolga
eahpenjuolgga	iehpenjuolgga
eaktodáhtos	iektudáhtos
eaktodáhtolaččat	iektudáhtolattjat
eallinaga	iellenaga
eambbo	iembo
eambo	iembbo
eambu	iembbo
eamidaš	iemedasj
eamis	iemes
eandalii	ienddalij
eandalit	ienddalet
eanebu	ienebu
eanebuš	ienebusj
eanetbealát	ienetbealát
eanáš	ænásj
earaládje	ieraládje
earalágan	ieralágan
earaláhkai	ieraláhkaj
earaláhkai	ieraláhkaj
earasadjái	ierasadjáj
earasajes	ierasajes
earemuđui	ieremuduj
eareliiggánit	ierelijggánet
earenoamážit	ierenoamátjet
earenomážit	ierenomátjet
earotbealde	ierutbealde
earotbeallai	ierutbeallaj
earretláhkái	ierretláhkáj
earrotbealde	ierrutbealde
earrotbeallai	ierrutbeallaj
earránassii	ærránassij
earáládje	æráládje
earáládje	æráládje
earálágan	ærálágan
earáláhkai	æráláhkaj
earáláhkái	æráláhkáj
earáláhkái	æráláhkáj
easka	iesska
easkabáliid	iesskabálijd
easká	æsská
easkka	ieska
eatnat	iednat
eatnoráiggi	iednurájgge
eavttoheamet	ievtuheamet
ednoš	eddnusj
egeš	egesj
ein	ejn
eisege	ejssege
eivakto	ejvvakto
eivaktu	ejvvaktu
eivve	ejve
eksplisihtalaččat	eksplesihtalattjat
erenoamáš	erenoamásj
erenoamážit	erenoamátjet
erenoamažit	erenoamatjet
erenomážit	erenomátjet
ergo	erggo
eskke	eske
etneš	ednesj
fakŋut	fagŋut
faŋkut	faŋkkut
farggabáliid	fargabálijd
farggamusat	fargamusat
farvealla	farvvealla
fastain	fasstajn
fast-ain	fast-ajn
fastin	fassten
fastin	fassten
fasttain	fastajn
fastten	fasten
fatnagasas	fadnagasas
fatnagassii	fadnagassij
feara	fiera
ferot	ferut
fielttil	fieltel
fiidnáseappot	fijnnáseappot
fiidnážit	fijnnátjet
finjil	finjel
fiskessidjii	fisskessidjij
fitnjalassii	fidnjalassij
fitnjut	fidnjut
fulkkeš	fulkesj
fuođđit	fuoddet
fuolalaččat	fuolalattjat
fuollameahttumit	fuollameahttumet
fággálagaid	fággálagajd
fálta	fállta
fámolaččat	fámulattjat
fárdearva	fárddearva
fárfful	fárful
fárrolaga	fárrulaga
fárrolagaid	fárrulagajd
fárrui	fárruj
fártasabbot	fárttasabbot
fáru	fáro
fásta	fássta
fátmálagaid	fátmálagajd
fávda	fávdda
fávlelačča	fávllelattja
fávlelaččas	fávllelattjas
fávlelažžii	fávlleladtjij
fávleleappos	fávlleleappos
fávlelebbui	fávllelebbuj
fávleleppožii	fávlleleppotjij
fávleleppožis	fávlleleppotjes
fávlelii	fávllelij
fávleliidda	fávllelijdda
fávlelis	fávlleles
fávlil	fávllel
fávllabealde	fávlabealde
fávllabeale	fávlabeale
fávllabeali	fávlabeale
fávllabeallai	fávlabeallaj
fávllibučča	fávlebuttja
fávllibuččas	fávlebuttjas
fávllibui	fávlebuj
fávllibuidda	fávlebujdda
fávllibus	fávlebus
fávllibužžii	fávlebudtjij
fávllimus	fávlemus
gahčagahča	gahtjagahtja
gahperoaivves	gahperoajvves
gahperoaivái	gahperoajváj
gaikomassii	gajkkumassij
gait	gajt
galju	galjjo
gallii	gallij
gallit	gallet
galládassii	galládassij
galmmasnaga	galmasnaga
gaŋgut	gaŋggut
gaŋkkooivviid	gaŋkoojvvijd
gaŋkut	gaŋkkut
ganjalčalmmiid	ganjáltjalmijd
garggunjálmmiid	gargunjálmijd
gaskabazaldagas	gasskabatsaldagas
gaskabazaldahkii	gasskabatsaldahkij
gaskaboddii	gasskaboddij
gaskačázis	gasskatjátses
gaskal	gasskal
gaskalis	gasskales
gaskamearálaččat	gasskamearálattjat
gaskan	gasskan
guovttágaskan	guovtágaskan
gaskaneametteskka	gasskaneametteska
gaskarádjai	gasskarádjaj
gaskasulaide	gasskasulajde
gaskasulain	gasskasulajn
gaskat	gasskat
gaskii	gasskij
gaskka	gaska
gaskkahaga	gaskahaga
gaskkaid	gaskajd
gaskkohagaid	gaskuhagajd
gasku	gassko
gassagassii	gassagassij
gavžut	gavttjut
gavžžil	gavtjel
gazzagasas	gadtsagasas
gazzagassii	gadtsagassij
gazzalagaid	gadtsalagajd
geahčen	giehtjen
geahčálagaid	gæhtjálagajd
geahppadit	giehppadet
geahppagerddiid	giehppagerddijd
geaidagasas	giejddagasas
geaidagassii	giejddagassij
geaidnoráigge	giejnnurájgge
geaigut	giejggut
geallagasas	giellagasas
geallagassii	giellagassij
geardde	gierde
gearddi	gierde
geardumassii	gierddumassij
geassasii	giessasij
geassasis	giessases
geasibui	giesebuj
geasibus	giesebus
geassečoavjjis	giessetjoavjjes
geasseguovdil	giesseguovdel
geasseleappos	giesseleappos
geasselebbui	giesselebbuj
geasselii	giesselij
geasseliidda	giesselijdda
geasselis	giesseles
geasset	giesset
geassit	giesset
geasás	gæsás
geavahanládje	gievahanládje
geavahanláhkai	gievahanláhkaj
geavllil	gievlel
geavrril	gievrel
geavrut	gievrrut
geavzut	gievttsut
geavzzil	gievtsel
geažálassii	gætjálassij
geažát	gætját
geidosii	gejddusij
geidosis	gejdduses
geit	gejt
giđasdálvve	gidásdálvve
giđasgease	gidásgease
giđđalii	giddalij
giđđalis	giddales
giđđat	giddat
giddalagaid	giddalagajd
gieđaguluin	giedagulujn
giehtasesiin	giehtasesijn
giehtalagaid	giehtalagajd
giellagassii	giellagassij
giellasii	giellasij
giellasis	giellases
gieskabále	giesskabále
gieskat	giesskat
gieskkaid	gieskajd
gietkagassii	gietkagassij
gievrru	gievro
gilgalagaid	gilggalagajd
gilggal	gilgal
gilggalis	gilgales
gilgut	gilggut
gilvolagaid	gilvvulagajd
gilvvu	gilvo
girjjálaččat	girjálattjat
gittalagaid	gittalagajd
gittauvssaid	gittauvssajd
givrril	givrel
givrut	givrrut
globálalaččat	glåbålalattjat
goabal	gåbal
goabbasiige	goabbasijge
goabbelii	goabbelij
goabbeliige	goabbelijge
goabbelis	goabbeles
goabbil	goabbel
goabbilge	goabbelge
goaiddá	goajdá
goalmmádassii	goalmádassij
goalmmádis	goalmádes
goamal	gåmal
goaŋkkil	goaŋkel
goaŋkut	goaŋkkut
goappil	goappel
goappilge	goappelge
goappos	goappus
goarjagasas	goarjjagasas
goarjagassii	goarjjagassij
goarjagii	goarjjagij
goarjagis	goarjjages
goarkagii	goarkkagij
goarkagis	goarkkages
goarrumassii	goarrumassij
goaruhussii	goaruhussij
goarvvil	goarvel
goasii	goasij
goasin	goasen
goassai	goassaj
goassige	goassege
goavddil	goavdel
goavkkil	goavkel
goavkut	goavkkut
goavrril	goavrel
goavrut	goavrrut
gobil	gåbel
goggo	gåggo
goigo	gåjggo
goikejulggiid	gåjkkejulggijd
goikevevssiid	gåjkkevevssijd
goit-al	gåjt-al
goitge	gåjtge
gok	gåk
gokčagasas	gåktjågasas
gokčagassii	gåktjågassij
gokko	gåkko
gokkonai	gåkkunaj
gokte	gåkte
goktege	gåktege
goktes	gåktes
golbmasiidgolbmasiid	gålmmåsijdgolmmasijd
golbmii	gålmmij
golgosii	gålggusij
golgosis	gålgguses
gollolagaid	gållulagajd
golmmaidgolmmaid	gålmåjdgolmajd
gomalassii	gåmålassij
gomogazzii	gåmugadtsij
gomolassii	gåmulassij
gomot	gåmut
gomuoivviid	gåmoojvvijd
gonne	gånne
gonnes	gånnes
gopmolassii	gåbmulassij
gopmut	gåbmut
goppos	gåppus
gorrelaččat	gårrelattjat
gorrosupmái	gårrusupmáj
gorrái	gårråj
gos	gås
gosa	gåså
gosii	gåsij
goskkeš	gåskesj
gossai	gåssåj
gostege	gåsstege
gostige	gåsstege
goste	gåsste
got	gåt
govdadit	gåvddådet
govdilasas	gåvddelasas
govdilassii	gåvddelassij
govdosii	gåvddusij
govdosis	gåvdduses
govt	gåvt
gubbarassii	gubbarassij
guđadassii	gudádassij
guđadis	gudádes
guđoldagas	guduldagas
guđoldahkii	guduldahkij
guhkesáiggis	guhkesájgges
guhkessidjii	guhkessidjij
guhkibuččas	guhkebuttjas
guhkibui	guhkebuj
guhkibuidda	guhkebujdda
guhkebuš	guhkebusj
guhkibus	guhkebus
guhkibužžii	guhkebudtjij
guhkiide	guhkijde
guhkiin	guhkijn
guhkkelaččas	guhkkelattjas
guhkkelažžii	guhkkeladtjij
guhkkelebbui	guhkkelebbuj
guhkkeleppožii	guhkkeleppotjij
guhkkeleppožis	guhkkeleppotjes
guhkkelii	guhkkelij
guhkkeliidda	guhkkelijdda
guhkkelis	guhkkeles
guhkkin	guhkken
guhkkin	guhkken
guhkkálagaid	guhkkálagajd
guhkkásii	guhkkásij
guhkáláhkai	guhkáláhkaj
guhttii	guhttij
guita	gujtta
guittot	gujtut
guittotge	gujtutge
guktii	guktij
gullolagaid	gullulagajd
gulámuddui	gulámudduj
gunttus	guntus
guođát	guodát
guoggarassii	guoggarassij
guoibmálagaid	guojmmálagajd
guokkil	guokkel
guoktil	guoktel
guoktásiidguoktásiid	guoktásijdguoktásijd
guorosnaga	guorusnaga
guossot	guossut
guovdat	guovddat
guovdeleappos	guovddeleappos
guovdelebbui	guovddelebbuj
guovdeleppožii	guovddeleppotjij
guovdeleppožis	guovddeleppotjes
guovdelii	guovddelij
guovdelis	guovddeles
guovdil	guovddel
guovdoleappos	guovdduleappos
guovdolebbui	guovddulebbuj
guovdoleppožii	guovdduleppotjij
guovdoleppožis	guovdduleppotjes
guovdolii	guovddulij
guovdolis	guovddules
guovssogeažis	guovsugeatjes
guovttebealčomil	guovtebealtjomel
guovttebealgobil	guovtebealgobel
guovttegávdnái	guovtegávnnáj
guovtteguosmái	guovteguosmáj
guovttejuolgaskii	guovtejuolgaskij
guovtteládje	guovteládje
guovttil	guovtel
guovttá	guovtá
gurrii	gurrij
gusto	gussto
guvdnjut	guvnnjut
guvdnut	guvnnut
guvnnjil	guvnjel
guvrril	guvrel
guvrut	guvrrut
guvttiidguvttiid	guvtijdguvttijd
gáddelačča	gáddelattja
gáddelaččas	gáddelattjas
gáddelaš	gáddelasj
gáddelažžii	gáddeladtjij
gáddelebbui	gáddelebbuj
gáddeleppožii	gáddeleppotjij
gáddeleppožis	gáddeleppotjes
gáddelii	gáddelij
gáddeliidda	gáddelijdda
gáddelis	gáddeles
gáddil	gáddel
gáddolagaid	gáddulagajd
gáidagasas	gájddagasas
gáidagassii	gájddagassij
gákcii	gáktsij
gáktegerddiid	gáktegerddijd
gálgoš	gálggusj
gámajuolggis	gámájuolgges
gánske	gánsske
gánssal	gánsal
gápmagahttá	gábmagahttá
gárgŋut	gárŋŋut
gárkŋil	gárŋel
gárragassii	gárragassij
gárragii	gárragij
gárragis	gárrages
gárrasii	gárrasij
gárrasis	gárrases
gárremaččaide	gárremattjajde
gárremaččain	gárremattjajn
gárremiidda	gárremijdda
gárremiin	gárremijn
gárrenoaivvis	gárrenoajvves
gárssil	gársel
gárvásii	gárvvásij
gáržásii	gárttjásij
gáržásis	gárttjáses
gáttabeali	gáttabeale
gáttabeallai	gáttabeallaj
gáttageahčai	gáttageahtjaj
gáttageahčen	gáttageahtjen
gával	gávál
gávddil	gávdel
gávotgaccaid	gávutgattsajd
gávrril	gávrel
gávrut	gávrrut
gávzzil	gávtsel
hain	hajn
heahkka	hiehkka
heahkkadaga	hiehkkadaga
heahkkat	hiehkkat
heahpatmeahttumit	hiehpatmeahttumet
heaittekeahttái	hiejtekeahttáj
healla	hiella
heaŋgagasas	hieŋggagasas
heaŋgagassii	hieŋggagassij
heaŋgasii	hieŋggasij
heaŋgasis	hieŋggases
hedi	hede
hedii	hedij
heggosii	heggusij
hiđuidháđuid	hidujdhádujd
hiljit	hiljjet
hiljážii	hiljjátjij
hiljážit	hiljjátjet
hiluidháluid	hilujdhálujd
hiluid	hilujd
harbmat	harmmat
harbmadit	harmmadet
hirbmat	hirmmat
hirbmadit	hirmmadet
hirbmosit	hirmmuset
hirpmasit	hirmaset
hirril	hirrel
hoahpohoahpus	hoahpuhoahpus
hohkkái	håhkkåj
huhttagassii	huhttagassij
hui	huj
huiven-hiváste	hujvven-hiváste
hyrbmat	hyrmmat
háhccut	háhttsut
háhttásii	háhttásij
háhttásis	háhttáses
hájilassii	hájelassij
hálga	hálgga
hálooivviid	háloojvvijd
hálssil	hálsel
háltái	hálltáj
hálva	hálvva
háŋkalagaid	háŋkkalagajd
hárččil	hártjel
hárčut	hárttjut
hárjjil	hárjel
hárril	hárrel
hárvelávkkiid	hárvvelávkkijd
hávil	hável
hávskit	hávssket
háválassii	háválassij
hávális	háváles
iđđedis	iddedes
iđđes	iddes
iđedassii	idedassij
iđedis	idedes
iđis	ides
iđitbealli	idetbealle
idjaguovdil	idjaguovdel
iehčanassii	iehtjanassij
iešalddes	ietjalddes
iešalddis	ietjalddes
iešalddiset	ietjalddiset
iešalddán	ietjalddán
iešalddát	ietjalddát
iešdáhtos	iesjdáhtos
iešdáhtus	iesjdáhtus
iešgieđal	iesjgiedal
iešguđetládje	iesjgudetládje
iešguđetláhkai	iesjgudetláhkaj
iešheanalis	iesjheanales
iešheanálaččat	iesjheanálattjat
iešoaivvestanatis	ietjoajvvestanates
iešokto	ietjukto
iežáládje	ietjáládje
iežasláhkái	ietjasláhkáj
iežasláhkai	ietjasláhkaj
ihcalassii	ihtsalassij
ihcalis	ihtsales
ihkin	ihken
ihkku	ihkko
ihtin	ihten
ihttenaš	ihttenasj
ihttin	ihtten
ihánit	ihánet
ijatbeaivái	ijátbeajváj
ijatbeaivvi	ijátbeajvve
ijatbeivviid	ijátbejvvijd
ijatihkku	ijátihkku
ilbmán	ilmmán
ildi	illde
ildása	illdása
illumielain	illumielajn
illágoastta	illágoasta
illávejiid	illávejijd
ilmmiidalmmiid	ilmijdalmijd
imašlaččat	imasjlattjat
imeš	imesj
implisihtalaččat	implesihtalattjat
inta	intta
ipmilmeahttumit	ibmelmeahttumet
irggeš	irgesj
irta	irtta
isidaš	isedasj
iskor	isskur
issorasat	issurasat
jagáš	jagásj
jahkeviissaid	jahkevijssajd
jahkásaččat	jahkásattjat
jaril	jarel
jarkŋil	jarŋel
jaska	jasska
jeahkalahttá	jiehkalahttá
jeavda	jievdda
jeavddalaččat	jievdalattjat
jelgii	jelggij
jergo	jerggo
jierrásit	jierráset
jirpmet	jirmet
jitnosii	jidnusij
jitnosit	jidnuset
jitnoseabbot	jidnuseabbot
joaimmil	joajmel
joavkolaga	joavkkulaga
jođáneappot	jådåneappot
jođánepmosit	jådånepmoset
jođánit	jådånet
jogo	jågo
johtileappot	jåhteleappot
johtilit	jåhtelet
joksege	jåksege
jolga	jålggå
joppa	jåppå
jorbadassii	jårbbådassij
jorbasidjii	jårbbåsidjij
jorbasii	jårbbåsij
jorggotbeliid	jårgutbelijd
jorggotgežiid	jårgutgetjijd
jorgut	jårggut
juhkamassii	juhkamassij
juhkanoaivves	juhkanoajvves
julggal	julgal
juolgesesiin	juolggesesijn
juolgásiid	juolggásijd
justa	jussta
juste	jusste
jábmejassii	jábbmejassij
jáffonaga	jáffunaga
jáfonaga	jáfunaga
jálutbeliid	jálutbelijd
jámas	jámás
jándorviissaid	jánddurvijssajd
jávkkohagas	jávkuhagas
jávkkohahkii	jávkuhahkij
jávkosii	jávkkusij
jávkosis	jávkkuses
jávohaga	jávuhaga
jávvásii	jávvásij
jávvásis	jávváses
kievrru	kievro
kánske	kánsske
lagabuččas	lagábuttjas
lagabui	lagábuj
lagabuidda	lagábujdda
lagabus	lagábus
lagabužžii	lagábudtjij
lahkalagaid	lahkalagajd
lahkaorodettiin	lahkaorodettijn
lahkiidlahkiid	lahkijdlahkijd
lahkkálagaid	lahkkálagajd
lahkosin	lahkusen
lahkosis	lahkuses
largo	larggo
lasi	lase
lasmosii	lassmusij
lasmosis	lassmuses
latnjalagaid	ladnjalagajd
latnjalassii	ladnjalassij
latnjasii	ladnjasij
latnjasis	ladnjases
leabba	liebba
leabbagasas	liebbagasas
leabbagassii	liebbagassij
leabbut	liebbut
leagil	liegel
leaikavuođas	liejkkavuodas
leaikkal	liejkal
leaikkas	liejkas
leaimmil	liejmel
leakkil	liekkel
leamssil	liemsel
leanzut	lienttsut
leanzzil	lientsel
leavttuid	lievtujd
liđbma	lirmma
lihbadjái	lihbadjáj
lihbajis	lihbajes
lihpadjái	lihpadjáj
lihpajis	lihpajes
lihpebadjái	lihpebadjáj
lihpebajis	lihpebajes
liiggás	lijgás
liikka	lijka
liikká	lijká
liktásit	liktáset
loahpadassii	loahpadassij
loahpageahčai	loahpageahtjaj
loahpageahčen	loahpageahtjen
loaidulii	loajddulij
loaidulis	loajddules
loaittuid	loajtujd
loaittul	loajtul
loamil	loamel
loanas	lånas
loažža	loadtja
loažžut	loadtjut
lobiheamit	låbeheamet
lobihemet	låbehemet
logahussii	lågåhussij
logemađe	lågemade
logenear	lågenear
logeneare	lågeneare
logenár	lågenár
loginár	lågenár
logenáre	lågenáre
logádassii	lågådassij
logádis	lågådes
lohkamassii	låhkåmassij
lohkkojupmái	låhkkujupmáj
lohkkosupmái	låhkkusupmáj
lohkásiidlohkásiid	låhkåsijdlohkásijd
loidolii	låjddulij
loidolis	låjddules
loikasit	låjkkåset
loktasii	låktåsij
loktasis	låktåses
loktosii	låktusij
loktosis	låktuses
lotnolaga	lådnulaga
lotnolagaid	lådnulagajd
lossadit	låssådet
lotka	låtkå
lotnolassii	lådnulassij
luhčanaga	luhtjanaga
luhtteorodettiin	luhtteorodettijn
lulde	lullde
lulibui	lulebuj
lulibuidda	lulebujdda
lulibus	lulebus
lulil	lulel
lullelačča	lullelattja
lullelaččas	lullelattjas
lullelaš	lullelasj
lullelažžii	lulleladtjij
lullelebbui	lullelebbuj
lulleleppožii	lulleleppotjij
lulleleppožis	lulleleppotjes
lullelii	lullelij
lulleliidda	lullelijdda
lullelis	lulleles
lullil	lullel
lullin	lullen
lulábeallai	lulábeallaj
lulágeahčai	lulágeahtjaj
lulágeahčen	lulágeahtjen
lulágeaže	lulágeatje
lunddolaččat	lundulattjat
luođđagasas	luoddagasas
luođđagassii	luoddagassij
luođđagii	luoddagij
luođđagis	luoddages
luoddaráigge	luoddarájgge
luohkkálii	luohkkálij
luohkkális	luohkkáles
luohttalagaid	luohttalagajd
luoikkas	luojkas
luoittát	luojtát
luovddaid	luovdajd
luovddalagaid	luovdalagajd
luovos	luovus
luovosvuoji	luovusvuoje
lupmosit	lubmuset
luvvolagaid	luvvulagajd
láddagassii	láddagassij
láddasii	láddasij
láddasis	láddases
láhčamaš	láhtjamasj
láhji	láhje
láhkai	láhkaj
láhkái	láhkáj
láhkežeamen	láhketjeamen
láhppagassii	láhppagassij
láhppasii	láhppasij
láhppasis	láhppases
láhpposii	láhppusij
láhpposis	láhppuses
láigomassii	lájggumassij
láigumassii	lájggumassij
láimmil	lájmel
láitemeahttumit	lájttemeahttumet
láitinláhkai	lájttenláhkaj
lákčut	láktjut
lámas	lámás
lápmálassii	lábmálassij
lášmadit	lássjmadet
láseráigge	láserájgge
láskut	lásskut
lássaráigge	lássarájgge
látnalassii	ládnalassij
lávččil	lávtjel
lávda	lávdda
lávga	lávgga
lávgalagaid	lávggalagajd
lávžálagaid	lávttjálagajd
mađđása	maddása
mađe	made
mađi	made
mahkáš	mahkásj
mahtiin	mahtijn
mahtis	mahtes
mahttái	mahttáj
mai	maj
maid	majd
maiddá	majdá
maiddái	majdáj
maiddái	majdáj
maiddái	majdáj
maidddái	majdddáj
mallosge	mallusge
maŋemuš	maŋemusj
maŋemussii	maŋemussij
maŋimus	maŋemus
maŋimusas	maŋemusas
maŋimussii	maŋemussij
maŋimustá	maŋemustá
maŋimuštá	maŋemusjtá
maŋistaga	maŋestaga
maŋŋegeahčen	maŋŋegeahtjen
maŋŋelgihtii	maŋŋelgihtij
maŋŋelaš	maŋŋelasj
maŋŋelaš	maŋŋelasj
maŋŋelebbui	maŋŋelebbuj
maŋŋeleppožii	maŋŋeleppotjij
maŋŋeleppožis	maŋŋeleppotjes
maŋŋelii	maŋŋelij
maŋŋeliidda	maŋŋelijdda
maŋŋelis	maŋŋeles
maŋŋelis	maŋŋeles
maŋŋemaŋŋálagaid	maŋŋemaŋŋálagajd
maŋŋidii	maŋŋedij
maŋŋil	maŋŋel
maŋŋin	maŋŋen
maŋŋit	maŋŋet
maŋŋiteahket	maŋŋeteahket
maŋŋitgiđa	maŋŋetgida
maŋŋálagaid	maŋŋálagajd
maŋŋásanatis	maŋŋásanates
maŋos	maŋus
maŋosguvlui	maŋusguvluj
maŋosii	maŋusij
maŋábeallai	maŋábeallaj
maŋágeahčai	maŋágeahtjaj
maŋágeahčen	maŋágeahtjen
maŋágeaže	maŋágeatje
maŋágeažes	maŋágeatjes
maŋálgihtii	maŋálgihtij
maŋásguvlui	maŋásguvluj
maŋážassii	maŋátjassij
maŋážussii	maŋátjussij
manin	manen
maninge	manenge
manješ	manjesj
mannolagas	mannulagas
mannolahkii	mannulahkij
markkát	markát
meaddelaš	mieddelasj
meahcabealde	miehtsabealde
meahcabeale	miehtsabeale
meahcabeallai	miehtsabeallaj
meahcceráigge	miehttserájgge
meahccáiaga	mæhttsájaga
mealgadat	mielggadat
mealgadaččas	mielggadattjas
mealgadaš	mielggadasj
mealgadažžii	mielggadadtjij
mealgadii	mielggadij
mealgadis	mielggades
mealgadit	mielggadet
mealgat	mielggat
mearabui	mierabuj
mearabuidda	mierabujdda
mearabus	mierabus
mearkkašahtti	mierkatjahtte
measta	miessta
meastui	miesstuj
meattá	mættá
mehcobealde	mehtsubealde
mehcobeale	mehtsubeale
mehcobeallai	mehtsubeallaj
menddo	mendo
mieđaid	miedajd
mieđil	miedel
mieđabealde	miedabealde
mieđábealde	miedábealde
mieđábeale	miedábeale
mieđábeallai	miedábeallaj
mieđás	miedás
miehtebeaivái	miehtebeajváj
miehtečáhcái	miehtetjáhtsáj
miehtegulgii	miehtegulgij
miehtejohtimii	miehtejohtimij
miehtelii	miehtelij
miehtelis	miehteles
miehtemurrii	miehtemurrij
miehterávdnjái	miehterávnnjáj
miehtil	miehtel
miehtásit	miehtáset
mieigut	miejggut
mielalaččat	mielalattjat
mielalis	mielales
mielastepmosit	mielastepmoset
mielddánátis	mieldánátes
mielddistis	mieldestes
mielde	miellde
mieldi	miellde
mieldeorodettiin	mielldeorodettijn
mieldálagaid	mielldálagajd
mieldámet	mielldámet
miellasepmosit	miellasepmoset
mieláhkui	mieláhkuj
mihus	midus
miilaviissaid	mijlavijssajd
milloseappot	milluseappot
milloseabbot	milluseabbot
millosepmosit	millusepmoset
minddar	mindar
minddár	mindár
mista	missta
moson	måsun
moakkil	moakkel
moalkkil	moalkel
moalkut	moalkkut
moarseš	moarssesj
moddii	måddij
mohkil	måhkel
mojonjálmmiid	måjunjálmijd
mojunjálmmiid	måjunjálmijd
moktege	måktege
moktige	måktege
morseš	mårssesj
moskosii	måsskusij
moskosis	måsskuses
mot	måt
movt	måvt
movtta	måvtå
muđolassii	mudulassij
muđui	muduj
muđuui	mudouj
muđuid	mudujd
muggarassii	muggarassij
muhtemin	muhtemen
muhtimassii	muhtemassij
muhtimin	muhtemen
muhtomin	muhtumen
muhtumassii	muhtumassij
muhtumin	muhtumen
muhtunláhkai	muhtunláhkaj
mulgut	mulggut
muoŧáš	muotásj
murtolassii	murttulassij
muttuid	muttujd
muttágit	muttáget
máddelačča	máddelattja
máddelaččas	máddelattjas
máddelažžii	máddeladtjij
máddelebbui	máddelebbuj
máddelii	máddelij
máddeliidda	máddelijdda
máddelis	máddeles
máddelit	máddelet
máddil	máddel
máddin	mádden
máddinnuortan	máddennuortan
máddinoarjin	máddenoarjen
máddugit	mádduget
máhccagasas	máhttsagasas
máhccagassii	máhttsagassij
máhccevaččat	máhttsevattjat
máhccovuksii	máhttsuvuksij
máhccut	máhttsut
máhcil	máhtsel
mái	máj
máŋggaládje	máŋgaládje
máŋggaláhkai	máŋgaláhkaj
máŋgii	máŋggij
máŋgimusat	máŋggemusat
mánnosaččat	mánnusattjat
mášolaččat	másjulattjat
máttabeallai	máttabeallaj
máttageahčai	máttageahtjaj
máttageahčen	máttageahtjen
máttageaže	máttageatje
máttagit	máttaget
máttibui	máttebuj
máttibuidda	máttebujdda
máttibus	máttebus
máttil	máttel
nabason	nabáson
nađđagasas	naddagasas
nađđagassii	naddagassij
nađo	nado
nalde	nallde
namalassii	namálassij
nammejahkii	nammejahkij
nannosit	nannuset
nappot	napput
nebeš	nebesj
niehkabeallai	niehkabeallaj
nirvut	nirvvut
nirvvil	nirvel
niskkemaŋil	niskemaŋel
nissonahttá	nissunahttá
njagil	njagel
njahpagassii	njahpagassij
njahppagassii	njahppagassij
njahppasii	njahppasij
njahppasis	njahppases
njakčut	njaktjut
njalput	njalpput
njamažahkkát	njamátjahkkát
njaŋgut	njaŋggut
njavččil	njavtjel
njavga	njavgga
njavkkil	njavkel
njeakcut	njiektsut
njealjádassii	njæljjádassij
njealjádis	njæljjádes
njealljásiidnjealljásiid	njælljásijnnjealljásijd
njeavccil	njievttsel
njeazzut	njiedtsut
njeljiidnjeljiid	njeljjijnnjeljijd
njelljii	njelljij
njiellagassii	njiellagassij
njoaiddul	njoajdul
njoalput	njoalpput
njoarostanmuddui	njoarustanmudduj
njoarostanmuttos	njoarustanmuttos
njoarragii	njoarragij
njoarragis	njoarrages
njoaskut	njoasskut
njoazebut	njoatsebut
njoazit	njoatset
njolgelávkái	njålggelávkáj
njolggi	njålge
njozet	njåtset
njulgestaga	njulggestaga
njunnesuoril	njunnesuorel
njunnálagaid	njunnálagajd
njunolassii	njunulassij
njunos	njunus
njunálassii	njunálassij
njunálassii	njunálassij
njunális	njunáles
njunásiid	njunásijd
njuokkil	njuokkel
njuolganaga	njuolgganaga
njuolggabut	njuolgabut
njuolggoseaibbe	njuolguseajbbe
njuolggočilggiid	njuolgutjilggijd
njuolggá	njuolgá
njuolggát	njuolgát
njuolggoluotta	njuolguluotta
njuolgguslaččat	njuolguslattjat
njuolgut	njuolggut
njuorrasit	njuorraset
njuoskkasnaga	njuoskasnaga
njuovahussii	njuovahussij
njuovvamassii	njuovvamassij
njuovvanviđá	njuovvanvidá
njuovžilit	njuovttjelet
njáikkal	njájkal
njáikkul	njájkul
njálgát	njálggát
njálmmálaččat	njálmálattjat
njálmmát	njálmát
njámmagassii	njámmagassij
njámmasii	njámmasij
njámmasis	njámmases
njáŋgut	njáŋggut
njárbadit	njárbbadet
njárggal	njárgal
noađđeselggiid	noaddeselggijd
nođđosii	nåddusij
nođđosis	nådduses
nohkka	nåhkkå
nollut	nållut
norggabealde	nårgåbealde
nudaddjon	nudáddjon
numot	numut
nuogis	nuoges
nuokkevuollái	nuokkevuolláj
nuolos	nuolus
nuoluid	nuolujd
nuortalačča	nuorttalattja
nuortalaččas	nuorttalattjas
nuortalaš	nuorttalasj
nuortalažžii	nuorttaladtjij
nuortaleamos	nuorttaleamos
nuortaleappos	nuorttaleappos
nuortalebbui	nuorttalebbuj
nuortaleppožii	nuorttaleppotjij
nuortaleppožis	nuorttaleppotjes
nuortalii	nuorttalij
nuortaliidda	nuorttalijdda
nuortalis	nuorttales
nuortalit	nuorttalet
nuortan	nuorttan
nuortandavvin	nuorttandavven
nuortanlullin	nuorttanlullen
nuortin	nuortten
nuorttabealde	nuortabealde
nuorttabeale	nuortabeale
nuorttabeallai	nuortabeallaj
nuorttabui	nuortabuj
nuorttabuidda	nuortabujdda
nuorttabus	nuortabus
nuorttageahčai	nuortageahtjaj
nuorttageahčen	nuortageahtjen
nuorttageaže	nuortageatje
nuorttas	nuortas
nuppeaivve	nuppeajvve
nuppeláhkai	nuppeláhkaj
nuppos	nuppus
nuppádassii	nuppádassij
nuppádis	nuppádes
nuskket	nusket
nuvttá	nuvtá
nuvttánaga	nuvtánaga
náđđagasas	náddagasas
náđđagassii	náddagassij
nárvvil	nárvel
návrun	návrrun
oaba	åba
oabanassii	åbanassij
oaidninláhkai	oajnnenláhkaj
oainna	oajna
oainnat	oajnat
oainneman	oajneman
oaivveheamet	oajveheamet
oaivvesnaga	oajvesnaga
oaivvát	oajvát
oalil	oalel
oalleláhkai	oalleláhkaj
oaláhii	oaláhij
oanehassii	oanehassij
oanekassii	oanekassij
oanit	oanet
oapmet	oabmet
oapmit	oabmet
oarjelačča	oarjjelattja
oarjelaččas	oarjjelattjas
oarjelaš	oarjjelasj
oarjelažžii	oarjjeladtjij
oarjeleamos	oarjjeleamos
oarjeleappos	oarjjeleappos
oarjelebbui	oarjjelebbuj
oarjeleppožii	oarjjeleppotjij
oarjeleppožis	oarjjeleppotjes
oarjelii	oarjjelij
oarjeliidda	oarjjelijdda
oarjelis	oarjjeles
oarjelit	oarjjelet
oarjil	oarjjel
oarjin	oarjjen
oarjindavvin	oarjjendavven
oarjinlullin	oarjjenlullen
oarjjabealde	oarjabealde
oarjjabeale	oarjabeale
oarjjabeallai	oarjabeallaj
oarjjageahčai	oarjageahtjaj
oarjjageahčen	oarjageahtjen
oarjjageaže	oarjageatje
oarjjibui	oarjebuj
oarjjibuidda	oarjebujdda
oarjjibus	oarjebus
oarjjil	oarjel
oarjjál	oarjál
oarjjás	oarjás
oarjjásdavás	oarjásdavás
oarjjáslulás	oarjáslulás
oarpmenbeleš	oarmenbelesj
oassálagaid	oassálagajd
oatnebotta	oadnebotta
oavnnjil	oavnjel
oažžunsadjái	oadtjunsadjáj
oažžunsajis	oadtjunsajes
oba	åbå
oba	åbå
obalohkái	åbålohkáj
obanassii	åbånassij
obbanassii	åbbånassij
obba	åbbå
obbagazzii	åbbågadtsij
obbalohkái	åbbålohkáj
obban	åbbån
obbanaga	åbbånaga
ođasnaga	ådåsnaga
ođđasis	åddåses
ođđasit	åddåset
odjorassii	ådjurassij
odne	åddne
ohcanláhkai	åhtsånláhkaj
ohpihii	åhpehij
ohpit	åhpet
oidnolagaid	åjnnulagajd
oidnosii	åjnnusij
oidnosis	åjnnuses
oinnolaččat	åjnulattjat
okcii	åktsij
oktan	åktån
oktanaga	åktånaga
oktanagas	åktånagas
oktanis	åktånes
oktasaččat	åktåsattjat
oktaseametteska	åktåseametteska
okte	åkte
oktege	åktege
oktii	åktij
oktiibuot	åktijbuot
oktiigait	åktijgajt
oktiige	åktijge
oktiinjálmmiid	åktijnjálmijd
oktiiráđiid	åktijrádijd
oktilaččat	åktelattjat
oktilassii	åktelassij
oktilit	åktelet
okto	åkto
okto	åkto
oktonassii	åktunassij
oktooaivvis	åktooajvves
oktoráđálaččat	åkturádálattjat
olahagas	ålåhagas
olahahkii	ålåhahkij
olatmeahttumii	ålåtmeahttumij
olatmeahttumis	ålåtmeahttumes
olggobeale	ålgubeale
olggobeali	ålgubeale
olggobeale	ålgubeale
olggobeallái	ålgubealláj
olggos	ålgus
olggossisa	ålgussisa
olggubui	ålgubuj
olggubuidda	ålgubujdda
olggubus	ålgubus
olggul	ålgul
olgguldasat	ålguldasat
olgolačča	ålggulattja
olgolaččas	ålggulattjas
olgolažžii	ålgguladtjij
olgoleappos	ålgguleappos
olgolebbui	ålggulebbuj
olgoleppožii	ålgguleppotjij
olgoleppožis	ålgguleppotjes
olgolii	ålggulij
olgoliidda	ålggulijdda
olgolis	ålggules
olgoráigge	ålggurájgge
olgul	ålggul
olgulačča	ålggulattja
olgun	ålggun
ollege	ållege
ollenge	ållenge
ollislaččat	ålleslattjat
ollodagas	ålludagas
ollodahkii	ålludahkij
ollonaga	ållunaga
ollu	ållo
ollunága	ållunága
ollásii	ållåsij
ollát	ållåt
olu	ålo
olus	ålus
olámuddui	ålåmudduj
olámuttos	ålåmuttos
on	ån
oŋ	åŋ
oppa	åppå
oppalaččat	åppålattjat
oppalohkái	åppålohkáj
oppanassii	åppånassij
opparat	åppårat
optimalalaččat	åptemalalattjat
orddil	årdel
orot	årut
oskkáldasat	åskåldasat
osohahkii	åsuhahkij
otne	ådne
otnánaga	ådnånaga
ovccádassii	åvttsådassij
ovccádis	åvttsådes
ovdagihtii	åvddågihtij
ovdalgihtii	åvddålgihtij
ovdal	åvddål
ovdalaš	åvddålasj
ovdalaš	åvddålasj
ovdaleappos	åvddåleappos
ovdalebbui	åvddålebbuj
ovdaleppožii	åvddåleppotjij
ovdaleppožis	åvddåleppotjes
ovdalii	åvddålij
ovdaliidda	åvddålijdda
ovdalis	åvddåles
ovdan	åvddån
ovdanruoktot	åvddånruoktot
ovdasanatis	åvddåsanates
ovdabeallái	åvddåbealláj
ovdabealde	åvddåbealde
ovddabealde	åvdåbealde
ovddabeale	åvdåbeale
ovddabeallai	åvdåbeallaj
ovddageahčai	åvdågeahtjaj
ovddageahčen	åvdågeahtjen
ovddalgihtii	åvdålgihtij
ovddas	åvdås
ovddemus	åvdemus
ovddemusat	åvdemusat
ovddemustá	åvdemustá
ovddežis	åvdetjes
ovddibui	åvdebuj
ovddibuidda	åvdebujdda
ovddibus	åvdebus
ovddimustá	åvdemustá
ovddimus	åvdemus
ovddos	åvdus
ovddosguvlui	åvdusguvluj
ovddosguovlluid	åvdusguovllujd
ovddosmaŋás	åvdusmaŋás
ovddosii	åvdusij
ovdelis	åvddeles
ovdán	åvddån
ovstalii	åvsstålij
ovstalis	åvsståles
ovstan	åvsstån
ovsttas	åvstås
ovtta	åvtå
ovttaidovttaid	åvtåjdovttajd
ovttaid-ovttaid	åvtåjd-åvtåjd
ovttafáru	åvtåfáru
ovttajienalaččat	åvtåjienalattjat
ovttaládje	åvtåládje
ovttaláhkai	åvtåláhkaj
ovttaláhkái	åvtåláhkáj
ovttamađe	åvtåmade
ovttamielas	åvtåmielas
ovttamielalaččat	åvtåmielalattjat
ovttas	åvtås
ovttasráđiid	åvtåsrádijd
ovttatládje	åvtåtládje
ovttatláhkái	åvtåtláhkáj
ovttatmano	åvtåtmano
ovttatmanu	åvtåtmanu
ovttatmanos	åvtåtmanos
ovtto	åvto
ovttohii	åvtuhij
ovttotládje	åvtutládje
peanta	pientta
persovnnalaččat	perssuvnalattjat
presto	pressto
raddálagaid	raddálagajd
rahpil	rahpel
rančut	rantjut
rastá	rasstá
rastá	rasstá
ravdal	ravddal
ravdalačča	ravddalattja
ravdalaččas	ravddalattjas
ravdalažžii	ravddaladtjij
ravdaleappos	ravddaleappos
ravdalebbui	ravddalebbuj
ravdaleppožii	ravddaleppotjij
ravdaleppožis	ravddaleppotjes
ravdalii	ravddalij
ravdaliidda	ravddalijdda
ravdalis	ravddales
ravddabui	ravdabuj
ravddabuidda	ravdabujdda
ravddabus	ravdabus
ravddagit	ravdaget
reahccut	riehttsut
reaida	riejdda
reaŋggaš	rieŋgasj
reavžut	rievttjut
riđus	ridus
riddolačča	riddulattja
riddolaččas	riddulattjas
riddolaččas.	riddulattjas.
riddolaš	riddulasj
riddolažžii	ridduladtjij
riddoleappos	ridduleappos
riddoleappos.	ridduleappos.
riddolebbui	riddulebbuj
riddolebbui	riddulebbuj
riddolii	riddulij
riddoliidda	riddulijdda
riddolis	riddules
rievttuid	rievtujd
riikkaidgaskasaččat	rijkajdgaskasattjat
rihccut	rihttsut
rihcojulggiid	rihtsujulggijd
rinčut	rintjut
rindeozaid	rinddeotsajd
ristut	risstut
rittubui	rittubuj
rittubuidda	rittubujdda
rivašilljá	rivatjilljá
rivvosii	rivvusij
roahkil	roahkel
roaibbonjálmmiid	roajbunjálmijd
roaibut	roajbbut
roamššil	roamsjel
roaŋkkil	roaŋkel
roaŋkut	roaŋkkut
roanccil	roantsel
roancut	roanttsut
roavččil	roavtjel
roavkkul	roavkul
roggut	råggut
rokkil	råkkel
romet	råmet
ruibbonjálmmiid	rujbunjálmijd
ruibut	rujbbut
ruksessidjii	ruksessidjij
rumppis	rumpes
rumpái	rumppáj
ruoktot	ruoktut
ruoššabealde	ruossjabealde
ruossalassii	ruossalassij
ruoŧabealde	ruotabealde
ruovttogežiid	ruovtugetjijd
ruovttogillii	ruovtugillij
ruovttoguvlui	ruovtuguvluj
ruovttoluotta	ruovtuluotta
ruovttoládje	ruovtuládje
ruovttotgežiid	ruovtutgetjijd
ruššojit	russjujet
russolassii	russulassij
ruvgalassii	ruvggalassij
ruvžžal	ruvtjal
rábášnaga	rábásjnaga
ráđđasii	ráddasij
ráđđasis	ráddases
rádjai	rádjaj
rádjái	rádjáj
rádjálagaid	rádjálagajd
ráđđálagaid	ráddálagajd
ráfálaččat	ráfálattjat
rái	ráj
ráidnasit	rájnnaset
ráigeráigge	rájggerájgge
ráigge	rájge
ráiggil	rájgel
rájis	rájes
rámppaid	rámpajd
rámskkil	rámskel
šahtain	sjahtajn
šat	sjat
šatain	sjatájn
šet	sjet
šieđus	sjiedus
šiehppun	sjiehppun
šiehppunassii	sjiehppunassij
šiehpus	sjiehpus
šiehput	sjiehput
šlumpa	slumppa
šluppul	sluppul
šnjorrosii	sjnjårrusij
šnjuoggut	sjnjuoggut
šnjuokkil	sjnjuokkel
sadjagassii	sadjagassij
sadjosii	sadjusij
sadjosis	sadjuses
sajis	sajes
sajusláhkai	sajusláhkaj
sallalagaid	sallalagajd
seahkesearválaga	siehkesearválaga
seahkálaga	sæhkálaga
seahkálagaid	sæhkálagajd
seahkalagaid	siehkalagajd
seaidnelačča	siejnnelattja
seaidnelaččas	siejnnelattjas
seaidnelaš	siejnnelasj
seaidnelažžii	siejnneladtjij
seaidneleappos	siejnneleappos
seaidnelebbui	siejnnelebbuj
seaidneleppožii	siejnneleppotjij
seaidneleppožis	siejnneleppotjes
seaidnelii	siejnnelij
seaidneliidda	siejnnelijdda
seaidnelis	siejnneles
seaidnil	siejnnel
seaiga	siejgga
seainna	siejna
seainnibui	siejnebuj
seainnibuidda	siejnebujdda
seainnibus	siejnebus
sealgga	sielga
sealggabeale	sielgabeale
sealggabealde	sielgabealde
sealggabeallái	sielgabealláj
sealggebeale	sielgebeale
sealggebealde	sielgebealde
sealggebeallái	sielgebealláj
selggobeale	selgubeale
selggobealde	selgubealde
selggobeallái	selgubealláj
sealggálassii	sælgálassij
sealgil	sielggel
seammas	siemmas
seammaláhkai	siemmaláhkaj
seammaláhkái	siemmaláhkáj
seammaládje	siemmaládje
seammáláhkai	sæmmáláhkaj
seammáládje	sæmmáládje
seammás	sæmmás
searválaga	særvválaga
searválagaid	særvválagajd
sekundáralaččat	sekundáralattjat
selggo	selgo
selggos	selgus
siđvut	sirvvut
sidjii	sidjij
sieiga	siejgga
sierraláhkai	sierraláhkaj
sierranassii	sierranassij
sihkkarit	sihkkaret
siidolagaid	sijddulagajd
sikkarit	sikkaret
sisaboakkil	sisáboakkel
sisabui	sisábuj
sisabuidda	sisábujdda
sisabus	sisábus
siskabealde	sisskabealde
siskabeallái	sisskabealláj
siskelačča	sisskelattja
siskelaččas	sisskelattjas
siskelaš	sisskelasj
siskelažžii	sisskeladtjij
siskeleamos	sisskeleamos
siskeleappos	sisskeleappos
siskelebbui	sisskelebbuj
siskeleppožii	sisskeleppotjij
siskeleppožis	sisskeleppotjes
siskelii	sisskelij
siskeliidda	sisskelijdda
siskelis	sisskeles
siskelit	sisskelet
siskil	sisskel
siskka	siska
siskkibui	siskebuj
siskkibuidda	siskebujdda
siskkibus	siskebus
siskkil	siskel
siskko	sisko
siskkáldasat	siskáldasat
siskálagaid	sisskálagajd
siste	sisste
sisttánátis	sistánátes
sivjjogaš	sivjugasj
sivvadaččat	sivvadattjat
skaippil	skajpel
skavžut	skavttjut
skavžžil	skavtjel
skeaŋkkas	skieŋkas
skeavžut	skievttjut
skiehkil	skiehkel
skielgut	skielggut
skihčil	skihtjel
skivnnjil	skivnjel
skoavddil	skoavdel
skolppil	skålpel
skuhčut	skuhtjut
skuibbil	skujbel
skuibut	skujbbut
skurdnjut	skurnnjut
skužil	skutjel
smarffil	smarfel
smarvvil	smarvel
smilččil	smiltjel
smuhččut	smuhttjut
smuhčil	smuhtjel
smávvásiid	smávvásijd
sneakta	sniekta
snogil	snågel
snogástahkii	snågåstahkij
snohkut	snåhkut
snolkut	snålkkut
snoril	snårel
snurttul	snurtul
snuvtut	snuvttut
snáhppásit	snáhppáset
snáittil	snájtel
soabbegieđas	soabbegiedas
soabbegihtii	soabbegihtij
soamesiin	soamesijn
sodjagasas	sådjågasas
sodjagassii	sådjågassij
sodjut	sådjut
soggelačča	såggelattja
soggelaččas	såggelattjas
soggelaš	såggelasj
soggelažžii	såggeladtjij
soggeleappos	såggeleappos
soggelebbui	såggelebbuj
soggeleppožii	såggeleppotjij
soggeleppožis	såggeleppotjes
soggelii	såggelij
soggeliidda	såggelijdda
soggelis	såggeles
soggil	såggel
sojil	såjel
sojul	såjul
sokka	såkkå
sokkibui	såkkebuj
sokkibuidda	såkkebujdda
sokkibus	såkkebus
soril	sårel
sorjjakeahttá	sårjåkeahttá
sorragasas	sårrågasas
sorragassii	sårrågassij
sparrolagaid	sparrulagajd
spiehččut	spiehttjut
spiehčil	spiehtjel
spileš	spilesj
spillui	spilluj
starga	stargga
stohporáigge	ståhpurájgge
stáđđásit	stáddáset
suige	sujgge
sulaid	sulájd
sulain	sulájn
sullalagaid	sullalagajd
sullii	sullij
sulli	sulle
sulsullii	sulssullij
summalis	summales
summalit	summalet
suohkadit	suohkadet
suohkkogerddiid	suohkkugerddijd
suohkkojuolggis	suohkkujuolgges
suoibma	suojmma
suoimmal	suojmal
suolggaid	suolgajd
suoli	suole
suolivuoli	suolevuole
suollit	suollet
suollugit	suolluget
suoril	suorel
suvdálaga	suvddálaga
sáhkalagaid	sáhkalagajd
sákkil	sákkel
sálbolagaid	sálbbulagajd
sálbut	sálbbut
sárdnumassii	sárnnumassij
sáttonaga	sáttunaga
sávnnjil	sávnjel
sávvamis	sávvames
teahtta	tiehtta
tiimmahala	tijmahala
uhccán	uhttsán
uhccánaš	uhttsánasj
uhces	uhtses
uhcesii	uhtsesij
uhcibut	uhtsebut
uhcimus	uhtsemus
uhcimusat	uhtsemusat
uhcimusge	uhtsemusge
uhcimustá	uhtsemustá
uhcit	uhtset
uhcán	uhtsán
uhcánaččaid	uhtsánattjajd
uhcánaš	uhtsánasj
uhcánii	uhtsánij
uhtesii	uhtesij
uksalačča	uksalattja
uksalaččas	uksalattjas
uksalaš	uksalasj
uksalažžii	uksaladtjij
uksalebbui	uksalebbuj
uksaleppožii	uksaleppotjij
uksaleppožis	uksaleppotjes
uksalii	uksalij
uksaliidda	uksalijdda
uksalis	uksales
unnibut	unnebut
unnimus	unnemus
unnimusat	unnemusat
unnimustá	unnemustá
unnit	unnet
unnánaččaid	unnánattjajd
unnánii	unnánij
uskelačča	usskelattja
uskelaččas	usskelattjas
uskelaš	usskelasj
uskelažžii	usskeladtjij
uskeleappos	usskeleappos
uskelebbui	usskelebbuj
uskeleppožii	usskeleppotjij
uskeleppožis	usskeleppotjes
uskelii	usskelij
uskeliidda	usskelijdda
uskelis	usskeles
uskil	usskel
uskin	ussken
uskkos	uskus
uvssobealde	uvsubealde
uvssobeale	uvsubeale
uvssobeallai	uvsubeallaj
uvssogeahčai	uvsugeahtjaj
uvssogeahčen	uvsugeahtjen
uvssos	uvsus
vahkkobotta	vahkkubotta
vahkkosaččat	vahkkusattjat
vahkkoviissaid	vahkkuvijssajd
vajos	vajus
vajot	vajut
vakŋut	vagŋut
valjis	valjjes
valjit	valjjet
vaŋkut	vaŋkkut
varasnaga	varásnaga
varga	vargga
vargahui	varggahuj
vargui	vargguj
varrasis	varrases
vatnagasas	vadnagasas
vatnagassii	vadnagassij
váidagahttá	vájddagahttá
vávda	vávdda
veaddagasas	vieddagasas
veaddagassii	vieddagassij
veaddagii	vieddagij
veaddagis	vieddages
veagal	viegal
veahkaválddil	viehkaválddel
veahkkálagaid	væhkkálagajd
veahkájo	væhkájo
veahttasit	viehttaset
veahá	væhá
veaiddalassii	viejdalassij
veaiddalis	viejdales
veaittalassii	viejtalassij
vealggás	vælgás
veallut	viellut
vealttakeahttá	vieltakeahttá
veanzut	vienttsut
veanzzil	vientsel
vearis	vieres
veastal	viesstal
veastalabbos	viesstalabbos
veastalabbui	viesstalabbuj
veastalačča	viesstalattja
veastalaččas	viesstalattjas
veastalažžii	viesstaladtjij
veastalii	viesstalij
veastaliidda	viesstalijdda
veastalis	viesstales
veastan	viesstan
veasttabealde	viestabealde
veasttabeale	viestabeale
veasttabeallai	viestabeallaj
veasttabui	viestabuj
veasttabuidda	viestabujdda
veasttabus	viestabus
veasttal	viestal
veasttas	viestas
veháš	vehásj
vehážiid	vehátjijd
vejolaččat	vejulattjat
velábusnai	velábusnaj
viđadassii	vidádassij
viđadis	vidádes
viehkanlávkái	viehkanlávkáj
vieljaš	vieljjasj
vielttil	vieltel
viesttarbealde	viestarbealde
viesttarbeale	viestarbeale
viesttarbeallai	viestarbeallaj
viesttargeahčai	viestargeahtjaj
viesttargeahčen	viestargeahtjen
viežžanládje	viedtjanládje
vihttii	vihttij
viidnanaga	vijnnanaga
viidnenaga	vijnnenaga
viidáseappot	vijddáseappot
viidát	vijddát
viiddásat	vijdásat
viiddáseappot	vijdáseappot
viimmat	vijmat
viidáset	vijddáset
viidásit	vijddáset
viisásit	vijssáset
viivvuheamet	vijvuheamet
vilbeleš	vilbbelesj
vinjil	vinjel
virramii	virramij
visot	visut
visožit	visutjet
vissásii	vissásij
vitnjalassii	vidnjalassij
vitnjut	vidnjut
vivaš	vivasj
vuhkohagaid	vuhkuhagajd
vuhtii	vuhtij
vuiges	vujgges
vuigestaga	vujggestaga
vulobealde	vulubealde
vulobeale	vulubeale
vulobeallai	vulubeallaj
vulogeahčai	vulugeahtjaj
vulogeahčen	vulugeahtjen
vulogeaže	vulugeatje
vulos	vulus
vuogálaččat	vuogálattjat
vuohččan	vuohttjan
vuohkkasit	vuohkkaset
vuohon	vuohun
vuoiddasnaga	vuojdasnaga
vuoiga	vuojgga
vuoikka	vuojka
vuolibučča	vuolebuttja
vuolibuččas	vuolebuttjas
vuolibui	vuolebuj
vuolibuidda	vuolebujdda
vuolibus	vuolebus
vuolibuš	vuolebusj
vuolibužžii	vuolebudtjij
vuolil	vuolel
vuolimus	vuolemus
vuollai	vuollaj
vuollegaččat	vuollegattjat
vuollelačča	vuollelattja
vuollelaččas	vuollelattjas
vuollelaš	vuollelasj
vuollelaš	vuollelasj
vuollelažžii	vuolleladtjij
vuollelebbui	vuollelebbuj
vuolleleppožii	vuolleleppotjij
vuolleleppožis	vuolleleppotjes
vuollelii	vuollelij
vuolleliidda	vuollelijdda
vuollelis	vuolleles
vuollelit	vuollelet
vuollil	vuollel
vuollin	vuollen
vuollugit	vuolluget
vuollái	vuolláj
vuollálagaid	vuollálagajd
vuolábeallai	vuolábeallaj
vuolágeahčai	vuolágeahtjaj
vuolágeahčen	vuolágeahtjen
vuolágeaže	vuolágeatje
vuonabui	vuonabuj
vuonabuidda	vuonabujdda
vuordagasas	vuorddagasas
vuorjjit	vuorjet
vuosseállái	vuosseálláj
vuoste	vuosste
vuosteasiid	vuossteasijd
vuostebeaivái	vuosstebeajváj
vuostečomil	vuosstetjomel
vuostečáhcái	vuosstetjáhtsáj
vuostegobil	vuosstegobel
vuostegulgii	vuosstegulgij
vuostejohtimii	vuosstejohtimij
vuostelii	vuosstelij
vuostelis	vuossteles
vuostemurrii	vuosstemurrij
vuosteoalgái	vuossteoalgáj
vuosterávdnjái	vuossterávnnjáj
vuostil	vuosstel
vuosttabealde	vuostabealde
vuosttabeale	vuostabeale
vuosttabeallai	vuostabeallaj
vuosttain	vuostajn
vuosttamustá	vuostamustá
vuosttažettiin	vuostatjettijn
vuosttažettiin	vuostatjettijn
vuostten	vuosten
vuosttil	vuostel
vuosttás	vuostás
vuostái	vuosstáj
vuostálagaid	vuosstálagajd
vuotnal	vuodnal
vuotnalačča	vuodnalattja
vuotnalaččas	vuodnalattjas
vuotnalaš	vuodnalasj
vuotnalažžii	vuodnaladtjij
vuotnaleappos	vuodnaleappos
vuotnalebbui	vuodnalebbuj
vuotnaleppožii	vuodnaleppotjij
vuotnaleppožis	vuodnaleppotjes
vuotnalii	vuodnalij
vuotnaliidda	vuodnalijdda
vuotnalis	vuodnales
vuotnámaš	vuodnámasj
vuotton	vuottun
vuovddal	vuovdal
vuovddehussii	vuovdehussij
vuovderáigge	vuovdderájgge
vuovdemassii	vuovddemassij
vuovdimassii	vuovddemassij
vuovdinláhkai	vuovddenláhkaj
vurjjet	vurjet
vurohagaid	vuruhagajd
vurrolagaid	vurrulagajd
vurrolaga	vurrulaga
vurrola	vurrula
vurrol	vurrul
vuvdojupmái	vuvddujupmáj
vácci	váttse
vádjit	vádjet
váibamassii	vájbbamassij
váile	vájle
váilevaččat	vájlevattjat
váillil	vájllel
váimmobáhkasnaga	vájmubáhkasnaga
váimmoguovdo	vájmuguovdo
válbmasii	válmmasij
vánit	vánet
váraid	várájd
váras	várás
vári	váre
váribui	várebuj
váribuidda	várebujdda
váribus	várebus
várrelačča	várrelattja
várrelaččas	várrelattjas
várrelaš	várrelasj
várrelažžii	várreladtjij
várrelebbui	várrelebbuj
várreleppožii	várreleppotjij
várreleppožis	várreleppotjes
várrelii	várrelij
várreliidda	várrelijdda
várrelis	várreles
várril	várrel
várrogasat	várrugasat
vásedin	váseden
vátneviša	vádnevisja
áđamusat	ádámusat
áddemeahttumit	áddemeahttumet
áhčeš	áhtjesj
áhkkorat	áhkkurat
áhkáš	áhkásj
áibbas	ájbas
áiddo	ájdo
áiddobeliid	ájdubelijd
áiggebále	ájgebále
áiggelassii	ájgelassij
áigges	ájges
áiggil	ájgel
áiggokeahttá	ájgukeahttá
áigovaččat	ájgguvattjat
áigá	ájggá
áigálii	ájggálij
áimmuide	ájmujde
áin	ájn
áinnas	ájnas
áinnaš	ájnasj
álbmogassii	álmmugassij
álebuš	álebusj
álelassii	álelassij
álfárot	álffárot
álfárut	álffárut
álggage	álgage
álggogeahčai	álgugeahtjaj
álggogeahčen	álgugeahtjen
álggos	álgus
álgobáliid	álggubálijd
álggugeahčen	álgugeahtjen
álgočalbmái	álggutjalmmáj
álgogeahčai	álggugeahtjaj
álgogeahčen	álggugeahtjen
álgoálggos	álggoálggos
álguige	álggujge
álgáge	álggáge
áli	ále
álohii	áluhij
álolaččat	álulattjat
áloládje	áluládje
álot	álut
álas	álás
álásin	álásen
bealleálásin	bielleálásen
ándagassii	ánddagassij
árabui	árábuj
árabuidda	árábujdda
árabuš	árábusj
árgaiđedis	árggajdedes
árgget	árget
árkkit	árket
árpmoheamit	ármuheamet
árradit	árradet
árvalusas	árvvalusas
ávccá	ávttsá
ávjjul	ávjul
ávjolassii	ávjjulassij
álkibut	álkkebut
álkimusat	álkkemusat
álkit	álkket
buoragit	buoraget
siivvožit	sijvutjet
siivvus	sijvus
siivobut	sijvvubut
siivomusat	sijvvumusat
siivvubut	sijvubut
siivvumusat	sijvumusat
siivvut	sijvut
siivot	sijvvut
vearrut	vierrut
vearrábut	værrábut
vearábut	værábut
vearrámusat	værrámusat
vearámusat	værámusat
julga	julgga
julggabut	julgabut
julggamus	julgamus
julggamusat	julgamusat
julggamusta	julgamusta
stuoribut	stuorebut
stuorimusat	stuoremusat
stuorimustá	stuoremustá
eanemus	ienemus
eanemustá	ienemustá
eanet	ienet
eanot	ienut
farggabut	fargabut
farggamus	fargamus
farggamusat	fargamusat
hárve	hárvve
hárvvet	hárvet
hárvvibut	hárvebut
hárvvimusat	hárvemusat
hárvvit	hárvet
rievttabut	rievtabut
rievttamus	rievtamus
lagabut	lagábut
lagamustá	lagámustá
lagat	lagát
árabut	árábut
áramus	árámus
áramusat	árámusat
áramustá	árámustá
árat	árát
guhkimus	guhkemus
guhkimusat	guhkemusat
guhkimustá	guhkemustá
guhkit	guhket
guhkibut	guhkebut
dávjá	dávjjá
dávjábut	dávjjábut
dávjámusat	dávjjámusat
dávjjibut	dávjebut
dávjjimus	dávjemus
dávjjimustá	dávjemustá
dárkket	dárket
dárkkibut	dárkebut
dárkkit	dárket
dárkkit	dárket
dárkkimusat	dárkemusat
