staiidit	stajjdit	v
almmáskit	almáskit	v
gasášit	gasátjit	v
sattihit	saddedit	v
bagohit	bagudit	v
bahkkehit	bahkkidit	v
bahkkedit	bahkkidit	v
bahkkehit	bahkkidit	v
bahkkestit	bahkkistit	v
bahđagit	bahtjagit	v
bahđašit	bahtjatjit	v
bahđiidit	bahtjijdit	v
bahđilit	bahtjelit	v
bahđistit	bahtjestit	v
bahđásit	bahtjásit	v
bahđđostit	bahttjustit	v
bakkagit	bakkagit	v
barffagit	barfagit	v
barffuhit	barfodit	v
barjidit	barjjedit	v
baskkášit	baskátjit	v
basttastit	bastastit	v
bažirdit	batjerdit	v
baže7stit	batjestit	v
bažistit	batjestit	v
beafihit	biefedit	v
beaitalit	biejttalit	v
bealistitit	bielestitit	v
bearbbildit	bierbeldit	v
beastalit	bessadit	v
beavrruhit	bievrodit	v
beavránit	bævrránit	v
beavskalit	bievsskalit	v
beavskkuhit	bievskodit	v
beađđanit	bieddanit	v
beađđasit	bieddasit	v
beaškalit	biessjkalit	v
beaškkuhit	biesjkodit	v
berehit	beridit	v
bieguhit	biegodit	v
biegádit	biegádit	v
biehkulit	biehkolit	v
biehtadit	biehtadit	v
beahttalit	biehttalit	v
biehttalit	biehttalit	v
bierffagit	bierfagit	v
bierffuhit	bierfodit	v
bierfáhit	bierffádit	v
bierggastit	biergastit	v
biertnástit	biernástit	v
bievssastit	bievsastit	v
bieđganit	biergganit	v
bieđáskit	biedáskit	v
bieđđalit	bieddalit	v
biggohit	biggudit	v
biggostit	biggustit	v
bihkkadit	bihkkadit	v
bihtalit	bihtalit	v
biigostit	bijggustit	v
bikšulit	biksjolit	v
bilaidit	bilájdit	v
bildadit	billdadit	v
bilgádit	bilggádit	v
biljagit	biljjagit	v
billidit	billedit	v
billistit	billestit	v
bilppahit	bilpadit	v
bilttagit	biltagit	v
binddastit	bindastit	v
bindulit	binddolit	v
birccastit	birtsastit	v
birccostit	birtsustit	v
biđgedit	birggidit	v
biđgehit	birggidit	v
birgestit	birggistit	v
biđgestit	birggistit	v
birihit	biredit	v
birostit	birustit	v
biršalit	birssjalit	v
bissehit	bissidit	v
biskkihit	biskedit	v
bissostit	bissustit	v
bisttašit	bistatjit	v
bistte7stit	bistestit	v
bivddildit	bivdeldit	v
bivdduhit	bivdodit	v
bivššagit	bivsjagit	v
bivššihit	bivsjedit	v
bivššuhit	bivsjodit	v
bivššádit	bivsjádit	v
birgehit	birggidit	v
biđgedit	birggidit	v
biđgehit	birggidit	v
biđgedit	birggidit	v
biđgehit	birggidit	v
birgestit	birggistit	v
biđgestit	birggistit	v
biđggiidit	birgijdit	v
biđihit	bidedit	v
biđistit	bidestit	v
biđuhit	bidodit	v
biškkodit	bisjkudit	v
biškkuhit	bisjkodit	v
biškkádit	bisjkádit	v
bláđedit	bládidit	v
boaccastit	boattsastit	v
boaggulit	boaggolit	v
boahkkudit	boahkkodit	v
boaibmulit	boajmmolit	v
boaimmastit	boajmastit	v
boaimmo7stitboajmostit	v
boaimmuhit	boajmodit	v
boaimmádit	boajmádit	v
boakkagit	boakkagit	v
boakkastit	boakkastit	v
boakko7stit	boakkostit	v
boakkuhit	boakkodit	v
boalbasit	boalbbasit	v
boalbbastit	boalbastit	v
boalggahit	boalgadit	v
boalđasit	boalttjasit	v
boalđđihit	boaltjedit	v
boalđđuhit	boaltjodit	v
boarkkasmit	boarkasmit	v
boarskudit	boarsskodit	v
boarášit	boarátjit	v
boatkanit	boatkanit	v
boađadit	bådadit	v
bocciidit	båttsijdit	v
bodnjasit	båddnjåsit	v
bogahit	bågådit	v
boggalit	båggålit	v
bohkastit	båhkåstit	v
bohkosit	båhkusit	v
bohraidit	båråjdit	v
bohrihit	båhredit	v
bohruhit	båhrodit	v
bolffagit	bålfågit	v
bolffuhit	bålfodit	v
bolohastit	båluhastit	v
boltasit	bålltåsit	v
bommehit	båmmidit	v
bontahit	bånttådit	v
borggahit	bårgådit	v
borggadit	bårgådit	v
borggahit	bårgådit	v
borggastit	bårgåstit	v
borggihit	bårgedit	v
borggiidit	bårgijdit	v
borgohit	bårggudit	v
borgostit	bårggustit	v
borgádit	bårggådit	v
borgáhit	bårggådit	v
borgádit	bårggådit	v
borgáhit	bårggådit	v
borvedit	bårvvidit	v
bostalit	båsstålit	v
bosttahit	båstådit	v
botkalit	båtkålit	v
botkehit	båtkidit	v
botkestit	båtkistit	v
botkkiidit	båtkkijdit	v
botkkistit	båtkkestit	v
botkkodit	båtkkudit	v
botkkuhit	båtkkodit	v
bottiidit	båttijdit	v
bovdehit	båvddidit	v
bovdestit	båvddistit	v
bovnnjistit	båvnjestit	v
bovskkihit	båvskedit	v
bođastit	bådåstit	v
bođaštit	bådåsjtit	v
bođđanit	båddånit	v
buggasit	buggasit	v
buggánit	buggánit	v
buhtadit	buhtadit	v
buhtistit	buhtestit	v
buhtásmit	buhtásmit	v
buhtášit	buhtátjit	v
buhđásit	buhtjásit	v
buiccuhit	bujtsodit	v
buiddodit	bujdudit	v
buikkihit	bujkedit	v
buimmadit	bujmadit	v
buippihit	bujpedit	v
bullehit	bullidit	v
bulddagit	buldagit	v
buljagit	buljjagit	v
buljardit	buljjardit	v
buljihit	buljjedit	v
bulljasit	bulljasit	v
bulđulit	bulttjolit	v
bulžudit	bulltjodit	v
bumppistit	bumpestit	v
bunccagit	buntsagit	v
bunccardit	buntsardit	v
bunzzardit	buntsardit	v
bunccastit	buntsastit	v
bunccistit	buntsestit	v
bunculit	bunttsolit	v
bunjadit	bunjádit	v
bunjádit	bunjádit	v
bunjaidit	bunjájdit	v
bunjodit	bunjudit	v
bunjadit	bunjádit	v
bunjádit	bunjádit	v
bunccardit	buntsardit	v
bunzzardit	buntsardit	v
bunđalit	buntjalit	v
bunđđihit	bunttjedit	v
bunžalit	bunttjalit	v
bunžáhit	bunttjádit	v
bunžžuhit	buntjodit	v
buoccihit	buottsedit	v
buohccin#dieđihit	buohttsendiededit	v
buohccádit	buohttsádit	v
buohccáhit	buohttsádit	v
buohccádit	buohttsádit	v
buohccáhit	buohttsádit	v
buohccástit	buohttsástit	v
buohtastahttalit	buohtastahttalit	v
buoiddášit	buojdátjit	v
buoimmastit	buojmastit	v
buollahit	buolladit	v
buolaštit	buolasjtit	v
buolvvastit	buolvastit	v
buoláskit	buoláskit	v
buorahit	buoradit	v
buorren#dohkkehit	buorrindåhkkidit	v
buorre7stit	buorrestit	v
buorrin#dohkkehit	buorrendåhkkidit	v
buoruštit	buorosjtit	v
buorášit	buorátjit	v
buovadit	buovadit	v
buovnnjagit	buovnjagit	v
buovnnjistit	buovnjestit	v
buovttahit	buovtadit	v
buovvalit	buovvalit	v
buođđudit	buoddodit	v
buođđulit	buoddolit	v
buošášit	buotjátjit	v
bures#sivdnidit	burissivnnedit	v
burggihit	burgedit	v
burgilit	burggelit	v
burgásit	burggásit	v
burskkihit	burskedit	v
burtanit	burttanit	v
busidit	busedit	v
busildit	buseldit	v
buskáhit	busskádit	v
buvgadit	buvggadit	v
buvttašit	buvtatjit	v
buvvánit	buvvánit	v
buđodit	bududit	v
buđđosit	buddusit	v
buškalit	bussjkalit	v
buškke7hit	busjkedit	v
buškkihit	busjkedit	v
buškke7hit	busjkedit	v
buškkihit	busjkedit	v
bušttašit	busjtatjit	v
bužistit	butjestit	v
báfaidit	báfájdit	v
báfidit	báfedit	v
bággo#lonistit	bággolånestit	v
bágirdit	bágerdit	v
báhkašit	báhkatjit	v
báhkistit	báhkestit	v
báhraidit	báhrajdit	v
báhđalit	báhtjalit	v
báhđilit	báhtjelit	v
báinnagit	bájnagit	v
báisadit	bájssadit	v
báiskásit	bájsskásit	v
báitalit	bájttalit	v
báito7hit	bájttodit	v
báiadit	bájádit	v
báiuhit	bájodit	v
bákko7hit	bákkodit	v
bákkuhit	bákkodit	v
bákko7hit	bákkodit	v
bákkuhit	bákkodit	v
báljagit	báljjagit	v
báljildit	báljjeldit	v
bálkkašit	bálkatjit	v
bálkádit	bálkkádit	v
bálkáhit	bálkkádit	v
bállahastalit	bállahastalit	v
báltudit	bálltodit	v
bálvalit	bálvvalit	v
bálvvuštit	bálvosjtit	v
bánccardit	bántsardit	v
bánžadit	bánttjadit	v
bánžžagit	bántjagit	v
bánžžistit	bántjestit	v
bárddašit	bárdatjit	v
bárjidit	bárjjedit	v
bárrudit	bárrodit	v
bártidit	bárttedit	v
bártiidit	bárttijdit	v
bárttáskit	bártáskit	v
bátnádit	bádnádit	v
báttástit	báttástit	v
bávđđagahttalit	bávtjagahttalit	v
bávđđagit	bávtjagit	v
báŋadit	báŋádit	v
báŋahit	báŋádit	v
báŋádit	báŋádit	v
báŋadit	báŋádit	v
báŋahit	báŋádit	v
báŋádit	báŋádit	v
báŋadit	báŋádit	v
báŋahit	báŋádit	v
báŋádit	báŋádit	v
bážašit	bátjatjit	v
báže7stit	bátjestit	v
bážistit	bátjestit	v
bážihit	bátjedit	v
báže7stit	bátjestit	v
bážistit	bátjestit	v
caddjodit	tsaddjudit	v
cadjasit	tsadjasit	v
cadjásit	tsadjásit	v
caiašit	tsajatjit	v
canccastit	tsantsastit	v
canccodit	tsantsudit	v
cavgge7stit	tsavgestit	v
cavgguhit	tsavgodit	v
cavgilit	tsavggelit	v
ceagganit	tsiegganit	v
ceaggasit	tsieggasit	v
ceaggádit	tsæggádit	v
ceaggáhit	tsæggádit	v
ceaggádit	tsæggádit	v
ceaggáhit	tsæggádit	v
ceahkastit	tsiehkastit	v
ceahkuhit	tsiehkodit	v
ceakkagit	tsiekkagit	v
ceakkildit	tsiekkeldit	v
ceakkuhit	tsiekkodit	v
cealkalit	tsielkkalit	v
cealkilit	tsielkkelit	v
cealkkašit	tsielkatjit	v
cealkke7stit	tsielkestit	v
cielkkistit	tsielkestit	v
cealkkihit	tsielkedit	v
cekkosmit	tsekkusmit	v
cielihit	tsieledit	v
cealkke7stit	tsielkestit	v
cielkkistit	tsielkestit	v
cieládit	tsielládit	v
cihlaidit	tsihlajdit	v
cikcasit	tsiktsasit	v
cilahit	tsiládit	v
cilaidit	tsilájdit	v
cilihit	tsiledit	v
cilkkiidit	tsilkijdit	v
cimirdit	tsimerdit	v
cinnuhit	tsinnodit	v
cirbmasit	tsirmmasit	v
cirgge7hit	tsirgedit	v
cirkkuhit	tsirkodit	v
cirpmastit	tsirmastit	v
ciskkihit	tsiskedit	v
cissuhit	tsissodit	v
civccastit	tsivttsastit	v
civccodit	tsivttsudit	v
civccuhit	tsivttsodit	v
civkalit	tsivkkalit	v
civkkašit	tsivkatjit	v
civkkuhit	tsivkodit	v
civkkádit	tsivkádit	v
civnnagit	tsivnagit	v
civzzagit	tsivtsagit	v
civzziidit	tsivtsijdit	v
cizašit	tsitsatjit	v
cizihit	tsitsedit	v
coabmasit	tsoabbmasit	v
coagášit	tsoagátjit	v
coahkašit	tsoahkatjit	v
coahke7hit	tsoahkedit	v
coahkkalit	tsoahkkalit	v
coakcudit	tsoaktsodit	v
cohcagit	tsåhtsågit	v
cohkkodit	tsåhkkudit	v
cohkkohit	tsåhkkudit	v
cohkkodit	tsåhkkudit	v
cohkkohit	tsåhkkudit	v
coicalit	tsåjttsålit	v
coiccuhit	tsåjtsodit	v
coiccáskit	tsåjtsåskit	v
cubadit	tsubádit	v
cuhcásit	tsuhtsásit	v
cuhladit	tsuhladit	v
cuhlaidit	tsuhlajdit	v
cuhlihit	tsuhledit	v
cuiggodit	tsujgudit	v
cuilalit	tsujlalit	v
cuiláhit	tsujládit	v
cuippihit	tsujpedit	v
culláhit	tsulládit	v
cummestit	tsummistit	v
cummistit	tsummestit	v
cuoccagit	tsuottsagit	v
cuoŋudit	tsuoŋodit	v
cussalit	tsussalit	v
cuskilit	tsusskelit	v
cuskkašit	tsuskatjit	v
cuskke7stit	tsuskestit	v
cussuhit	tsussodit	v
cuvccastit	tsuvttsastit	v
cuvistit	tsuvestit	v
cuvkalit	tsuvkkalit	v
cuvkkuhit	tsuvkodit	v
cuvkkádit	tsuvkádit	v
cuŋkalit	tsuŋkkalit	v
cáhcasit	tsáhtsasit	v
cáiccagit	tsájtsagit	v
cáiccistit	tsájtsestit	v
cáiccáskit	tsájtsáskit	v
cáicudit	tsájttsodit	v
cákcasit	tsáktsasit	v
cázastit	tsátsástit	v
daguhit	dagodit	v
dahraidit	dahrajdit	v
daiahaladit	dajáhaladit	v
daiahastalit	dajáhastalit	v
dallodit	dalludit	v
dalggodit	dalgudit	v
dalkkihit	dalkedit	v
daraidit	darájdit	v
darihit	daredit	v
dasašit	dasatjit	v
davkadit	davkkadit	v
davkkadit	davkadit	v
davkasit	davkkasit	v
davkkildit	davkeldit	v
davrragit	davragit	v
daŋastit	daŋástit	v
daškanit	dassjkanit	v
daškkodit	dasjkudit	v
deabardit	diebardit	v
deabirdit	dieberdit	v
deadnjasit	dieddnjasit	v
deahpanit	diehpanit	v
deaimmáskit	dæjmáskit	v
deaiihit	diejjdit	v
deakđasit	diektjasit	v
deallardit	diellardit	v
deamaidit	diemajdit	v
deamihit	diemedit	v
deamppuhit	diempodit	v
deampulit	diemppolit	v
deamssuhit	diemsodit	v
deanjálgit	dænjálgit	v
dearahit	dieradit	v
dearbbadit	dierbadit	v
dearpalit	dierppalit	v
dearppahit	dierpadit	v
dearppastit	dierpastit	v
dearvvahit	diervadit	v
dearvvašit	diervatjit	v
deattastit	diettastit	v
deattašit	diettatjit	v
deattuhit	diettodit	v
deavđđastit	dievtjastit	v
deađvasit	diervvasit	v
deaŋggaštit	dieŋgasjtit	v
deaškalit	diessjkalit	v
deaškanit	diessjkanit	v
deaškasit	diessjkasit	v
deaškkastit	diesjkastit	v
deaškke7hit	diesjkedit	v
deaškkihit	diesjkedit	v
deaškke7hit	diesjkedit	v
deaškkihit	diesjkedit	v
deaškkuhit	diesjkodit	v
deašášit	dætjátjit	v
deaššastit	diessjastit	v
devdnedit	devnnidit	v
devkkodit	devkudit	v
devđđodit	devtjudit	v
deškkodit	desjkudit	v
diebbánit	diebbánit	v
diehpagit	diehpagit	v
dielladit	dielladit	v
dielvvásmit	dielvásmit	v
dienidit	dienedit	v
dierdidit	dierddedit	v
dieskkardit	dieskardit	v
dievihit	dievedit	v
dieđuštit	diedosjtit	v
digaštit	digasjtit	v
diggedit	diggidit	v
dihkkadit	dihkkadit	v
dihkkedit	dihkkidit	v
dihkkádit	dihkkádit	v
dihkádit	dihkádit	v
dihraidit	dihrajdit	v
dihtoštit	dihtusjtit	v
diiddastit	dijdastit	v
dikkáskit	dikkáskit	v
dilddiidit	dildijdit	v
dilddistit	dildestit	v
dildduhit	dildodit	v
dilssášit	dilsátjit	v
diládit	diládit	v
dimihit	dimedit	v
dimiidit	dimijdit	v
dimistit	dimestit	v
dinodit	dinudit	v
diraidit	dirájdit	v
dirbbodit	dirbudit	v
dirkke7hit	dirkedit	v
dirrulit	dirrolit	v
dirđđuhit	dirtjodit	v
divrrašit	divratjit	v
divskkodit	divskudit	v
divskkádit	divskádit	v
divttásmit	divtásmit	v
divššodit	divsjudit	v
divššuhit	divsjodit	v
diđoštit	didusjtit	v
diškalit	dissjkalit	v
diškasit	dissjkasit	v
diškkastit	disjkastit	v
diškkodit	disjkudit	v
diškkuhit	disjkodit	v
diškkádit	disjkádit	v
diškulit	dissjkolit	v
doabastit	dåbastit	v
doahkkudit	doahkkodit	v
doahttalit	doahttalit	v
doaibmidit	doajmmedit	v
doaimmahit	doajmadit	v
doaivváskit	doajváskit	v
doaiašit	dåjatjit	v
doaiihit	doajjdit	v
doallánit	doallánit	v
doalvalit	doalvvalit	v
doalvvástit	doalvástit	v
doamihit	doamedit	v
doapmalit	doabmalit	v
doapmidit	doabmedit	v
doarssuhit	doarsodit	v
doaráskit	doaráskit	v
doarškalit	doarssjkalit	v
doarškkihit	doarsjkedit	v
doavkkášit	doavkátjit	v
doavskalit	doavsskalit	v
doavskkašit	doavskatjit	v
doavskkuhit	doavskodit	v
doađđihit	doattjedit	v
doaŋgudit	doaŋggodit	v
doaškalit	doassjkalit	v
doaškkihit	doasjkedit	v
doažžudit	doadtjodit	v
doddjohit	dåddjudit	v
dohkasmit	dåhkåsmit	v
dohppehit	dåhppidit	v
dohppestit	dåhppistit	v
dohraidit	dåhråjdit	v
dokŋadit	dågŋådit	v
doldudit	dålldodit	v
dolkadit	dålkkådit	v
dolkalit	dålkkålit	v
dolkkihit	dålkedit	v
dolvviidit	dålvijdit	v
dorrehit	dårridit	v
dorggiidit	dårgijdit	v
dorjestit	dårjjistit	v
dorvvastit	dårvåstit	v
dorvádit	dårvvådit	v
dossádit	dåssådit	v
dovadit	dåvådit	v
dovkošit	dåvkkutjit	v
dovskkihit	dåvskedit	v
dovskkodit	dåvskudit	v
dovssihit	dåvsedit	v
doškestit	dåssjkistit	v
doškkodit	dåsjkudit	v
dudjohit	dudjudit	v
duhastit	duhástit	v
duhaštit	duhasjtit	v
duhkuštit	duhkosjtit	v
duhppestit	duhppistit	v
duhppádit	duhppádit	v
duhrahit	duhradit	v
duhraidit	duhrajdit	v
duhrihit	duhredit	v
duihmudit	dujhmmodit	v
duikudit	dujkkodit	v
duippidit	dujpedit	v
duivvidit	dujvedit	v
duksanit	duksanit	v
dulbestit	dulbbistit	v
dulppagit	dulpagit	v
dulvvášit	dulvátjit	v
dumssagit	dumsagit	v
dunttardit	duntardit	v
duobadit	duobadit	v
duoddudit	duoddodit	v
duodjidit	duodjedit	v
duogurdit	duogordit	v
duoguštit	duogosjtit	v
duohoštit	duohusjtit	v
duohpalit	duohpalit	v
duoittardit	duojtardit	v
duolbbasin#jorahit	duolbasinjårådit	v
duolbbasmit	duolbasmit	v
duolbmalit	duolmmolit	v
duolddihit	duoldedit	v
duolmmadit	duolmadit	v
duolmmahit	duolmadit	v
duolmmadit	duolmadit	v
duolmmahit	duolmadit	v
duolvvidit	duolvedit	v
duorbalit	duorbbalit	v
duorgadit	duorggadit	v
duorggastit	duorgastit	v
duorššagit	duorsjagit	v
duovgudit	duovggodit	v
duođaldit	duodaldit	v
duođaštit	duodasjtit	v
duppardit	duppardit	v
durahit	durádit	v
durbbodit	durbudit	v
durddidit	durdedit	v
durdudit	durddodit	v
durskkuhit	durskodit	v
duskidit	dusskedit	v
duvddašit	duvdatjit	v
duvdelit	duvddilit	v
duvhllidit	duvhledit	v
duvkkiidit	duvkijdit	v
duđaidit	dudájdit	v
duđgalit	durggalit	v
duđihit	dudedit	v
duššadit	dussjadit	v
duškalit	dussjkalit	v
duškidit	dussjkedit	v
duššášit	dussjátjit	v
dábildit	dábeldit	v
dábistit	dábestit	v
dábuhit	dábodit	v
dábástit	dábástit	v
dággudit	dággodit	v
dáguhit	dágodit	v
dáhkadit	dáhkadit	v
dáhkidit	dáhkedit	v
dáhpádit	dáhpádit	v
dáhtodit	dáhtudit	v
dáidnádit	dájnnádit	v
dáiggášit	dájgátjit	v
dáigudit	dájggodit	v
dáikkihit	dájkedit	v
dáikkáskit	dájkáskit	v
dáistalit	dájsstalit	v
dáiáskit	dájáskit	v
dáktadit	dáktadit	v
dállastit	dállastit	v
dálludit	dállodit	v
dálvádit	dálvvádit	v
dáláštit	dálásjtit	v
dánccadit	dántsadit	v
dánccastit	dántsastit	v
dánirdit	dánerdit	v
dánsestit	dánssistit	v
dápmasit	dábmasit	v
dáraidit	dárájdit	v
dárihit	dáredit	v
dárjjodit	dárjudit	v
dárjudit	dárjjodit	v
dárjjodit	dárjudit	v
dárjudit	dárjjodit	v
dárkkodit	dárkudit	v
dárkko7hit	dárkodit	v
dárkkuhit	dárkodit	v
dárkko7hit	dárkodit	v
dárkkuhit	dárkodit	v
dárkostit	dárkkustit	v
dáro7stit	dárostit	v
dárránit	dárránit	v
dáráskit	dáráskit	v
dássánit	dássánit	v
dásásmit	dásásmit	v
dávggasmit	dávgasmit	v
dávggastit	dávgastit	v
dávgudit	dávggodit	v
dávistit	dávestit	v
dávjjidit	dávjedit	v
dávjudit	dávjjodit	v
dávjánit	dávjjánit	v
dávžžadit	dávtjadit	v
dáđđudit	dáddodit	v
dáškkidit	dásjkedit	v
deadduhit	dieddodit	v
eaddudit	ieddodit	v
geađđudit	gieddodit	v
eadjalit	iedjalit	v
njiedjalit	njiedjalit	v
eahpe7basuhit	iehpebasudit	v
eaibmidit	iejmmedit	v
eaibmudit	iejmmodit	v
rieibmudit	riejmmodit	v
beaidadit	biejddadit	v
eaidadit	iejddadit	v
sneaidadit	sniejddadit	v
eaiggádit	æjgádit	v
eaippildit	iejpeldit	v
ealašit	ielatjit	v
gealašit	gielatjit	v
ealjuhit	ieljjodit	v
ealáskit	æláskit	v
eamidastalit	iemedastalit	v
eanne7hit	iennedit	v
eannáhit	ænnádit	v
eanášit	ænátjit	v
eardudit	ierddodit	v
earuhit	ierodit	v
jearuhit	jierodit	v
vearuhit	vierodit	v
đieruhit	tjierodit	v
eastadit	iesstadit	v
biestalit	biesstalit	v
eastalit	iesstalit	v
easttadit	iestadit	v
eatne7hit	iednedit	v
eatnánit	ædnánit	v
deattihit	diettedit	v
eatte7hit	iettedit	v
eattihit	iettedit	v
meattihit	miettedit	v
šliettihit	sliettedit	v
deattihit	diettedit	v
eatte7hit	iettedit	v
eattihit	iettedit	v
meattihit	miettedit	v
šliettihit	sliettedit	v
eavttuhit	ievtodit	v
eaškálit	æssjkálit	v
einnostit	ejnustit	v
ellohit	elludit	v
eloštit	elusjtit	v
ennostit	ennustit	v
evttohit	evtudit	v
sevttodit	sevtudit	v
faggasit	faggasit	v
fakkastit	fakkastit	v
fakŋalit	fagŋalit	v
fallehit	fallidit	v
falášit	falátjit	v
faskasit	fasskasit	v
faskkastit	faskastit	v
faskkestit	faskistit	v
faskkodit	faskudit	v
faskulit	fasskolit	v
fastošit	fasstutjit	v
fasttášit	fastátjit	v
fađastit	fadástit	v
fađustit	fadostit	v
faŋkkagit	faŋkagit	v
faŋuhit	faŋodit	v
faŋádit	faŋádit	v
fearkkastit	fierkastit	v
fearkulit	fierkkolit	v
feasttašit	fiestatjit	v
feastásit	fæsstásit	v
fereštit	ferisjtit	v
ferkkodit	ferkudit	v
fidnehit	fiddnidit	v
fielladit	fielladit	v
fiergádit	fierggádit	v
fierihit	fieredit	v
fierradit	fierradit	v
fierralit	fierralit	v
fierttudit	fiertodit	v
fievrasit	fievrrasit	v
fievrre7dit	fievredit	v
fievrridit	fievredit	v
márkan#fievrridit	márkkanfievredit	v
sisa#fievrre7dit	sisafievredit	v
sisa#fievrridit	sisafievredit	v
suolle7#fievrridit	suollefievredit	v
viidáset#fievrridit	vijddásetfievredit	v
márkan#fievrridit	márkkanfievredit	v
sisa#fievrre7dit	sisafievredit	v
sisa#fievrridit	sisafievredit	v
suolle7#fievrridit	suollefievredit	v
viidáset#fievrridit	vijddásetfievredit	v
fiidnudit	fijnnodit	v
fikkahit	fikkadit	v
fillestit	fillistit	v
fil√©^astit	fil√©^astit	v
finadit	finádit	v
finahit	finádit	v
finadit	finádit	v
finahit	finádit	v
finihit	finedit	v
finjagit	finjágit	v
finjildit	finjeldit	v
firrestit	firristit	v
firrohit	firrudit	v
firtestit	firttistit	v
fiskahit	fisskadit	v
fiskkihit	fiskedit	v
fiskkodit	fiskudit	v
fiskánit	fisskánit	v
fiŋgasit	fiŋggasit	v
fiŋggihit	fiŋgedit	v
fiŋggodit	fiŋgudit	v
fiškalit	fissjkalit	v
fiškasit	fissjkasit	v
fiškkardit	fisjkardit	v
fiškkihit	fisjkedit	v
friskkodit	friskudit	v
fuoladit	fuoladit	v
fuolahit	fuoladit	v
fuoladit	fuoladit	v
fuolahit	fuoladit	v
fuomihit	fuomedit	v
fuomášit	fuomátjit	v
fuonidit	fuonedit	v
fuonášit	fuonátjit	v
fuopmášit	fuobmátjit	v
fuorjjášit	fuorjátjit	v
fuorástit	fuorástit	v
fuotnánit	fuodnánit	v
fuođardit	fuodardit	v
furrošit	furrutjit	v
fáipasit	fájppasit	v
fáippastit	fájpastit	v
fáippihit	fájpedit	v
fáippodit	fájpudit	v
fáippádit	fájpádit	v
fákkáskit	fákkáskit	v
fáktorastit	fákturastit	v
fálbme7#bealástit	fálmmebælástit	v
fárrehit	fárridit	v
fárrestit	fárristit	v
fárgehit	fárggidit	v
fárrudit	fárrodit	v
fáruhit	fárodit	v
fásttostit	fástustit	v
fástudit	fásstodit	v
fátmmastit	fátmmastit	v
fátmmodit	fátmmudit	v
fávledit	fávllidit	v
fávllidit	fávledit	v
fávledit	fávllidit	v
fávllidit	fávledit	v
fávlánit	fávllánit	v
fávrrosmit	fávrusmit	v
fáđahit	fádádit	v
fáđašit	fádatjit	v
fáškalit	fássjkalit	v
fáškasit	fássjkasit	v
fáškkardit	fásjkardit	v
fáškkastit	fásjkastit	v
fáškkihit	fásjkedit	v
gacce7stit	gattsestit	v
gaccirdit	gattserdit	v
gaccodit	gattsudit	v
gaccuhit	gattsodit	v
gahkkudit	gahkkodit	v
gahridit	gahredit	v
gaibadit	gajbbadit	v
gaidnadit	gajnnadit	v
gaivvihit	gajvedit	v
gakculit	gaktsolit	v
galbbastit	galbastit	v
galkadit	galkkadit	v
galkkadit	galkadit	v
galkadit	galkkadit	v
galkkadit	galkadit	v
galmmiidit	galmijdit	v
gamardit	gamárdit	v
garašit	garatjit	v
garcestit	garttsistit	v
gardásit	garddásit	v
gargalit	garggalit	v
garggistit	gargestit	v
gargguhit	gargodit	v
garihit	garedit	v
garistit	garestit	v
garppuhit	garpodit	v
garuhit	garodit	v
garvvašit	garvatjit	v
gassalit	gassalit	v
gassuhit	gassodit	v
gassudit	gassodit	v
gassuhit	gassodit	v
gasttihit	gastedit	v
gasášit	gasátjit	v
gavašit	gavatjit	v
gavccodit	gavttsudit	v
gavccádit	gavttsádit	v
gavdnjalit	gavnnjalit	v
gavihit	gavedit	v
gavistit	gavestit	v
gavjehit	gavjjidit	v
gavjjuhit	gavjodit	v
gavnnjastit	gavnjastit	v
gavvardit	gavvardit	v
gavvásit	gavvásit	v
gavžžihit	gavtjedit	v
gazirdit	gatserdit	v
gaŋgguhit	gaŋgodit	v
gaŋkestit	gaŋkkistit	v
gaŋkkagit	gaŋkagit	v
gaškkihit	gasjkedit	v
geafášit	gæfátjit	v
geahcalit	giehtsalit	v
geahpašit	giehpatjit	v
geahpášit	gæhpátjit	v
geahđadit	giehtjadit	v
geahđahit	giehtjadit	v
geahđadit	giehtjadit	v
geahđahit	giehtjadit	v
geahđastit	giehtjastit	v
geahđe7stit	giehtjestit	v
geahđđalit	giehttjalit	v
geaigahit	giejggadit	v
geaiganit	giejgganit	v
geaigasit	giejggasit	v
geaiggagit	giejgagit	v
geaigguhit	giejgodit	v
geaivalit	giejvvalit	v
geaktidit	giektedit	v
gealbidit	gielbbedit	v
gealbudit	gielbbodit	v
gealdduhit	gieldodit	v
geamppašit	giempatjit	v
geanašit	gienatjit	v
gearadit	gieradit	v
gearahit	gieradit	v
gearadit	gieradit	v
gearahit	gieradit	v
gearggusin#meannudit	giergosinmiennodit	v
gearjidit	gierjjedit	v
geavahit	gevadit	v
geavjadit	gievjjadit	v
geavlidit	gievlledit	v
geavránit	gævrránit	v
geavvadit	gievvadit	v
geazadit	gietsadit	v
geađgádit	gærggádit	v
geađđudit	gieddodit	v
geažuhit	gietjodit	v
gehpiidit	gehpijdit	v
geiggiidit	gejgijdit	v
gemodit	gemudit	v
gerjjodit	gerjudit	v
getkkoštit	getkkusjtit	v
geđđohit	geddudit	v
giekcasit	giektsasit	v
gielbbardit	gielbardit	v
gielddašit	gieldatjit	v
giessasit	giessasit	v
gietkkadit	gietkkadit	v
gievttadit	gievtadit	v
gievvudit	gievvodit	v
gieváskit	gieváskit	v
gieškadit	giessjkadit	v
gihlidit	gihledit	v
gihládit	gihládit	v
gihppudit	gihppodit	v
gihraidit	gihrajdit	v
gihrihit	gihredit	v
giksadit	giksadit	v
giktadit	giktadit	v
giktalit	giktalit	v
gillástit	gillástit	v
gildahit	gilldadit	v
gilgedit	gilggidit	v
gilgestit	gilggistit	v
giljodit	giljjudit	v
giljádit	giljjádit	v
gilššagit	gilsjagit	v
gimbbaldit	gimbaldit	v
gimssordit	gimsurdit	v
gimškkardit	gimsjkardit	v
gincalit	ginttsalit	v
ginccuhit	gintsodit	v
ginccádit	gintsádit	v
ginuhit	ginodit	v
ginustit	ginostit	v
girbmidit	girmmedit	v
girdodit	girddudit	v
girjjodit	girjudit	v
girjudit	girjjodit	v
girjjodit	girjudit	v
girjudit	girjjodit	v
girkkodit	girkudit	v
gisaidit	gisájdit	v
givccodit	givttsudit	v
givccádit	givttsádit	v
givdnjahit	givnnjadit	v
givnnjardit	givnjardit	v
givnnjádit	givnjádit	v
givrragit	givragit	v
givttahit	givtadit	v
givvežit	givvitjit	v
givšttidit	givsjtedit	v
givžžastit	givtjastit	v
gizzulit	gidtsolit	v
giđđudit	giddodit	v
giŋgguhit	giŋgodit	v
giŋgodit	giŋggudit	v
giŋggádit	giŋgádit	v
giŋgodit	giŋggudit	v
gišvvardit	gisjvvardit	v
gišvvihit	gisjvvedit	v
giššuhit	gissjodit	v
gižžidit	gidtjedit	v
gižžudit	gidtjodit	v
goabagit	gåbagit	v
goadnahit	goaddnadit	v
goadnasit	goaddnasit	v
goaibbagit	goajbagit	v
goaippildit	goajpeldit	v
goalkke7hit	goalkedit	v
goalkkidit	goalkedit	v
goalkkihit	goalkedit	v
goalkke7hit	goalkedit	v
goalkkidit	goalkedit	v
goalkkihit	goalkedit	v
goalkke7hit	goalkedit	v
goalkkidit	goalkedit	v
goalkkihit	goalkedit	v
goalkkášit	goalkátjit	v
goallo7stit	goallostit	vš
goalvvahit	goalvadit	v
goalvvuhit	goalvodit	v
goalŋŋadit	goalŋadit	v
goamagit	gåmagit	v
goanjidit	goanjedit	v
goantulit	goanttolit	v
goarasmit	gårasmit	v
goarbmulit	goarmmolit	v
goarddašit	goardatjit	v
goarggasmit	goargasmit	v
goargguhit	goargodit	v
goarjidit	goarjjedit	v
goarkalit	goarkkalit	v
goarpmastit	goarmastit	v
goarpmo7hit	goarmodit	v
goarpmuhit	goarmodit	v
goarpmo7hit	goarmodit	v
goarpmuhit	goarmodit	v
goarránit	goarránit	v
goartudit	goarttodit	v
goarvanit	goarvvanit	v
goarvvagit	goarvagit	v
goarvvastit	goarvastit	v
goarvve7hit	goarvedit	v
goasihit	goasedit	v
goassudit	goassodit	v
goastadit	goasstadit	v
goasttášit	goastátjit	v
goatnahit	goadnadit	v
goattásmit	goattásmit	v
goavccuhit	goavttsodit	v
goavkkagit	goavkagit	v
goavrragit	goavragit	v
goavrruhit	goavrodit	v
goavásmit	goavásmit	v
goavášit	goavátjit	v
goaŋidit	goaŋedit	v
goaŋkkuhit	goaŋkodit	v
gobagit	gåbågit	v
gobmahit	gåbbmådit	v
gobmidit	gåbbmedit	v
gohđđodit	gåhttjudit	v
goidadit	gåjddådit	v
goiddildit	gåjdeldit	v
goidošit	gåjddutjit	v
goiggardit	gåjgårdit	v
goivodit	gåjvudit	v
gokđasit	gåktjåsit	v
goldnadit	gålnnådit	v
golggirdit	gålgerdit	v
golkehit	gålkkidit	v
golkestit	gålkkistit	v
gollodit	gålludit	v
golludit	gållodit	v
golluhit	gållodit	v
olggos#golludit	ålgusgållodit	v
golludit	gållodit	v
golluhit	gållodit	v
olggos#golludit	ålgusgållodit	v
golluštit	gållosjtit	v
golnnihit	gålnedit	v
gomaidit	gåmåjdit	v
gomuštit	gåmosjtit	v
gonstošit	gånsstutjit	v
gonsttošit	gånstutjit	v
gorbmestit	gårmmistit	v
gorgŋehit	gårŋŋidit	v
gorgŋestit	gårŋŋistit	v
gorpmodit	gårmudit	v
goskkiidit	gåskijdit	v
gottildit	gåtteldit	v
gottáskit	gåttåskit	v
govdadit	gåvddådit	v
govddadit	gåvdådit	v
govddidit	gåvdedit	v
govddihit	gåvdedit	v
govddidit	gåvdedit	v
govddihit	gåvdedit	v
govddiidit	gåvdijdit	v
govddodit	gåvdudit	v
govddášit	gåvdåtjit	v
govdnadit	gåvnnådit	v
govdodit	gåvddudit	v
govdánit	gåvddånit	v
govlládit	gåvlådit	v
govssašit	gåvsåtjit	v
govuhit	gåvodit	v
govššodit	gåvsjudit	v
gozustit	gåtsostit	v
gozádit	gåtsådit	v
gođahit	gådådit	v
goŋggihit	gåŋgedit	v
goŋkehit	gåŋkkidit	v
goŋkánit	gåŋkkånit	v
gubistit	gubestit	v
guhkkánit	guhkkánit	v
guhlardit	guhlardit	v
guhpanit	guhpanit	v
guhpiidit	guhpijdit	v
guhpirdit	guhperdit	v
guippihit	gujpedit	v
guissádit	gujsádit	v
guittidit	gujtedit	v
guiagit	gujágit	v
guljodit	guljjudit	v
gulladit	gulladit	v
guláskit	guláskit	v
gumihit	gumedit	v
guobbalit	guobbalit	v
guobirdit	guoberdit	v
guoggahit	guoggadit	v
guohcagit	guohtsagit	v
guohce7hit	guohtsedit	v
guohcistit	guohtsestit	v
guohkastit	guohkastit	v
guohkkárit	guohkkárit	v
guohpasit	guohpasit	v
guohppudit	guohppodit	v
guohuštit	guohosjtit	v
guoigalit	guojggalit	v
guoiggadit	guojgadit	v
guoikkihit	guojkedit	v
guoimmuhit	guojmodit	v
guoiradit	guojradit	v
guoirrašit	guojrratjit	v
guoiihit	guojjdet	v
guokkagit	guokkagit	v
guokkuhit	guokkodit	v
guolggidit	guolgedit	v
guoljastit	guoljjastit	v
guolmmastit	guolmastit	v
guolástit	guolástit	v
guonjardit	guonjardit	v
guonnagit	guonnagit	v
guoppuštit	guopposjtit	v
guorbadit	guorbbadit	v
guorbbuhit	guorbodit	v
guorbmádit	guormmádit	v
guorkkihit	guorkedit	v
guorssadit	guorsadit	v
guorssádit	guorsádit	v
guosadit	guosadit	v
guosahit	guosadit	v
guosadit	guosadit	v
guosahit	guosadit	v
guoskke7hit	guoskedit	v
guosmme7hit	guosmedit	v
guossalit	guossalit	v
guosttadit	guostadit	v
guottašit	guottatjit	v
guottildit	guotteldit	v
guovdduštit	guovdosjtit	v
guovdnjudit	guovnnjodit	v
guovnnjagit	guovnjagit	v
guođahit	guodadit	v
guođđelit	guoddilit	v
guppagit	guppagit	v
guppihit	guppedit	v
guppistit	guppestit	v
guppuštit	gupposjtit	v
gurastit	gurástit	v
gurddašit	gurdatjit	v
gurehit	guridit	v
gurgásit	gurggásit	v
gurosmit	gurusmit	v
gurpahit	gurppadit	v
gurpalit	gurppalit	v
gurpasit	gurppasit	v
gurpmodit	gurmudit	v
gurppihit	gurpedit	v
gurradit	gurradit	v
guskalit	gusskalit	v
guskkiidit	guskijdit	v
gussodit	gussudit	v
gustohit	gusstudit	v
guvhllagit	guvhlagit	v
guvnnjádit	guvnjádit	v
guvrruštit	guvrosjtit	v
guđđahit	guttjadit	v
guđđastit	guttjastit	v
guštestit	gussjtistit	v
gáddái#skihkidit	gáddájskihkedit	v
gáhrostit	gáhrustit	v
gáhtardit	gáhtardit	v
gáidádit	gájddádit	v
gáiffadit	gájfadit	v
gáiggistit	gájgestit	v
gáikkihit	gájkedit	v
gáivvastit	gájvastit	v
gáivvihit	gájvedit	v
gáiaidit	gájájdit	v
gáiihit	gájjdit	v
gáiálgit	gájálgit	v
gállehit	gállidit	v
gálbbardit	gálbardit	v
gáldnadit	gálnnadit	v
gálganit	gálgganit	v
gálladit	gálladit	v
gálljudit	gálljodit	v
gálo7dit	gálodit	v
gálo7dit	gálodit	v
gáludit	gálodit	v
gálágit	gálágit	v
gánagit	gánágit	v
gánnáhit	gánnádit	v
gápposmit	gáppusmit	v
gárbmudit	gármmodit	v
gárganit	gárgganit	v
gárgedit	gárggidit	v
gárgehit	gárggidit	v
viidáset#gárgedit	vijddásetgárggidit	v
gárgedit	gárggidit	v
gárgehit	gárggidit	v
viidáset#gárgedit	vijddásetgárggidit	v
gárggiidit	gárgijdit	v
gárgidit	gárggedit	v
gáriidit	gárijdit	v
gárkŋagit	gárŋagit	v
gárrudit	gárrodit	v
gártadit	gárttadit	v
gárvvásmit	gárvásmit	v
gáržudit	gárttjodit	v
gáržžášit	gártjátjit	v
gásidit	gásedit	v
gástadit	gásstadit	v
gásttašit	gástatjit	v
gávagit	gávágit	v
gávastit	gávástit	v
gávddagit	gávdagit	v
gávdnjánit	gávnnjánit	v
gávgalit	gávggalit	v
gávgge7hit	gávgedit	v
gávggihit	gávgedit	v
gávgge7hit	gávgedit	v
gávggihit	gávgedit	v
gávggiidit	gávgijdit	v
gávggistit	gávgestit	v
gávgguhit	gávgodit	v
gávildit	gáveldit	v
gávnnjagit	gávnjagit	v
gávnnjahit	gávnjadit	v
gávpalit	gávppalit	v
gávppahit	gávpadit	v
gávppašit	gávpatjit	v
gávppildit	gávpeldit	v
gávrragit	gávragit	v
gávránit	gávrránit	v
gávuhit	gávodit	v
gávvánit	gávvánit	v
gávzzagit	gávtsagit	v
gávđđadit	gávtjadit	v
gávđđastit	gávtjastit	v
gášvalit	gássjvalit	v
gášvvardit	gásjvvardit	v
gášvvihit	gásjvvedit	v
hahkadit	hahkadit	v
hahkihit	hahkedit	v
hahpadit	hahpadit	v
hahppalit	hahppalit	v
haksilit	hakselit	v
haksostit	haksustit	v
hapmudit	habmodit	v
haraidit	harájdit	v
haskadit	hasskadit	v
haskadit	hasskadit	v
haskkadit	haskadit	v
havssahit	havsadit	v
havsse7stit	havsestit	v
havssihit	havsedit	v
havssiidit	havsijdit	v
haŋkkuhit	haŋkodit	v
heaibbuhit	hiejbodit	v
heaibbáskit	hæjbáskit	v
heairre7hit	hiejrredit	v
heaiudit	hiejodit	v
heaiuhit	hiejodit	v
heaiudit	hiejodit	v
heaiuhit	hiejodit	v
heaiušit	hiejotjit	v
heakkahit	hiekkadit	v
healbadit	hielbbadit	v
healssastit	hielsastit	v
heamssistit	hiemsestit	v
hearjidit	hierjjedit	v
hearvvahit	hiervadit	v
heavahit	hievadit	v
heavganit	hievgganit	v
hievganit	hievgganit	v
heavvanit	hievvanit	v
heađuštit	hiedosjtit	v
heađáskit	hædáskit	v
heaŋgahit	hieŋggadit	v
heaŋgasit	hieŋggasit	v
heaŋggagit	hieŋgagit	v
heaŋggastit	hieŋgastit	v
heaŋgguhit	hieŋgodit	v
heaŋgáhit	hæŋggádit	v
heikkahit	hejkadit	v
heillodit	hejlludit	v
oktii7#heivehit	aktij7hiebadit	v
heiosmit	hejusmit	v
heiošit	hejutjit	v
hellehit	hellidit	v
helssodit	helsudit	v
hereštit	herisjtit	v
hervošit	hervvutjit	v
hervvošit	hervutjit	v
hevrriidit	hevrijdit	v
heŋggiidit	heŋgijdit	v
heŋgostit	heŋggustit	v
hiddjidit	hiddjedit	v
hidjidit	hidjedit	v
hieimmastit	biekkastit	v
heavganit	hievgganit	v
hievganit	hievgganit	v
hieđuhit	hiedodit	v
hihtudit	hihtodit	v
hilaštit	hilasjtit	v
hilbbasmit	hilbasmit	v
hilbbodit	hilbudit	v
hilbudit	hilbbodit	v
hilbošit	hilbbutjit	v
hilbbodit	hilbudit	v
hilbudit	hilbbodit	v
hilcudit	hilttsodit	v
hilggádit	hilgádit	v
hilgádit	hilggádit	v
hilggádit	hilgádit	v
hilgádit	hilggádit	v
hiljášit	hiljjátjit	v
hilljudit	hilljodit	v
hiltedit	hilltidit	v
himihit	himedit	v
himppistit	himpestit	v
himsudit	himssodit	v
hipmošit	hibmutjit	v
hirranit	hirranit	v
hirasmit	hirásmit	v
hirpmahit	hirmadit	v
hirrudit	hirrodit	v
hitnardit	hidnardit	v
hivvehit	hivvidit	v
hivllášit	hivlátjit	v
hivludit	hivllodit	v
hiđásmit	hidásmit	v
hiŋkkašit	hiŋkatjit	v
hiŋkkihit	hiŋkedit	v
hiŋkkádit	hiŋkádit	v
hoagahit	hågadit	v
hoagihit	hoagedit	v
hoahkalit	hoahkalit	v
hoahkidit	hoahkedit	v
hoahpuhit	hoahpodit	v
hoaiggardit	hoajgardit	v
hoalkadit	hoalkkadit	v
hoalššistit	hoalsjestit	v
hoamssistit	hoamsestit	v
hoavridit	hoavrredit	v
hoavrre7stit	hoavrestit	v
hoavrristit	hoavrestit	v
hoavrre7stit	hoavrestit	v
hoavrristit	hoavrestit	v
hoavránit	hoavrránit	v
hobehit	håbidit	v
hohkahit	håhkådit	v
hohpohit	håhpudit	v
hoigasit	håjggåsit	v
holbádit	hålbbådit	v
hovrriidit	håvrijdit	v
huiggirdit	hujgerdit	v
huiošit	hujutjit	v
humahit	humádit	v
humaidit	humájdit	v
humeštit	humisjtit	v
humihit	humedit	v
hunadit	hunádit	v
huncadit	hunttsadit	v
huobastit	huobastit	v
huovidit	huovedit	v
hurihit	huredit	v
hurrulit	hurrolit	v
hurvvagit	hurvagit	v
hurvvuhit	hurvodit	v
huvlliidit	huvlijdit	v
huvvidit	huvvedit	v
huđagit	hudágit	v
hušaidit	husjájdit	v
huškkastit	husjkastit	v
hábbasit	hábbasit	v
hábbudit	hábbodit	v
hágganit	hágganit	v
háhcihit	háhtsedit	v
háhkásit	háhkásit	v
háikkašit	hájkatjit	v
hálbbášit	hálbátjit	v
háljistit	háljjestit	v
hálkkihit	hálkedit	v
hálssagit	hálsagit	v
hámssuhit	hámsodit	v
hámssádit	hámsádit	v
hánddaldit	hándaldit	v
hánášit	hánátjit	v
hápmánit	hábmánit	v
háppastit	háppastit	v
háppuhit	háppodit	v
háppustit	háppostit	v
háppádit	háppádit	v
hárragit	hárragit	v
hárvve7dit	hárvedit	v
hárvve7dit	hárvedit	v
hárvvidit	hárvedit	v
hárđulit	hárttolit	v
hárđđihit	hártedit	v
hárđđuhit	hártodit	v
háskkidit	háskedit	v
háskkirdit	háskerdit	v
hásttalit	hástalit	v
hávddodit	hávdudit	v
hávggádit	hávgádit	v
hávrragit	hávragit	v
hávrriidit	hávrijdit	v
hávskkášit	hávskátjit	v
háđirdit	háderdit	v
háŋggaštit	háŋgasjtit	v
háŋkasit	háŋkkasit	v
bihtalit	bihtalit	v
iiašit	ijatjit	v
ilggodit	ilgudit	v
vilggodit	vilgudit	v
illodit	illudit	v
illudit	illodit	v
silludit	sillodit	v
heillodit	hejlludit	v
illodit	illudit	v
illudit	illodit	v
lilluhit	lillodit	v
silludit	sillodit	v
đilluhit	tjillodit	v
gillástit	gillástit	v
illástit	illástit	v
ilosmit	ilusmit	v
finadit	finádit	v
finahit	finádit	v
inádit	inádit	v
irgalit	irggalit	v
iskkadit	iskadit	v
iskkahit	iskadit	v
iskkadit	iskadit	v
iskkahit	iskadit	v
isádastalit	isádastalit	v
ittásmit	ittásmit	v
jahkiidit	jahkijdit	v
jahlidit	jahledit	v
jakkaldit	jakkaldit	v
jakŋadit	jagŋadit	v
đalludit	tjallodit	v
jallašit	jallatjit	v
jame7hit	jamedit	v
jamihit	jamedit	v
jame7hit	jamedit	v
jamihit	jamedit	v
janzzahit	jantsadit	v
jarffahit	jarfadit	v
jarihit	jaredit	v
jarkŋasmit	jarŋasmit	v
jarrudit	jarrodit	v
javzedit	javttsidit	v
jađgodit	jarggudit	v
jađgohit	jarggudit	v
jađgodit	jarggudit	v
jađgohit	jarggudit	v
jađgŋodit	jarŋŋudit	v
jađgŋohit	jarŋŋudit	v
jađgŋodit	jarŋŋudit	v
jađgŋohit	jarŋŋudit	v
jaŋašit	jaŋatjit	v
jeagadit	jiegadit	v
čiekŋudit	tjiegŋodit	v
jiellahastalit	jiellahastalit	v
jieltudit	jielltodit	v
jienastan#vuoigadit	jienastanvuojggadit	v
jiervvastit	jiervastit	v
jierásmit	jierásmit	v
jiessagit	jiessagit	v
jiessudit	jiessodit	v
jievjjihit	jievjedit	v
jievjjildit	jievjeldit	v
jievladit	jievlladit	v
jievžžadit	jievtjadit	v
joahcalit	joahtsalit	v
joaimmagit	joajmagit	v
joatkkašit	joatkkatjit	v
joatkásit	joatkásit	v
joavaidit	jåvajdit	v
šoavaidit	sjåvajdit	v
joavgalit	joavggalit	v
njoavgalit	njoavggalit	v
joavgge7hit	joavgedit	v
joavihit	joavedit	v
šoavihit	sjoavedit	v
joavvalit	joavvalit	v
jolggadit	jålgådit	v
jolggaštit	jålgåsjtit	v
joppaldit	jåppåldit	v
čoppaldit	tjåppåldit	v
šođbbodit	sjårbudit	v
jore7štit	jåresjtit	v
jorgge7hit	jårgedit	v
jorgge7hit	jårgedit	v
jorihit	jåredit	v
jovgohit	jåvggudit	v
jozzidit	jådtsedit	v
jođálmit	jådålmit	v
juhkildit	juhkeldit	v
juhkásit	juhkásit	v
julaidit	julájdit	v
jule7štit	julesjtit	v
julggadit	julgadit	v
julggaštit	julgasjtit	v
julkalit	julkkalit	v
julkkihit	julkedit	v
čulkkihit	tjulkedit	v
julkkuhit	julkodit	v
jullidit	julledit	v
njullihit	njulledit	v
julmmagit	julmagit	v
jumaidit	jumájdit	v
jumihit	jumedit	v
juohkádit	juohkádit	v
juokŋadit	juogŋadit	v
njuolgahit	njuolggadit	v
njuolggadit	njuolgadit	v
juolgguštit	juolgosjtit	v
juonastit	juonastit	v
juorbbuhit	juorbodit	v
juorbbádit	juorbádit	v
juorbulit	juorbbolit	v
juorrudit	juorrodit	v
juotnidit	juodnedit	v
juovssahit	juovsadit	v
juovzudit	juovttsodit	v
juovzzihit	juovtsedit	v
juovzzuhit	juovtsodit	v
juovzzádit	juovtsádit	v
juođahit	juodadit	v
juraidit	jurájdit	v
šuraidit	sjurájdit	v
jurddahit	jurdadit	v
jurddašit	jurdatjit	v
jurdilit	jurddelit	v
jurihit	juredit	v
jurssastit	jursastit	v
jurssistit	jursestit	v
juskalit	jusskalit	v
juskkuhit	juskodit	v
jutnošit	judnutjit	v
juvdudit	juvddodit	v
juvzzodit	juvtsudit	v
jáhkuhit	jáhkodit	v
jálddošit	jáldutjit	v
jálddudit	jáldodit	v
jálosmit	jálusmit	v
jápmásit	jábmásit	v
játnadit	jádnadit	v
játtihit	játtedit	v
jávkkehit	jávkidit	v
jávkkihit	jávkedit	v
jávkkodit	jávkudit	v
keamppasmit	kiempasmit	v
keamppašit	kiempatjit	v
kievrudit	kievrrodit	v
koaillagit	koajllagit	v
koailluhit	koajllodit	v
koailáhit	koajládit	v
koailánit	koajlánit	v
koasttidit	koastedit	v
konstošit	kånsstutjit	v
koŋkehit	kåŋkkidit	v
koŋkánit	kåŋkkånit	v
kruvnnidit	kruvnedit	v
kuhciidit	kuhtsijdit	v
kumppo7stit	kumpostit	v
kumppustit	kumpostit	v
kumppo7stit	kumpostit	v
kumppustit	kumpostit	v
kunniidit	kunnijdit	v
kuohcagit	kuohtsagit	v
kuohce7hit	kuohtsedit	v
kuohcildit	kuohtseldit	v
kuohcistit	kuohtsestit	v
kuonnagit	kuonnagit	v
kuorranit	kuorranit	v
labbanit	labbanit	v
ladnjedit	laddnjidit	v
ladnjestit	laddnjistit	v
lahpasit	lahpasit	v
lahppasit	lahppasit	v
lahttudit	lahttodit	v
laigadit	lajggadit	v
laigasit	lajggasit	v
laiggihit	lajgedit	v
laiggodit	lajgudit	v
lakkihit	lakkedit	v
laktasit	laktasit	v
laktásit	laktásit	v
lamagit	lamágit	v
lanjahit	lanjádit	v
lapmudit	labmodit	v
laskadit	lasskadit	vw
lasmmihit	lasmedit	v
lađaidit	ladájdit	v
lađgalit	lárggalit	v
lađggihit	largedit	v
lađggiidit	largijdit	v
lađggistit	largestit	v
laššásmit	lassjásmit	v
leabastit	liebastit	v
leabbahit	liebbadit	v
leabbanit	liebbanit	v
leahkastit	tsakkastit	vw
leahkkasit	tsakkasit	vw
leaicidit	liejttsedit	v
leaikasit	lassjkasit	vw
leaikkastit	liejkastit	v
leaikkuhit	liejkodit	v
leaissagit	liejsagit	v
leamssihit	liemsedit	v
leanddašit	liendatjit	v
leanzzagit	lientsagit	v
leappagit	lieppagit	v
leappe7hit	lieppedit	v
leappuhit	lieppodit	v
leatnjásit	lædnjásit	v
leavgge7hit	lievgedit	v
leađgalit	lierggalit	v
šleađgalit	slierggalit	vw
leađgge7hit	sliergedit	vw
leađggihit	sliergedit	vw
šleađgge7hit	sliergedit	vw
šleađggihit	sliergedit	vw
leađgge7hit	liergedit	vw
leađggihit	liergedit	vw
šleađgge7hit	sliergedit	vw
šleađggihit	sliergedit	vw
lehehit	lehidit	v
lehttohit	lehttudit	v
leháhit	lehádit	v
leikehit	lejkkidit	v
leikestit	lejkkistit	v
leikošit	lejkkutjit	v
leppodit	leppudit	v
leŋgestit	leŋggistit	v
lidnestit	liddnistit	v
liehmudit	liehmodit	v
liehppadit	liehppadit	v
liekkihit	liekkedit	v
liekkistit	liekkestit	v
liekđasit	liektjasit	v
liekđásit	liektjásit	v
liemastit	liemastit	v
lienjádit	lienjádit	v
lievllistit	lievlestit	v
lieškkihit	liesjkedit	v
lihkadit	lihkadit	v
lihkahit	lihkadit	v
lihkadit	lihkadit	v
lihkahit	lihkadit	v
lihkastit	lihkastit	v
lihke7stit	lihkestit	v
lihkkasit	lihkkasit	v
lihkkidit	lihkkedit	v
lihkkohit	lihkkudit	v
lihttoláigohit	lihttulájgodit	v
liirrustit	lijrrostit	v
likkiidit	likkijdit	v
likkosmit	likkusmit	v
liktedit	liktidit	v
liktestit	liktistit	v
liktudit	liktodit	v
lilluhit	lillodit	v
liluhit	lilodit	v
limškkagit	limsjkagit	v
limškkistit	limsjkestit	v
linccagit	lintsagit	v
šlinzzagit	slintsagit	v
linccahit	lintsadit	v
linccuhit	lintsodit	v
liniidit	linijdit	vw
linistit	linestit	vw
linjagit	linjágit	v
linjodit	linjudit	v
linásmit	linásmit	v
lisistit	lisestit	v
litnudit	lidnodit	v
livvohit	livudit	vw
livvudit	livodit	vw
livhnnodit	livhnnudit	v
livjáhit	livjjádit	v
livkkuhit	livkodit	v
livkáhit	livkkádit	v
livttásmit	livtásmit	v
livttášit	livtátjit	v
livvudit	livvodit	vw
livzzistit	livtsestit	v
livššadit	livsjadit	v
livššastit	livsjastit	v
livššodit	livsjudit	v
livššuhit	livsjodit	v
livžžardit	livtjardit	v
livžžastit	livtjastit	v
livžžodit	livtjudit	v
livžžádit	livtjádit	v
liđggastit	lirgastit	v
liđiidit	lidijdit	v
liđmmagit	lirmagit	v
liđmmodit	lirmudit	v
liđpmagit	lidpmagit	v
liđpmodit	lidpmudit	v
liđvvagit	lirvagit	v
liđvvistit	lirvestit	v
liŋgalit	liŋggalit	v
liŋggustit	liŋgostit	v
liškasit	lissjkasit	v
liškkihit	lisjkedit	v
loaggánit	loaggánit	v
loahke7hit	loahkedit	v
šloahkihit	sloahkedit	v
loahpahit	loahpadit	v
loahppa#meannudit	loahppamiennodit	v
loahttudit	loahttodit	v
loaiddadit	loajdadit	v
loaiddastit	loajdastit	v
ovdan#loaiddastit	åvddånloajdastit	v
loakkagit	loakkagit	v
loaktalit	loaktalit	v
loaktilit	loaktelit	v
loanahit	lånadit	v
loanidit	loanedit	v
loanášit	loanátjit	v
loapmagit	loabmagit	v
loarffuhit	loarfodit	v
loarfulit	loarffolit	v
loarfánit	loarffánit	v
loasastit	låsastit	v
loavddašit	loavdatjit	v
loavdudit	loavddodit	v
loavkidit	loavkkedit	v
loavkkistit	loavkestit	v
loavuhit	loavodit	v
loađđadit	loattjadit	v
loaškkuhit	loasskodit	vw
loažžadit	loadtjadit	v
lobidit	loabedit	vw
lodjudit	lådjodit	vw
lodnjáhit	låddnjådit	v
lodnjánit	låddnjånit	v
logahalahit	lågådalladit	vw
logaldit	lågådit	vw
loggásit	njallasit	v
lohkkadit	lássit	v
lohkkádit	lássit	v
lohkkadit	lássit	v
lohkkádit	lássit	v
lohkuhit	låhkodit	v
lohppehit	låhppidit	v
loikadit	låjkkådit	vw
loikkašit	låjkåtjit	vw
loikkihit	låjkedit	vw
loikkiidit	låjkijdit	vw
loiášit	låjåtjit	v
lokkastit	njallástit	v
lokkodit	njalludit	v
lokkuhit	låkkodit	v
loktanit	låktånit	v
loktestit	låktistit	v
lokŋásit	lågŋåsit	v
lonehit	lånidit	v
lonjodit	lånjudit	v
lonjuhit	lånjodit	v
losášit	låsåtjit	vw
lotkkihit	låtkkedit	v
lotkkiidit	låtkkijdit	v
lotkkodit	låtkkudit	v
lotnjudit	lådnjodit	v
lovkkiidit	låvkijdit	v
lovttadit	låvtådit	v
lovttahit	låvtådit	v
lovttadit	låvtådit	v
lozzadit	lådtsådit	v
ložžedit	lådtjidit	v
lubmedit	lubbmidit	v
luddehit	luddidit	v
luddestit	luddistit	v
lulidit	luledit	v
lulistit	lulestit	v
lumosmit	lumusmit	v
lunjaidit	lunjájdit	v
luobbahit	luobbadit	v
luogustit	luogostit	v
luohcadit	luohtsadit	v
luohpadit	luohpadit	v
luohpudit	luohpodit	v
luohđásit	luohtjásit	v
luoikalastte7stit	luojkkalastestit	v
luoillistit	luojllestit	v
luoiaidit	luojajdit	vw
luoktudit	luoktodit	v
luonjaidit	luonjajdit	v
luopmudit	luobmodit	v
luoppagit	luoppagit	v
luoskanit	luosskanit	v
luoskkagit	luoskagit	v
luotkanit	luotkanit	v
luotnudit	luodnodit	v
luovasmit	luovasmit	v
luovddašit	luovdatjit	v
luovdilit	luovddelit	v
luovdádit	luovddádit	v
luovđđahit	luovtjadit	v
luoškkagit	luosjkagit	v
luskkiidit	luskijdit	v
lusttiidit	lustijdit	v
lutkkiidit	lutkkijdit	v
lutkkosmit	lutkkusmit	v
luvdestit	luvddistit	v
luvnnjiidit	luvnjijdit	v
luđđuhit	luttjodit	v
šluđđuhit	sluttjodit	v
luŋkkagit	luŋkagit	v
šluŋkkagit	sluŋkagit	v
luŋkkahit	luŋkadit	v
šluŋkkahit	sluŋkadit	v
luŋkkistit	luŋkestit	v
šluŋkkistit	sluŋkestit	v
luŋkáhit	luŋkkádit	v
šluŋkáhit	sluŋkkádit	v
luŋkánit	luŋkkánit	v
šluŋkánit	sluŋkkánit	v
lábmehit	lábbmidit	v
ládjudit	ládjodit	v
lágastit	lágástit	v
lágiidit	lágijdit	v
láhka#mearridit	láhkamierredit	v
láhka#vuođđudit	láhkavuoddodit	v
láhkadit	láhkadit	v
láhkkodit	láhkkudit	v
láhkkostit	láhkkustit	v
láhttadit	láhttadit	v
láhttestit	láhttistit	v
láhđamastalit	láhtjamastalit	v
láibbastit	lájbastit	v
láigohit	lájggudit	vw
ovda#láigohit	åvddålájggudit	v
láigudit	lájggodit	vw
láikkášit	lájkátjit	vw
láittašit	lájtatjit	vw
láivudit	slájvvodit	v
lálláhit	lálládit	v
lálašit	lálatjit	v
lánjadit	lánjádit	v
lánjodit	lánjudit	v
lápmudit	lábmodit	v
lárbmadit	lármmadit	v
šlárbmadit	slármmadit	v
lásttidit	lástedit	v
látnjasit	ládnjasit	v
lávdadit	lávddadit	v
lávddadit	lávdadit	v
lávdadit	lávddadit	v
lávddadit	lávdadit	v
lávgge7hit	lávgedit	v
lávlestit	lávllástit	vw
lávttihit	lávtedit	v
lávžádit	lávttjádit	v
lávžžástit	lávtjástit	v
láŋkadit	láŋkkadit	v
lášmmodahttalit	lásjmudahttalit	vw
malssidit	målsodit	vw
manihit	manedit	v
marššagit	marsjagit	v
marššuhit	marsjodit	v
mastadit	masstadit	v
maŋášit	maŋatjit	vw
meaddalit	mieddalit	v
meaddádit	mæddádit	v
meafardit	miefardit	v
meahccidit	miehttsedit	vw
meahcástit	mæhtsástit	vw
meaiddašit	miejdatjit	v
meaiskidit	miejsskedit	v
mealastit	mielastit	v
mealtalit	mielltalit	v
mealádit	mæládit	v
meammagit	miemmagit	v
gearggusin#meannudit	giergosinmiennodit	v
loahppa#meannudit	loahppamiennodit	v
meannudit	miennodit	v
ášše#meannudit	ássjemiennodit	v
meargŋasit	mierŋŋasit	v
mearkadit	mierkkadit	v
mearkkahit	merkadit	vw
mearkkašit	merkatjit	vw
mearkkášit	mærkátjit	vw
mearredit	mierredit	vw
meađalditit	miedalditit	v
meađalditit	miedalditit	v
meađaldit	miedaldit	v
meađmmagit	miermagit	v
meađpmagit	miedpmagit	v
melodit	meludit	v
menodit	menudit	v
merkehit	mierkkidit	vw
meroštit	merusjtit	v
miehkástit	miehkástit	v
miehtánit	miehtánit	v
mieigasit	miejggasit	v
mieiggastit	miejgastit	v
miel#váikkuhit	mielvájkodit	v
mielddistit	mieldestit	v
mieldduhit	mieldodit	v
mielddustit	mieldostit	v
mielde7#váikkuhit	mielldevájkodit	v
mielggastit	mielgastit	v
mierkkádit	mierkádit	v
mievžžastit	mievtjastit	v
mieđuštit	miedosjtit	v
mieškalit	smiessjkalit	vw
mieškkuhit	smiesjkodit	vw
mihtidit	mihtedit	vw
mihttohit	mihttudit	v
mirkkohit	mirkudit	v
misttahit	mistadit	v
mittodit	mittudit	v
moakkagit	moakkagit	v
moalkasit	moalkkasit	v
moalkkagit	moalkagit	v
moalkkardit	moalkardit	v
moallanit	smållanit	vw
moarddašit	moardatjit	vw
moarrasit	moarrasit	v
moarrudit	moarrodit	v
moarránit	moarránit	v
moaráskit	moaráskit	v
moađaidit	mådajdit	v
moađgalit	moarggalit	v
moccáskit	måttsåskit	v
moddjádit	måddjådit	v
moddjilit	måddjelit	v
moggidit	måggedit	v
smoggidit	småggedit	v
mohtudit	måhtodit	v
moiddodit	måjdudit	vw
moivváskit	måjvåskit	v
mokkirdit	måkkerdit	v
mokkáskit	måkkåskit	v
moljastit	måljjåstit	v
moljádit	måljjådit	v
mollanit	smållånit	vw
smollanit	smållånit	vw
molsasit	målssåsit	v
molssastit	målsåstit	vw
molžžardit	måltjårdit	v
moraštit	måråsjtit	v
morihit	måredit	v
morranit	mårijdit	v
morránit	mårijdit	v
morranit	mårijdit	v
morránit	mårijdit	v
moskkosmit	måskusmit	v
moskkudit	måskodit	v
mosttagit	måstågit	v
movttiidit	måvtijdit	vw
movttáskit	måvtåskit	v
mozzasit	mådtsåsit	vw
mozzidit	mådtsedit	v
muddehit	muddidit	v
muhraidit	muhrajdit	v
muittašit	mujtatjit	vw
muittuhit	mujtodit	v
mukkagit	mukkagit	v
mukkiidit	mukkijdit	v
muktalit	muktalit	v
muktosit	muktusit	v
mulggastit	mulgastit	v
mulggodit	mulgudit	v
mulggádit	mulgádit	v
muljardit	muljjardit	v
mulđđihit	multjedit	v
munahit	munádit	v
muohtašit	muohtatjit	v
muoládit	muoládit	v
muossánit	muossánit	v
muosvvistit	muosvvestit	v
muosáhit	muosádit	v
muotkkuhit	muotkkodit	v
muovjádit	muovjjádit	v
muozastit	muotsastit	v
murjedit	murjjidit	v
murkkudit	murkodit	vw
mutkkodit	mutkkudit	v
muttardit	muttardit	v
muđaldit	mudáldit	v
máddánit	máddánit	v
máguhit	mágodit	v
máhccadit	máhttsadit	vw
máhttáhit	máhttádit	v
máihlliidit	májhlijdit	v
máinnašit	májnatjit	v
máinnustit	májnostit	v
máizadit	májttsadit	v
máizziidit	májtsijdit	v
máizzistit	májtsestit	v
máladit	máládit	v
málestit	mállistit	vw
málistit	málestit	vw
mánidit	mánedit	v
máraidit	márájdit	v
márffodit	márfudit	vw
márihit	gurgijdit	vw
márkan#fievrridit	márnánahttedit	vw
mátkkašit	manatjit	vw
mátkkaštit	manatjit	v
mátkkoštit	mátkkusjtit	v
máttahit	máttadit	v
mávssahit	mávsadit	vw
máŋganit	máŋgganit	v
máŋgehit	máŋggidit	v
naddjodit	naddjudit	v
naffagit	naffagit	v
nagodit	nagádit	vw
nahke7hit	nahkedit	v
nahkihit	nahkedit	v
nahke7hit	nahkedit	v
nahkihit	nahkedit	v
nahkášit	nahkátjit	v
naigalit	næjkkalit	vw
naiggistit	skielbestit	vw
naigguhit	næjkodit	vw
nakšalit	naksjalit	v
nallasit	nallasit	v
nallosit	nallusit	v
namahit	nammadit	v
namuhit	nammadit	v
nannudit	nannunit	vw
nanosmit	nanusmit	v
nanošit	nanutjit	v
nanustit	nanostit	vw
narggašit	nargatjit	vw
naskke7stit	naskestit	v
navddašit	navdatjit	v
navššihit	navsjedit	v
navššuhit	navsjodit	v
nađđadit	naddadit	v
nealggášit	nælgátjit	v
nealgudit	nælggodit	vw
nearranit	nierranit	v
neaskkašit	nieskatjit	vw
neavrudit	nievrrodit	vw
neavttadit	nievtadit	v
neavttašit	nievtatjit	v
neavvuhit	nievvodit	v
neavzzuhit	nievtsodit	v
negosmit	negusmit	v
nevrošit	nevrrutjit	v
nevvodit	nevvudit	v
nevzzodit	nevtsudit	v
niehkudit	niehkodit	v
nieiadit	niejadit	v
nieiahit	niejadit	v
nieiadit	niejadit	v
nieiahit	niejadit	v
nihlaidit	nihlajdit	v
nihlistit	nihlestit	v
niibbástit	nijbástit	vw
niktalit	niktalit	v
nilkkistit	nilkestit	vw
nimmardit	njimmardit	vw
nimmordit	njimmurdit	vw
nimmurdit	njimmordit	vw
nimmorit	njimmurit	vw
nimmordit	njimmurdit	vw
nimmurdit	njimmordit	vw
nirppagit	nirpagit	v
nirppihit	nirpedit	v
nirvahit	nirvvadit	v
nirvvahit	nirvadit	v
nisttihit	nistedit	v
nistásit	nisstásit	v
nisádit	snisádit	vw
nivkalit	nivkkalit	v
nivkkádit	nivkádit	v
nivssihit	nivsedit	v
njabagit	njabágit	v
njabirdit	njaberdit	v
njagagit	njagágit	v
njaguštit	njagosjtit	v
njahkalit	njáhkalit	vw
njahpasit	njahpasit	vw
njahpastit	njahpastit	v
njahpe7stit	njahpestit	v
njahpistit	njahpestit	v
njahpe7stit	njahpestit	v
njahpistit	njahpestit	v
njahppasit	njahppasit	v
njakđasit	njaktjasit	v
njalddašit	njaldatjit	v
njalgge7hit	njalgedit	v
njalggihit	njalgedit	v
njalgge7hit	njalgedit	v
njalggihit	njalgedit	v
njalggiidit	njalgijdit	v
njalkkastit	njalkestit	vw
njalpalit	njalppalit	v
njalppagit	njalpagit	v
njalppe7hit	njalpedit	v
njalppihit	njalpedit	v
njalppe7hit	njalpedit	v
njalppihit	njalpedit	v
njalssagit	njalsagit	v
njalssuhit	njalsodit	v
njaláhastalit	njaláhastalit	v
njalđđidit	njaltjedit	v
njammedit	njamadit	vw
njammadit	njamadit	vw
njammasit	njammasit	vw
njartadit	njarttadit	v
njarvvagit	njarvagit	v
šnjarvvagit	snjarvagit	v
njarvvuhit	njarvodit	v
šnjarvvuhit	snjarvodit	v
njaskasit	njasskasit	v
njavggodit	njávgudit	vw
njavgguhit	njávgodit	vw
njavkkihit	snjuvkedit	vw
njavkkiidit	snjuvkijdit	vw
njavđđagit	njavtjagit	v
njavđđihit	njavtjedit	v
njavđđuhit	njavtjodit	v
njađašit	njadatjit	vw
njaŋgahit	njaŋggadit	v
njaŋgalit	njaŋggalit	v
njaŋgasit	njaŋggasit	v
njaŋggagit	njaŋgagit	v
njaŋggardit	njaŋgardit	v
njaŋggihit	njaŋgedit	v
njaŋggiidit	njaŋgijdit	v
njaŋggirdit	njaŋgerdit	v
njaŋggistit	njaŋgestit	v
njaŋgguhit	njaŋgodit	v
njeaccagit	njiettsagit	vx have to check!
njeaccahit	njiettsadit	vx have to check!
njeaccistit	njiettsestit	v
njeaccuhit	njiettsodit	v
njeaidalit	njiejddalit	v
njeakcasit	njiektsasit	v
njealljánit	njælljánit	vw
njeavccagit	njievttsagit	v
njeazzahit	njiedtsadit	v
njeazzasit	njiedtsasit	v
njeađgasit	njierggasit	v
njeađggáskit	njærgáskit	v
njeaššagit	njiessjagit	v
njeccodit	njettsudit	v
njiedjalit	njiedjalit	v
njiehcadit	njiehtsadit	v
njieiadit	njiejadit	v
njieiahit	njiejadit	v
njieiadit	njiejadit	v
njieiahit	njiejadit	v
njiekkastit	njiekkastit	v
njiellasit	njiellasit	vw
njieládit	njiellalit	vw
njigaidit	njigájdit	v
njigádit	njigádit	v
njilkalit	njilkkalit	v
njimaidit	njimájdit	v
njire7štit	njiresjtit	v
njirištit	njiresjtit	v
njirgalit	njirggalit	v
njirgehit	njirggidit	v
njire7štit	njiresjtit	v
njirištit	njiresjtit	v
njirttastit	njirtastit	v
njiskkastit	njiskastit	v
njivkkihit	njivkedit	v
njivkkádit	njivkádit	v
njivlidit	njivlledit	v
njivllihit	njivledit	v
njivllistit	njivlestit	v
njivžulit	njivttjolit	v
njivžžardit	njivtjardit	v
njivžžastit	njivtjastit	v
njivžžihit	njivtjedit	v
njivžžodit	njivtjudit	v
njivžžádit	njivtjádit	v
njoahcudit	njoahtsodit	v
njoalccagit	njoaltsagit	v
šnjoalccagit	snjoaltsagit	v
njoalpalit	njoalppalit	v
njoalppagit	njoalpagit	v
njoalppe7hit	njoalpedit	v
njoalppihit	njoalpedit	v
njoalppe7hit	njoalpedit	v
njoalppihit	njoalpedit	v
njoamihit	njoamedit	v
njoammasit	njoammasit	v
njoammudit	njoammodit	v
njoammásit	njoammásit	v
njoamádit	njoamádit	v
njoaro7stit	njoarostit	v
njoaskkihit	njoaskedit	v
njoavgalit	njoavggalit	v
njoavggistit	njoavgestit	v
njoazášit	njoatsátjit	v
njoađvudit	njoarvvodit	v
njoađvvagit	njoarvagit	v
njoađvvasmit	njoarvasmit	v
njoiddosmit	njåjdusmit	v
njokkardit	njåkkårdit	v
njolggiidit	njålgijdit	v
njolgidit	njålggedit	v
njolvvagit	njålvågit	v
njolvvihit	njålvedit	v
njorrehit	njårridit	v
njorrestit	snjoarristit	vw
njovggiidit	njåvgijdit	v
njozastit	njåtsåstit	v
njozádit	njåtsådit	v
njuikehit	njujkkidit	v
njuikestit	njujkkistit	v
njuikkodit	njujkudit	v
njuikko7hit	njujkodit	v
njuikkuhit	njujkodit	v
njuikko7hit	njujkodit	v
njuikkuhit	njujkodit	v
njuikulit	njujkkolit	v
njulgehit	njulggidit	v
njulggodit	njulgudit	v
njullihit	njulledit	v
njune7#vuolástit	njunevuolástit	v
njunnádit	njunnádit	v
njunuhit	njunodit	v
njuoggahit	njuoggadit	v
njuoggasit	njuoggasit	v
šnjuoggasit	snjuoggasit	v
njuohkánit	njuohkánit	v
njuohkásit	njuohkásit	v
njuohtasit	njuohtasit	v
njuokkagit	njuokkagit	v
šnjuokkagit	snjuokkagit	v
njuokkardit	njuokkardit	v
šnjuokkardit	snjuokkardit	v
njuolastit	njuolastit	v
njuolgge7hit	njuolgedit	v
njuolggo#muitalit	njuolgomujttalit	v
njuolvvagit	njuolvagit	v
njuorbasit	njuorbbasit	v
njuordasit	njuorddasit	v
njuordásit	njuorddásit	v
njuorradit	njuorradit	v
njuorvadit	njuorvvadit	v
njuorvvagit	njuorvagit	v
njuorššagit	njuorsjagit	v
njuoskke7hit	njuoskedit	vw
njuoskkihit	njuoskedit	vw
njuoskke7hit	njuoskedit	vw
njuoskkihit	njuoskedit	vw
njuoskkistit	njuoskestit	v
njuovildit	njuoveldit	v
njuovđđa#lahkástit	njuovtjalahkástit	v
njurggodit	snjurgudit	vw
njurggádit	snjurgádit	vw
njuskkiidit	njuskijdit	v
njuvddadit	njuvdadit	v
njuvddašit	njuvdatjit	v
njágadit	njágádit	v
njágahit	njágádit	v
njágadit	njágádit	v
njágahit	njágádit	v
njáiggosmit	njájgusmit	v
njáiggošit	njájgutjit	v
njáikkagit	njájkagit	v
njálbmadit	njálmmadit	v
njálgudit	njálggodit	vw
njálmmardit	njálmardit	v
njálmmuštit	njálmostit	vw
njámmodit	njámmudit	v
njámastit	njámastit	vw
njámmasit	njámmasit	vw
njámmastit	njámastit	vw
njárbbášit	njárbátjit	v
njáskasit	njásskasit	v
njávggádit	njávgádit	vw
njávkkistit	njávkestit	v
njáđášit	njádátjit	v
njáđđudit	njáddodit	v
njáŋgalit	njáŋggalit	v
njáŋgasit	njáŋggasit	v
njáŋggihit	njáŋgedit	v
njáŋggiidit	njáŋgijdit	v
njáŋggistit	njáŋgestit	v
njáškalit	njássjkalit	v
njáškkuhit	njásjkodit	v
noaiddástit	noajdástit	vx have to check
noarvádit	noarvvádit	v
noastalit	noasstalit	v
noastáhit	noasstádit	v
noastásit	noasstásit	v
noavkalit	noavkkalit	v
noavkkastit	noavkastit	v
noavkkuhit	noavkodit	v
noavkkádit	noavkádit	v
noađo7štit	noadosjtit	v
noađuštit	noadosjtit	v
noađo7štit	noadosjtit	v
noađuštit	noadosjtit	v
noađáskit	noadáskit	v
noađástit	noadástit	v
noađđádit	noaddádit	v
nogihit	någedit	v
nohke7stit	nåhkestit	v
nohkihit	nåhkedit	v
nohkkadit	nåhkkådit	v
noidošit	nåjdutjit	vw
nollagit	nållågit	v
nollihit	nålledit	v
nolliidit	nållijdit	v
nordasit	nårddåsit	vw
norkkagit	nårkågit	v
noskkašit	nåskåtjit	v
notkasit	nåtkåsit	v
nođđuditit	nåddoditit	v
nuhkkalit	nuhkkalit	v
nuhkuštit	nuhkosjtit	v
nuissodit	nujsudit	v
nullosit	nullusit	v
nulppagit	nulpagit	v
nuohtástit	nuohtástit	v
nuolludit	nuollodit	vw
nuondadit	nuonddadit	v
nuorasmit	nuorasmit	v
nuorašit	nuoratjit	v
nuorbasit	nuorbbasit	v
nuorbbastit	nuorbastit	v
nuoskidit	nuosskedit	v
nuoskkášit	nuoskátjit	v
nuoskudit	nuosskodit	v
nuossadit	nuossadit	v
nurddagit	nurdagit	v
nurridit	nurredit	v
nurssagit	nursagit	v
nurššagit	nursjagit	v
nurššihit	nursjedit	v
nuskošit	nusskutjit	v
nuvkalit	nuvkkalit	v
nuvkkihit	nuvkedit	v
nábárdit	náberdit	vw
náddjodit	náddjudit	v
nádjasit	nádjasit	v
náhkkádit	náhkkádit	v
náiggistit	nájgestit	v
náitalit	nájttalit	v
náiadit	nájádit	v
nákkáskit	nákkáskit	v
náladit	náládit	v
nállasit	nállasit	v
nárpmastit	nármastit	v
nárridit	nárredit	v
nárvvagit	nárvagit	v
nárvvodit	nárvudit	v
náskodit	násskudit	v
návdulit	návddolit	v
náđđadit	náddadit	v
náđđahit	náddadit	v
náđđadit	náddadit	v
náđđahit	náddadit	v
náđđudit	náddodit	v
oaddudit	oaddodit	v
oaggasit	oaggasit	v
njoahcudit	njoahtsodit	vw
oahcudit	oadjodit	vw
loahpahit	låhpadit	vw
oahpadit	åhpadit	vw
oahpahit	åhpadit	vw
soahpadit	såbadit	vw
loahpahit	låhpadit	vw
oahpadit	åhpadit	vw
oahpahit	åhpadit	vw
soahpadit	såbadit	vw
oahpásmit	oahpásmit	v
oaidnalit	vuojnnalit	vw
oainnašit	vuojnatjit	vw
oainnihit	vuojnedit	vw
oaittáskit	oajtáskit	v
oaivvadit	åjvadit	vw
oaivvildit	árvvedit	vw
boakkastit	boakkastit	v
oakkastit	oakkostit	vw
oalgguhit	alodit	vw
oalistit	goalestit	vw
oamásmit	oamásmit	vx have to check
oamášit	oamátjit	v
loanášit	loanátjit	v
oanášit	oanátjit	v
oardnjudit	oarnnjodit	v
oasse7#ruhtadit	oasseruhtadit	v
noastalit	noasstalit	v
oastalit	oasstalit	vw
oasttašit	åstatjit	vw
oasuhit	oasodit	v
oasástit	oasástit	v
oatnánit	oadnánit	v
oavnnjildit	oavnjeldit	v
oavnnjistit	oavnjestit	v
oazistit	oatsestit	v
oađđástit	oattjástit	v
oažžasit	oadtjasit	v
hobehit	håbidit	v
obehit	åbidit	v
odjodahttalit	ådjudahttalit	v
ogohahttalit	åguhahttalit	v
ohpehit	åhpidit	v
oidnostit	vuojnnustit	vw
oktedit	sjierridit	vw
loktestit	låktistit	v
oktestit	sjierristit	vw
oktii7#heivehit	åktij7hejvvidit	v
oktii#vástidit	åktijvásstedit	v
golahit	gålådit	vw
lolahit	lålådit	vw
moladit	målådit	vw
olahit	ålådit	vx have to check
oláhit	ålådit	vx have to check
olgehit	ålggidit	v
olggos#golludit	ålgusgållodit	v
olgguštit	ålgosjtit	v
olgodit	ålggudit	v
ollalit	ållålit	v x have to check
ollistit	ållistit	vw
golahit	gålådit	v
lolahit	lålådit	v
moladit	målådit	v
olahit	ålådit	v
oláhit	ålådit	v
omardit	åmårdit	v
onddodit	åndudit	v
oppastit	åppåstit	v
oppašit	åppåtjit	v
ordnedit	årnnidit	v
ortnet#ráŋggáštit	årnitráŋgásjtit	v
ortniidit	årnijdit	v
ovda#láigohit	åvddålájggudit	v
dovdáhit	dåvddådit	v
govdadit	gåvddådit	v
ovdadit	goavsodit	vw
ovdan#loaiddastit	åvddånloajdastit	v
ovdan#đáie7hit	åvddåntjájedit	v
ovddas#vástidit	åvdåsvásstedit	vw
ovddeštit	ådåstahttet	vw
ovdduštit	ådåstahttet	vw
bovdehit	båvddidit	v
ovdehit	åvddidit	v
ovehit	åvidit	v
ovttaidit	åvtåjdit	v
ovttastit	åvtåstit	v
gođahit	gådådit	v
ođadit	ådåstit	vw
ođasmit	ådåstit	vw
jođašit	jådåtjit	vw
ođašit	ådåtjit	vx have to check
ođđa#đalmmagastalit	åddåtjalmagastalit	v
ožoldit	åtjuldit	vx have to check
ožžodit	guoddudit	vw
pievladit	bievlladit	vw
pievlladit	bievladit	vw
pievladit	bievlladit	vw
pievlladit	bievladit	vw
piinnidit	bijnedit	vw
prentedit	prienntidit	vw
prentehit	prienntidit	vw
prentedit	prienntidit	vw
prentehit	prienntidit	vw
rabaidit	rabmadit	vw
rabe7stit	rabástit	vw
rabistit	ramástit	vw
rabe7stit	rabástit	vw
rabistit	ramástit	vw
rabihit	ramástit	v
ragihit	ragedit	v
raguhit	ragodit	v
rahkánit	rahkánit	v
rahpastit	rahpastit	v
rahppasit	rahppasit	v
rahpášit	rahpátjit	v
ramppuhit	rampodit	v
ramsalit	rabmalit	vw
ramssihit	rimssodit	vx have to check
rasildit	raseldit	v
rasttidit	rasstedit	vx have to check
rasttildit	rasteldit	vx have to check
ravdadit	ravddadit	v
ravgadit	ravgadit	vw
ravggadit	ravgadit	v
ravggihit	ravgedit	v
ravkkihit	ravkedit	v
ravkkuhit	ravkodit	v
ravđđuhit	ravtjodit	v
raŋgalit	raŋggalit	v
raŋggagit	raŋgagit	v
raŋggihit	raŋgedit	v
raŋgádit	raŋggádit	v
raŋihit	raŋedit	v
raŋistit	raŋestit	v
rašášit	rasjátjit	v
raššudit	rasjodit	vw
ražáskit	ratjáskit	v
reaggánit	ræggánit	v
reahccalit	riehttsalit	v
reahidit	riehedit	v
reahjidit	riehjedit	v
reahttadit	riehttadit	v
reakđanit	riektjanit	v
realssistit	rielsestit	v
reanttidit	rientedit	v
reavggádit	rievgedit	vw
reavžalit	rievttjalit	v
reavžžagit	rievtjagit	v
reavžžuhit	rievtjodit	v
reaškkihit	riesjkedit	v
reidestit	rejddistit	v
reikedit	rejkkidit	v
reimmodit	rejmudit	v
rekđohit	rektjudit	v
prentedit	prienntidit	vw
prentehit	prienntidit	vw
rentedit	renttidit	v
rentehit	renttidit	v
prentedit	prienntidit	vw
prentehit	prienntidit	vw
rentedit	renttidit	v
rentehit	renttidit	v
ribihit	ribádit	vw
riccagit	rittsagit	vx
ridnahit	riddnadit	v
riehkadit	riehkadit	v
riehkidit	riehkedit	v
riehtudit	riehtodit	v
rieibmudit	riejmmodit	v
rieiihit	riejjdit	v
rieiádit	riejádit	v
rieiáskit	riejáskit	v
riekkistit	riekkestit	v
riektadit	riektadit	v
rievidit	rievedit	v
rievttašit	rievtatjit	v
riežihit	rietjedit	v
riežádit	rietjádit	v
riggudit	riggodit	v
riggulit	riggolit	v
rihkkasit	rihkkasit	v
rihkkuhit	rihkkodit	v
rihko7stit	rihkostit	v
rihkustit	rihkostit	v
rihko7stit	rihkostit	v
rihkustit	rihkostit	v
rihpastit	rihpastit	v
rihpašit	rihpatjit	v
rihpihit	rihpedit	v
rihppasit	rihppasit	v
rihppulit	rihppolit	v
rihđiidit	rihtjijdit	v
riiddáskit	rijdáskit	v
riimmostit	rijmustit	v
rikkášit	rikkátjit	v
rimssagit	rimsagit	v
rimssistit	rimsestit	v
rimssodit	rimsudit	v
rimssuhit	rimsodit	v
rimssustit	rimsostit	v
rimškkagit	rimsjkagit	v
rinđđagit	rinttjagit	v
rinđđistit	rinttjestit	v
rinžžistit	rintjestit	v
risttahit	ristadit	v
risttašit	ristatjit	v
ritnudit	ridnodit	v
rivdnjalit	rivnnjalit	v
rivnnjuhit	rivnjodit	v
rivzzagit	rivtsagit	v
rizagit	ritságit	v
rizihit	ritsedit	v
riđeštit	ridisjtit	v
riđđudit	riddodit	v
riŋgestit	riŋggistit	v
rišadit	risjádit	v
rišaidit	risjájdit	v
rišihit	risjedit	v
riškalit	rissjkalit	v
riškkihit	risjkedit	v
riškkuhit	risjkodit	v
riššudit	rissjodit	v
roabihit	roabedit	v
roahkadit	roahkadit	v
roahkasmit	roahkasmit	v
roahkastit	roahkastit	v
roahkkasit	roahkkasit	v
roahpihit	roahpedit	v
roahppánit	roahppánit	v
roaibbagit	roajbagit	v
roaibbádit	roajbádit	v
roaiskalit	roajsskalit	v
roaiskkagit	roajskagit	v
roaiskkuhit	roajskodit	v
roaivalit	roajvvalit	v
roaivvastit	roajvastit	v
roakđanit	roaktjanit	v
roakđasit	roaktjasit	v
roamssihit	roamsedit	v
roamššagit	roamsjagit	v
roanccagit	roantsagit	v
roanžžagit	roantjagit	v
roavnnjuhit	roavnjodit	v
roavvudit	roavvodit	v
roavádit	roavádit	v
roavđđagit	roavtjagit	v
roađđahit	roaddadit	v
roađđidit	roaddedit	v
roaŋkahit	roaŋkkadit	v
roaŋkanit	roaŋkkanit	v
roaškkagit	roasjkagit	v
roaškke7hit	roasjkedit	v
roaškkihit	roasjkedit	v
roaškke7hit	roasjkedit	v
roaškkihit	roasjkedit	v
roaškkuhit	roasjkodit	v
robmahit	råbbmådit	v
rodjadit	rådjådit	v
rohcošit	råhtsutjit	v
rohkkáhit	råhkkådit	v
rohtiidit	råhtijdit	v
rokđehit	råktjidit	v
romášit	råmåtjit	v
ropmudit	råbmodit	v
rosvudit	råsvodit	v
rotnudit	rådnodit	v
rožagit	råtjågit	v
ruccistit	ruttsestit	v
ruddudit	ruddodit	v
rufaiditit	rufájditit	v
rugáhit	rugádit	v
ruibbagit	rujbagit	v
ruibbuhit	rujbodit	v
ruibbádit	rujbádit	v
ruivalit	rujvvalit	v
ruivvagit	rujvagit	v
ruivváskit	rujváskit	v
ruiosmit	rujusmit	v
rullehit	rullidit	v
rumššagit	rumsjagit	v
runaidit	runájdit	v
runddihit	rundedit	v
runiidit	runijdit	v
runodit	runudit	v
ruodjadit	ruodjadit	v
ruohkkasit	ruohkkasit	v
ruohte7stit	ruohtestit	v
ruoibbagit	ruojbagit	v
ruoibbuhit	ruojbodit	v
ruoibbádit	ruojbádit	v
ruoidnadit	ruojnnadit	v
ruoinnašit	ruojnatjit	v
ruoiusmit	ruojosmit	v
ruoksahit	ruoksadit	v
ruonihit	ruonedit	v
ruossanit	ruossanit	v
ruossuhit	ruossodit	v
ruovddástit	ruovdástit	v
ruovdádit	ruovddádit	v
ruovggádit	ruovgádit	v
ruovssihit	ruovsedit	v
ruovssildit	ruovseldit	v
ruovssuhit	ruovsodit	v
ruoškalit	ruossjkalit	v
ruoškkuhit	ruosjkodit	v
ruožihit	ruotjedit	v
ruppodit	ruppudit	v
ruskestit	russkistit	v
ruttagit	ruttagit	v
ruttidit	ruttedit	v
ruvaštit	ruvasjtit	v
ruvgalit	ruvggalit	v
ruvgánit	ruvggánit	v
kruvnnidit	kruvnedit	v
ruvnnidit	ruvnedit	v
ruvssodit	ruvsudit	v
ruvžžuhit	ruvtjodit	v
ruđđagit	ruttjagit	v
ruđđistit	ruttjestit	v
ruđgalit	rurggalit	v
ruđodit	rududit	v
ruđuhit	rudodit	v
ruŋkkistit	ruŋkestit	v
ruššudit	russjodit	v
rábastit	rábástit	v
rábidit	rábedit	v
rábmehit	rábbmidit	v
rábo7stit	rábostit	v
rábustit	rábostit	v
rábo7stit	rábostit	v
rábustit	rábostit	v
rábádit	rábádit	v
ráfuhit	ráfodit	v
ráfáidit	ráfájdit	v
rágadit	rágádit	v
rágádit	rágádit	v
rágeštit	rágisjtit	v
rággalit	rággalit	v
rágadit	rágádit	v
rágádit	rágádit	v
ráhkadit	ráhkadit	v
ráhke7stit	ráhkestit	v
ráhkistit	ráhkestit	v
ráhke7stit	ráhkestit	v
ráhkistit	ráhkestit	v
ráhkkanit	ráhkkanit	v
ášše7#ráhkkanit	ássjeráhkkanit	v
ráhkásmit	ráhkásmit	v
ráhpásmit	ráhpásmit	v
ráhpášit	ráhpátjit	v
ráhtalit	ráhtalit	v
ráiddostit	rájdustit	v
ráiggidit	rájgedit	v
ráikidit	rájkkedit	v
ráillistit	rájllestit	v
stráillistit	strájllestit	v
ráinnodit	rájnudit	v
ráiskkagit	rájskagit	v
ráiskkidit	rájskedit	v
ráiskkiidit	rájskijdit	v
ráiskkistit	rájskestit	v
ráiskudit	rájsskodit	v
ráivvastit	rájvastit	v
ráiadit	rájádit	v
ráiahit	rájádit	v
ráiadit	rájádit	v
ráiahit	rájádit	v
rákkášit	rákkátjit	v
rámmehit	rámmidit	v
rámidit	rámedit	v
rámiidit	rámijdit	v
rámskkagit	rámskagit	v
rámssagit	rámsagit	v
rámškalit	rámssjkalit	v
rámškkihit	rámsjkedit	v
rámškkistit	rámsjkestit	v
rámškkodit	rámsjkudit	v
rámškkuhit	rámsjkodit	v
rámškkádit	rámsjkádit	v
rámššagit	rámsjagit	v
ránodit	ránudit	v
ránđđagit	ránttjagit	v
rápmadit	rábmadit	v
rápmustit	rábmostit	v
ráppaštit	ráppasjtit	v
rátkkašit	rátkkatjit	v
rávdadit	rávddadit	v
rávddásmit	rávdásmit	v
rávjjastit	rávjastit	v
rávásmit	rávásmit	v
rávžadit	rávttjadit	v
rávžžašit	rávtjatjit	v
rávžžildit	rávtjeldit	v
ráđđagit	ráttjagit	v
ráđahit	rádádit	v
ráđaidit	rádájdit	v
ráđastit	rádástit	v
ráđistit	rádestit	v
ráđđidit	ráddedit	v
ortnet#ráŋggáštit	årnitráŋgásjtit	v
ráŋggáštit	ráŋgásjtit	v
ráškalit	rássjkalit	v
ráškkihit	rásjkedit	v
rášudit	rásjodit	v
rážžadit	rádtjadit	v
saddjehit	saddjidit	v
cagahit	tsagádit	v
sagadit	sagádit	v
sagahit	sagádit	v
cagahit	tsagádit	v
sagadit	sagádit	v
sagahit	sagádit	v
cahkiidit	tsahkijdit	v
sahkiidit	sahkijdit	v
saidnadit	sajnnadit	v
sainnahit	sajnadit	v
saiustit	sajostit	v
saiuštit	sajosjtit	v
saiásmit	sajásmit	v
salkalit	salkkalit	v
salkasit	salkkasit	v
salkkihit	salkedit	v
salkkuhit	salkodit	v
salodit	saludit	v
salodit	saludit	v
saluhit	salodit	v
samaidit	samájdit	v
sartudit	sarttodit	v
satnjasit	sadnjasit	v
savdadit	savddadit	v
savdnjilit	savnnjelit	v
savkalit	savkkalit	v
savkkuhit	savkodit	v
savnnjašit	savnjatjit	v
savnnjihit	savnjedit	v
ciebahit	tsiebadit	v
seabadit	siebadit	v
seaggudit	sieggodit	v
seaguhit	siegodit	v
seagáskit	sægáskit	v
seahkanit	siehkanit	v
seahkidit	siehkedit	v
seahkánit	sæhkánit	v
seailluhit	siejllodit	v
seailudit	siejlodit	v
seaivalit	siejvvalit	v
seaivvuhit	siejvodit	v
seaivvádit	sæjvádit	v
seakkášit	sækkátjit	v
seakŋudit	siegŋodit	v
sealgadit	sielggadit	v
sealggahit	sielgadit	v
sealgádit	sælggádit	v
seallasit	siellasit	v
seanadit	sienadit	v
searggihit	siergedit	v
searvidit	siervvedit	v
searvvadit	siervadit	v
seatnadit	siednadit	v
seavadit	sievadit	v
seavašit	sievatjit	v
seavddagit	sievdagit	v
seavnnjahit	sievnjadit	v
seavnnjašit	sievnjatjit	v
seavnnjihit	sievnjedit	v
seavnnjuhit	sievnjodit	v
seavnnjášit	sævnjátjit	v
segodit	segudit	v
selehit	selidit	v
selvehit	selvvidit	v
sepmohit	sebmudit	v
sevddiidit	sevdijdit	v
sevnnjodit	sevnjudit	v
sevttodit	sevtudit	v
sibildit	sibeldit	v
sibirdit	siberdit	v
sidjádit	sidjádit	v
siedjudit	siedjodit	v
siektadit	siektadit	v
sierkŋadit	sierŋadit	v
sievttastit	sievtastit	v
sihke7stit	sihkestit	v
sihkkasit	sihkkasit	v
siiddastit	sijdastit	v
siivvosmit	sijvusmit	v
sikkildit	sikkeldit	v
silášit	silátjit	v
sinjaidit	sinjájdit	v
sirddašit	sirdatjit	v
sirgŋadit	sirŋŋadit	v
siđgŋadit	sirŋŋadit	v
sisa#fievrre7dit	sisafievredit	v
sisa#fievrridit	sisafievredit	v
sisa#fievrre7dit	sisafievredit	v
sisa#fievrridit	sisafievredit	v
sisa#gáibidit	sisagájbbedit	v
sisa#đálihit	sisatjáledit	v
ciskkihit	tsiskedit	v
siskkidit	siskedit	v
siskkildit	siskeldit	v
siskkuštit	siskosjtit	v
siskánit	sisskánit	v
sitnjasit	sidnjasit	v
sittardit	sittardit	v
sivahit	sivádit	v
bures#sivdnidit	burissivnnedit	v
sivdnidit	sivnnedit	v
sivjjogastalit	sivjugastalit	v
sivladit	sivlladit	v
siđasmit	sidásmit	v
sirgŋadit	sirŋŋadit	v
siđgŋadit	sirŋŋadit	v
siđvahit	sirvvadit	v
siđvvagit	sirvagit	v
skabastit	skabástit	v
skahraidit	skahrajdit	v
skahrihit	skahredit	v
skaldduhit	skaldodit	v
skarkkihit	skarkedit	v
skavvehit	skavvidit	v
skavžžahit	skavtjadit	v
skavžžašit	skavtjatjit	v
skeaikkihit	skiejkedit	v
skealmmastit	skielmastit	v
skearro7stit	skierrostit	v
skearrustit	skierrostit	v
skierro7stit	skierrostit	v
skearro7stit	skierrostit	v
skearrustit	skierrostit	v
skierro7stit	skierrostit	v
skeartnjagit	skiernjagit	v
skeavkádit	skævkkádit	v
skeavkáhit	skævkkádit	v
skeavkádit	skævkkádit	v
skeavkáhit	skævkkádit	v
skeavžžihit	skievtjedit	v
skeavžžuhit	skievtjodit	v
skelbmošit	skelmmutjit	v
skelđđiidit	skeltjijdit	v
skerrostit	skerrustit	v
skertnjiidit	skernjijdit	v
skevvehit	skevvidit	v
skielgahit	skielggadit	v
skielggagit	skielgagit	v
skielgguhit	skielgodit	v
skielttardit	skieltardit	v
skierpmádit	skiermádit	v
skearro7stit	skierrostit	v
skearrustit	skierrostit	v
skierro7stit	skierrostit	v
skiervanit	skiervvanit	v
skievttardit	skievtardit	v
skievttidit	skievtedit	v
skievvidit	skievvedit	v
gáddái#skihkidit	gáddájskihkedit	v
skihkidit	skihkedit	v
skihtardit	skihtardit	v
skihđahit	skihtjadit	v
skihđđahit	skihttjadit	v
skilgalit	skilggalit	v
skilganit	skilgganit	v
skilgge7hit	skilgedit	v
skilihit	skiledit	v
skilkalit	skilkkalit	v
skilkke7hit	skilkedit	v
skilkkihit	skilkedit	v
skilkke7hit	skilkedit	v
skilkkihit	skilkedit	v
skilkkuhit	skilkodit	v
skilttardit	skiltardit	v
skindošit	skinddutjit	v
skirragit	skirragit	v
skirvanit	skirvvanit	v
skirvehit	skirvvidit	v
skivvehit	skivvidit	v
skivllagit	skivlagit	v
skivžžagit	skivtjagit	v
skiŋgalit	skiŋggalit	v
skiŋggihit	skiŋgedit	v
skiŋgguhit	skiŋgodit	v
skiŋggádit	skiŋgádit	v
skoabaidit	skåbajdit	v
skoabihit	skoabedit	v
skoalihit	skoaledit	v
skoalkkuhit	skoalkodit	v
skoarahit	skåradit	v
skoaraidit	skårajdit	v
skoarihit	skoaredit	v
skoarragit	skoarragit	v
skoarđđagit	skoartjagit	v
skoavddagit	skoavdagit	v
skoavdudit	skoavddodit	v
skoavhllagit	skoavhlagit	v
skoavhludit	skoavhllodit	v
skoavkalit	skoavkkalit	v
skoavkke7hit	skoavkedit	v
skoavkkihit	skoavkedit	v
skoavkke7hit	skoavkedit	v
skoavkkihit	skoavkedit	v
skoavkkuhit	skoavkodit	v
skoađastit	skådastit	v
skoažihit	skoatjedit	v
skolladit	skållådit	v
skolppagit	skålpågit	v
skolppuhit	skålpodit	v
skolvvagit	skålvågit	v
skubbestit	skubbistit	v
skuhraidit	skuhrajdit	v
skuhrihit	skuhredit	v
skuibahit	skujbbadit	v
skuibbagit	skujbagit	v
skulkkodit	skulkudit	v
skulđalit	skulttjalit	v
skulđđihit	skultjedit	v
skulđđuhit	skultjodit	v
skunjaidit	skunjájdit	v
skunjihit	skunjedit	v
skuoivvagit	skuojvagit	v
skuolaidit	skuolajdit	v
skuolffuhit	skuolfodit	v
skuoljastit	skuoljjastit	v
skuolkasit	skuolkkasit	v
skuonjaidit	skuonjajdit	v
skuonjuhit	skuonjodit	v
skuortnagit	skuornagit	v
skuožurdit	skuotjordit	v
skurkkihit	skurkedit	v
skurragit	skurragit	v
skurtnjagit	skurnjagit	v
skurtnjuhit	skurnjodit	v
skurvvagit	skurvagit	v
skurđđagit	skurtjagit	v
skuvaidit	skuvájdit	v
skuvihit	skuvedit	v
skuvnnjagit	skuvnjagit	v
skuŋkkagit	skuŋkagit	v
skuŋkkuhit	skuŋkodit	v
skužagit	skutjágit	v
skužaidit	skutjájdit	v
skužistit	skutjestit	v
skáhđasit	skáhtjasit	v
skáidnedit	skájnnidit	v
skáiaidit	skájájdit	v
skáiihit	skájjdit	v
skáktádit	skáktádit	v
skálahit	skáládit	v
skálaidit	skálájdit	v
skálihit	skáledit	v
skálkkastit	skálkastit	v
skálkkihit	skálkedit	v
skálkošit	skálkkutjit	v
skálmmastit	skálmastit	v
skárastit	skárástit	v
skávgadit	skávggadit	v
skávgalit	skávggalit	v
skážastit	skátjástit	v
skážihit	skátjedit	v
skážádit	skátjádit	v
smarffagit	smarfagit	v
smarvvagit	smarvagit	v
smealđagit	smielttjagit	v
smiehtadit	smiehtadit	v
smiehtahit	smiehtadit	v
smiehtadit	smiehtadit	v
smiehtahit	smiehtadit	v
smiergalit	smierggalit	v
smierggihit	smiergedit	v
smiergguhit	smiergodit	v
smierrudit	smierrodit	v
smiezaidit	smietsajdit	v
smirezit	smiritsit	v
smirošit	smirutjit	v
smiđásmit	smidásmit	v
smoaldanit	smoalldanit	v
smoggidit	småggedit	v
smokkagit	småkkågit	v
smokkodit	småkkudit	v
smolggiidit	smålgijdit	v
smorodit	smårudit	v
smáittášit	smájtátjit	v
smávuhit	smávodit	v
smávvudit	smávvodit	v
snahpastit	snahpastit	v
snarrodit	snarrudit	v
snaraidit	snarájdit	v
snarragit	snarragit	v
sneaidadit	sniejddadit	v
snielásmit	snielásmit	v
snievkalit	snievkkalit	v
snievkkuhit	snievkodit	v
snihpastit	snihpastit	v
snihpodit	snihpudit	v
snihppasit	snihppasit	v
snirkkagit	snirkagit	v
snirkkuhit	snirkodit	v
snoabihit	snoabedit	v
snoabádit	snoabádit	v
snoaggudit	snoaggodit	v
snoakkášit	snoakkátjit	v
snoalkkistit	snoalkestit	v
snogagit	snågågit	v
snoguhit	snågodit	v
snolkkagit	snålkågit	v
snorrehit	snårridit	v
snorránit	snårrånit	v
snorranit	snårrånit	v
snorragit	snårrågit	v
snorránit	snårrånit	v
snorranit	snårrånit	v
snorruhit	snårrodit	v
snuohtardit	snuohtardit	v
snuolggidit	snuolgedit	v
snuolggistit	snuolgestit	v
snuorddildit	snuordeldit	v
snuordudit	snuorddodit	v
snuskkihit	snuskedit	v
snuđádit	snudádit	v
snárkanit	snárkkanit	v
snárkkagit	snárkagit	v
snárkudit	snárkkodit	v
snávggodit	snávgudit	v
soabbulit	soabbolit	v
soadjádit	soadjádit	v
soahpadit	soahpadit	v
soaigge7hit	soajgedit	v
soaiggihit	soajgedit	v
soaigge7hit	soajgedit	v
soaiggihit	soajgedit	v
soaikulit	soajkkolit	v
soaimmadit	soajmadit	v
soaitte7stit	soajtestit	v
soaldudit	soalldodit	v
soalsidit	soalssedit	v
soalssidit	soalsedit	v
soalssistit	soalsestit	v
soappastit	soappastit	v
soappástit	soappástit	v
soarcalit	soarttsalit	v
soardidit	soarddedit	v
soardásit	soarddásit	v
soarpudit	soarppodit	v
soasihit	soasedit	v
soatkasit	soatkasit	v
soavddildit	soavdeldit	v
soavludit	soavllodit	v
soađáskit	soadáskit	v
soaŋuhit	soaŋodit	v
soažžudit	soadtjodit	v
sodjasit	sådjåsit	v
sodnjánit	såddnjånit	v
sohpasit	såhpåsit	v
coicalit	tsåjttsålit	v
soicalit	såjttsålit	v
soiccihit	såjtsedit	v
coiccistit	tsåjtsestit	v
soiccistit	såjtsestit	v
coiccuhit	tsåjtsodit	v
soiccuhit	såjtsodit	v
coiccáskit	tsåjtsåskit	v
soiccáskit	såjtsåskit	v
soiihit	såjjdit	v
soktudit	såktodit	v
solgádit	sålggådit	v
solžidit	sålltjedit	v
sonjuhit	sånjodit	v
soradit	sårådit	v
sorjalit	sårjjålit	v
sotnadit	sådnådit	v
sovkalit	såvkkålit	v
sovkkuhit	såvkodit	v
sođagit	sådågit	v
spabbalit	spabbalit	v
spahđalit	spahtjalit	v
spaigasit	spajggasit	v
spaigguhit	spajgodit	v
spakkagit	spakkagit	v
spalcadit	spalttsadit	v
spalccidit	spaltsedit	v
spalccihit	spaltsedit	v
spalccidit	spaltsedit	v
spalccihit	spaltsedit	v
spanuhit	spanodit	v
spappuhit	spappodit	v
sparrudit	sparrodit	v
sparahit	sparádit	v
sparaidit	sparájdit	v
spargalit	sparggalit	v
spargguhit	spargodit	v
sparkalit	sparkkalit	v
sparkelastit	sparkkilastit	v
sparkke7hit	sparkedit	v
sparkkihit	sparkedit	v
sparkke7hit	sparkedit	v
sparkkihit	sparkedit	v
sparkkuhit	sparkodit	v
spatnjasit	spadnjasit	v
spažahit	spatjádit	v
spažaidit	spatjájdit	v
spažihit	spatjedit	v
spažuhit	spatjodit	v
speaigalit	spiejggalit	v
spealastit	spielastit	v
spielastit	spielastit	v
speažžasit	spiedtjasit	v
spiehkastit	spiehkastit	v
spiehkkasit	spiehkkasit	v
spealastit	spielastit	v
spielastit	spielastit	v
spierggádit	spiergádit	v
spihkodit	spihkudit	v
spiiddistit	spijdestit	v
spiidne#guođo7hit	spijnneguododit	v
spiidnošit	spijnnutjit	v
spinjaidit	spinjájdit	v
spivkohit	spivkkudit	v
spivkošit	spivkkutjit	v
spoahke7hit	spoahkedit	v
spoahkihit	spoahkedit	v
spoahke7hit	spoahkedit	v
spoahkihit	spoahkedit	v
spoahkkalit	spoahkkalit	v
spoahkuhit	spoahkodit	v
spoggalit	spåggålit	v
spokkuhit	spåkkodit	v
spulžudit	spulltjodit	v
spággudit	spággodit	v
spáigalit	spájggalit	v
spáigasit	spájggasit	v
spáiggihit	spájgedit	v
spáiggádit	spájgádit	v
spáikasit	spájkkasit	v
spáikkastit	spájkastit	v
spáikkihit	spájkedit	v
spáittiidit	spájtijdit	v
spálđudit	spálttjodit	v
spálđđildit	spáltjeldit	v
spálžžildit	spáltjeldit	v
spálžudit	spálltjodit	v
spálđđildit	spáltjeldit	v
spálžžildit	spáltjeldit	v
spánastit	spánástit	v
spánžadit	spánttjadit	v
spánžžagit	spántjagit	v
spánžžistit	spántjestit	v
spárkadit	spárkkadit	v
srubistit	srubestit	v
staiggiidit	stajgijdit	v
staiidit	stajjdit	v
stalkadit	stalkkadit	v
stargadit	starggadit	v
starggasmit	stargasmit	v
stavkáhit	stavkkádit	v
steaikalit	stiejkkalit	v
steaikke7hit	stiejkedit	v
steanžalit	stienttjalit	v
steanžáhit	stænttjádit	v
steanžžagit	stientjagit	v
steanžže7hit	stientjedit	v
steanžžihit	stientjedit	v
steanžže7hit	stientjedit	v
steanžžihit	stientjedit	v
steanžžuhit	stientjodit	v
steavlidit	stievlledit	v
steavžžuhit	stievtjodit	v
steađđagit	stiettjagit	v
steađđe7hit	stiettjedit	v
steađđihit	stiettjedit	v
steađđe7hit	stiettjedit	v
steađđihit	stiettjedit	v
steađđuhit	stiettjodit	v
steažžalit	stiedtjalit	v
steažžasit	stiedtjasit	v
stielgudit	stielggodit	v
stielkudit	stielkkodit	v
stielkádit	stielkkádit	v
stihkadit	stihkadit	v
stihkádit	stihkádit	v
stilđđihit	stiltjedit	v
stilđđuhit	stiltjodit	v
stilđđádit	stiltjádit	v
stircalit	stirttsalit	v
stirccihit	stirtsedit	v
stirccuhit	stirtsodit	v
stirdudit	stirddodit	v
stoagáskit	stoagáskit	v
stoaidudit	stoajddodit	v
stoancalit	stoanttsalit	v
stoancce7hit	stoantsedit	v
stoanccuhit	stoantsodit	v
stoanžalit	stoanttjalit	v
stoanžžihit	stoantjedit	v
stoanžžuhit	stoantjodit	v
stoarbmiditit	stoarmmeditit	v
stoavkalit	stoavkkalit	v
stoavkke7hit	stoavkedit	v
stoavkkuhit	stoavkodit	v
stohkkadit	ståhkkådit	v
stohkkádit	ståhkkådit	v
stohkkadit	ståhkkådit	v
stohkkádit	ståhkkådit	v
stohppádit	ståhppådit	v
stolkkihit	stålkedit	v
stoncalit	stånttsålit	v
stonccuhit	ståntsodit	v
strubistit	strubestit	v
stráillistit	strájllestit	v
stuibmidit	stujmmedit	v
stuimmáskit	stujmáskit	v
stuláskit	stuláskit	v
stulđalit	stulttjalit	v
stulđđihit	stultjedit	v
stulđđuhit	stultjodit	v
stumppuhit	stumpodit	v
stuorrudit	stuorrodit	v
stuorásmit	stuorásmit	v
stuorášit	stuorátjit	v
sturgalit	sturggalit	v
sturggihit	sturgedit	v
sturjjidit	sturjedit	v
stuŋgadit	stuŋggadit	v
stuŋgehit	stuŋggidit	v
stužaidit	stutjájdit	v
stužihit	stutjedit	v
stágguditit	stággoditit	v
stáhpardit	stáhpardit	v
stáhpádit	stáhpádit	v
stáidnadit	stájnnadit	v
stáipasit	stájppasit	v
stáippardit	stájpardit	v
stáippasmit	stájpasmit	v
stáippodit	stájpudit	v
stáippuhit	stájpodit	v
stánžudit	stánttjodit	v
stávedit	stávidit	v
stávrrihit	stávredit	v
stávrruhit	stávrodit	v
stávrádit	stávrrádit	v
stávráhit	stávrrádit	v
stávrádit	stávrrádit	v
stávráhit	stávrrádit	v
stáđásmit	stádásmit	v
suhpodit	suhpudit	v
suhtihit	suhtedit	v
suiahit	sujádit	v
suohppádit	suohppádit	v
suoibbihit	suojbedit	v
suoibbuhit	suojbodit	v
suoibbádit	suojbádit	v
suoibánit	suojbbánit	v
suoivve7hit	suojvedit	v
suoivvihit	suojvedit	v
suoivve7hit	suojvedit	v
suoivvihit	suojvedit	v
suoiásmit	suojásmit	v
suokkagit	suokkagit	v
suokkardit	suokkardit	v
suoksadit	suoksadit	v
suolbmudit	suolmmodit	v
suoldnudit	suolnnodit	v
suolle7#fievrridit	suollefievredit	v
suonjadit	suonjadit	v
suonjardit	suonjardit	v
suorggahit	suorgadit	v
suorggidit	suorgedit	v
suorranit	suorranit	v
suortudit	suorttodit	v
suossadit	suossadit	v
suosttuhit	suostodit	v
suotnjalit	suodnjalit	v
suovganit	suovgganit	v
suovssildit	suovseldit	v
suovvidit	suovvedit	v
suovvudit	suovvodit	v
suovvádit	suovvádit	v
suođihit	suodedit	v
suođđadit	suoddadit	v
suožahit	suotjadit	v
surgehit	surggidit	v
surggiidit	surgijdit	v
sustilit	susstelit	v
susttašit	sustatjit	v
sutmmistit	sutmmestit	v
suttihit	suttedit	v
cuvccastit	tsuvttsastit	v
suvccastit	suvttsastit	v
suvjadit	suvjjadit	v
suvlliidit	suvlijdit	v
suvrragit	suvragit	v
suvrrásmit	suvrásmit	v
suvđđagit	suvtjagit	v
ságastit	ságástit	v
cáhcasit	tsáhtsasit	v
sáhcasit	sáhtsasit	v
sáhkkuhit	sáhkkodit	v
sáhko7hit	sáhkodit	v
sáhkuhit	sáhkodit	v
sáhko7hit	sáhkodit	v
sáhkuhit	sáhkodit	v
sáhtašit	sáhtatjit	v
sáhto7stit	sáhtostit	v
sáhttalit	sáhttalit	v
sáhđasit	sáhtjasit	v
sáiganit	sájgganit	v
sáiggagit	sájgagit	v
sáimmastit	sájmastit	v
sáittástit	sájtástit	v
sáivadit	sájvvadit	v
sákkagit	sákkagit	v
sálttiidit	sáltijdit	v
sálttášit	sáltátjit	v
sáltudit	sálltodit	v
sámildit	sámeldit	v
sánuhit	sánodit	v
sánáidit	sánájdit	v
sárastit	sárástit	v
sárjjastit	sárjastit	v
sárjádit	sárjjádit	v
sártnaštit	sárnasjtit	v
sártnádit	sárnádit	v
sátne7#lahkástit	sádnelahkástit	v
sátne7#viđástit	sádnevidástit	v
sátnádit	sádnádit	v
sávadit	sávádit	v
sávnnjodit	sávnjudit	v
sávnnodit	sávnudit	v
sávrudit	sávrrodit	v
cázastit	tsátsástit	v
sázastit	sátsástit	v
vuollái#sázastit	vuollájsátsástit	v
sázodit	sátsudit	v
sáŋardit	sáŋárdit	v
teahtistit	tiehtestit	v
teahtásmit	tæhtásmit	v
tennjedit	tennjidit	v
tevdnedit	tevnnidit	v
tiggedit	tiggidit	v
tiiddastit	tijdastit	v
hudjosit	hudjusit	v
udjosit	udjusit	v
đudjosit	tjudjusit	v
uhcahastalit	uhtsahastalit	v
uhccudit	uhttsodit	v
uhccánit	uhttsánit	v
uhcedit	uhtsidit	v
uhcáhastalit	uhtsáhastalit	v
uhcášit	uhtsátjit	v
guhkedit	guhkidit	v
guhkidit	guhkedit	v
uhkidit	uhkedit	v
ruiosmit	rujusmit	v
uiosmit	ujusmit	v
huiošit	hujutjit	v
uiošit	ujutjit	v
gulahit	guládit	v
julahit	juládit	v
ulahit	uládit	v
unnudit	unnodit	v
unnánit	unnánit	v
unnáhastalit	unnáhastalit	v
unnášit	unnátjit	v
unohastit	unuhastit	v
unohastalit	unuhastalit	v
urddistit	urdestit	v
buskkihit	buskedit	v
cuskkihit	tsuskedit	v
juskkihit	juskedit	v
snuskkihit	snuskedit	v
uskkidit	uskedit	v
uskánit	usskánit	v
uvhridit	uvhredit	v
uŋggardit	uŋgardit	v
vabaidit	vabájdit	v
vadjasit	vadjasit	v
vakŋalit	vagŋalit	v
valastit	valástit	v
valjášit	valjjátjit	v
valášit	valátjit	v
varasmit	varásmit	v
varastit	varástit	v
vardahit	varddadit	v
varddašit	vardatjit	v
varradit	varradit	v
vasmalit	vassmalit	v
vaspalit	vasspalit	v
vatnasit	vadnasit	v
vavdadit	vavddadit	v
vavddadit	vavdadit	v
vađastit	vadástit	v
vađustit	vadostit	v
vaŋkkagit	vaŋkagit	v
vaŋuhit	vaŋodit	v
vaŋádit	vaŋádit	v
vašáskit	vasjáskit	v
veaguhit	viegodit	v
veahkehit	viehkidit	v
veahtalit	viehtalit	v
veahttadit	viehttadit	v
veahttalit	viehttalit	v
viehttalit	viehttalit	v
veahtudit	viehtodit	v
veaisidit	viejssedit	v
veaiihit	viejjdit	v
vealahit	vieladit	v
veallahit	vielladit	v
vielladit	vielladit	v
veallánit	vællánit	v
vealtadit	vielltadit	v
vealuhit	vielodit	v
vealđalit	vielttjalit	v
vealđasit	vielttjasit	v
vealđđagit	vieltjagit	v
vealđđe7hit	vieltjedit	v
vealđđihit	vieltjedit	v
vealđđe7hit	vieltjedit	v
vealđđihit	vieltjedit	v
veanzasit	vienttsasit	v
veanzzagit	vientsagit	v
veardidit	vierddedit	v
veardnidit	viernnedit	v
vearistit	vierestit	v
vearjudit	vierjjodit	v
veartnáskit	værnáskit	v
vearáskit	væráskit	v
veatnáskit	vædnáskit	v
veavssástit	vævsástit	v
veavttastit	vievtastit	v
veašidit	vietjedit	v
veažirdit	vietjerdit	v
vehtiidit	vehtijdit	v
veiggodit	vejgudit	v
veiolaštit	vejulasjtit	v
velledit	vellidit	v
vellehit	vellidit	v
velledit	vellidit	v
vellehit	vellidit	v
velehit	velidit	v
velgohit	velggudit	v
veriidit	verijdit	v
vieccistit	viettsestit	v
vieggasit	vieggasit	v
veahttalit	viehttalit	v
viehttalit	viehttalit	v
vielggašit	vielgatjit	v
vielggihit	vielgedit	v
vielggildit	vielgeldit	v
vielgguhit	vielgodit	v
vielggášit	vielgátjit	v
vielgánit	vielggánit	v
veallahit	vielladit	v
vielladit	vielladit	v
viergádit	vierggádit	v
vierradit	vierradit	v
vierttudit	viertodit	v
vierášit	vierátjit	v
viesihit	viesedit	v
viessadit	viessadit	v
vievgŋadit	vievgŋadit	v
vieđđildit	viettjeldit	v
vihahit	vihádit	v
vihkkehit	vihkkidit	v
vihttánit	vihttánit	v
viibadit	vijbbadit	v
viidudit	vijddodit	v
viidáset#fievrridit	vijddásetfievredit	v
viidáset#gárgedit	vijddásetgárggidit	v
viimmáskit	vijmáskit	v
viissášit	vijsátjit	v
viisudit	vijssodit	v
vikšadit	viksjadit	v
vildadit	villdadit	v
vilddosmit	vildusmit	v
vilddošit	vildutjit	v
vilddálgit	vildálgit	v
vilddáskit	vildáskit	v
vildudit	villdodit	v
vileštit	vilisjtit	v
vilggodit	vilgudit	v
vilppagit	vilpagit	v
vilppastit	vilpastit	v
vilppihit	vilpedit	v
vilppádit	vilpádit	v
vilššagit	vilsjagit	v
vilššádit	vilsjádit	v
vinjagit	vinjágit	v
vinjildit	vinjeldit	v
virgádit	virggádit	v
virgái#nammadit	virggájnammadit	v
virgáidit	virggájdit	v
virkkodit	virkudit	v
virkkosmit	virkusmit	v
virradit	virradit	v
virtestit	virttistit	v
virttásmit	virtásmit	v
visostit	visustit	v
vistilit	visstelit	v
vižardit	vitjárdit	v
vuhpodit	vuhpudit	v
vuhtodit	vuhtudit	v
vuhttodit	vuhttudit	v
vuigestit	vujggistit	v
vuobaidit	vuobajdit	v
vuogasmit	vuogasmit	v
vuogašit	vuogatjit	v
vuogihit	vuogedit	v
vuohkadit	vuohkadit	v
vuohpádit	vuohpádit	v
vuohttalit	vuohttalit	v
vuohđudit	vuohtjodit	v
vuoidasit	vuojddasit	v
jienastan#vuoigadit	jienastanvuojggadit	v
vuoigadit	vuojggadit	v
vuoigatvuođa#vuođđudit	vuojggatvuodavuoddodit	v
vuoissadit	vuojsadit	v
vuoissihit	vuojsedit	v
vuoissádit	vuojsádit	v
vuoitalit	vuojttalit	v
vuoiŋŋastaladit	vuojŋastaladit	v
vuoiŋŋe7hit	vuojŋedit	v
vuoiŋŋidit	vuojŋedit	v
vuoiŋŋihit	vuojŋedit	v
vuoiŋŋe7hit	vuojŋedit	v
vuoiŋŋidit	vuojŋedit	v
vuoiŋŋihit	vuojŋedit	v
vuoiŋŋe7hit	vuojŋedit	v
vuoiŋŋidit	vuojŋedit	v
vuoiŋŋihit	vuojŋedit	v
vuoiihit	vuojjdit	v
vuoiildit	vuojjldit	v
vuoiádit	vuojádit	v
vuolgalit	vuolggalit	v
vuolildit	vuoleldit	v
vuollasit	vuollasit	v
vuollái#sárggastit	vuollájsárgastit	v
vuollái#sázastit	vuollájsátsástit	v
vuollástit	vuollástit	v
vuoluštit	vuolosjtit	v
vuolšudit	vuolssjodit	v
vuonjasmit	vuonjasmit	v
vuorasmit	vuorasmit	v
vuorašit	vuoratjit	v
vuorddildit	vuordeldit	v
vuorjjildit	vuorjeldit	v
vuorjjášit	vuorjátjit	v
vuosmme7stit	vuosmestit	v
vuosmmistit	vuosmestit	v
vuosmme7stit	vuosmestit	v
vuosmmistit	vuosmestit	v
vuoste#beallái7#gaskkustit	vuosstebælláj7gaskostit	v
vuoste7#hágostit	vuosstehágustit	v
vuoste#jienastit	vuosstejienastit	v
vuosttaldit	vuostaldit	v
vuostánit	vuosstánit	v
vuotnámastalit	vuodnámastalit	v
vuovdalit	vuovddalit	v
vuovdduštit	vuovdosjtit	v
vuovdášit	vuovddátjit	v
vuovssuhit	vuovsodit	v
vuovzasit	vuovttsasit	v
vuovzásit	vuovttsásit	v
vuođđistit	vuottjestit	v
vuođustit	vuodostit	v
vuođuštit	vuodosjtit	v
láhka#vuođđudit	láhkavuoddodit	v
vuoigatvuođa#vuođđudit	vuojggatvuodavuoddodit	v
vuođđudit	vuoddodit	v
vuoŋásmit	vuoŋásmit	v
vuoššastit	vuossjastit	v
vuoššudit	vuossjodit	v
vurkkodit	vurkudit	v
vuvdošit	vuvddutjit	v
váccahit	váttsadit	v
váddudit	váddodit	v
vádjolit	vádjulit	v
váfistit	váfestit	v
váhkkasit	váhkkasit	v
váhnemastalit	váhnimastalit	v
váidalit	vájddalit	v
miel#váikkuhit	mielvájkodit	v
mielde7#váikkuhit	mielldevájkodit	v
váikkuhit	vájkodit	v
váillahit	vájlladit	v
váimmoskit	vájmuskit	v
váinnuhit	vájnodit	v
váipasit	vájppasit	v
váippastit	vájpastit	v
váippihit	vájpedit	v
váippodit	vájpudit	v
váippádit	vájpádit	v
váivvahit	vájvadit	v
váivvášit	vájvátjit	v
váialdit	vájáldit	v
váiuldit	vájoldit	v
váksáditit	váksáditit	v
válbmanit	válmmanit	v
válddahit	váldadit	v
válddáhit	váldádit	v
válganit	válgganit	v
válladit	válladit	v
válmmastit	válmastit	v
válmmaštit	válmasjtit	v
vánastit	vánástit	v
vánttasmit	vántasmit	v
vánášit	vánátjit	v
várdahit	várddadit	v
várgehit	várggidit	v
várssuhit	vársodit	v
vátnudit	vádnodit	v
váttásmit	váttásmit	v
váttášit	váttátjit	v
vávašit	vávatjit	v
vávjjašit	vávjatjit	v
vávllo7stit	vávlostit	v
vávllustit	vávlostit	v
vávllo7stit	vávlostit	v
vávllustit	vávlostit	v
vázzodit	vádtsudit	v
hábbasit	hábbasit	v
ábbasit	ábbasit	v
hábbudit	hábbodit	v
ábbudit	ábbodit	v
đábbudit	tjábbodit	v
dábuhit	dábodit	v
ábuhit	ábodit	v
áccuhit	áttsodit	v
ádjásit	ádjásit	v
ággadit	ággadit	v
báhcadit	báhtsadit	v
báhcahit	báhtsadit	v
máhcadit	máhtsadit	v
máhcahit	máhtsadit	v
áhcahit	áhtsadit	v
áhpe7golgadit	áhpegolgadit	v
áhppádit	áhppádit	v
đáhppádit	tjáhppádit	v
áhpánit	áhpánit	v
ráhpásmit	ráhpásmit	v
áhpásmit	áhpásmit	v
áhtaštit	áhtasjtit	v
váibadit	vájbbadit	v
áibadit	ájbbadit	v
áibbašit	ájbatjit	v
áiddastit	ájdastit	v
áiddo7stit	ájdostit	v
báitalit	bájttalit	v
náitalit	nájttalit	v
áitalit	ájttalit	v
áittardit	ájtardit	v
báittašit	bájtatjit	v
láittašit	lájtatjit	v
áittašit	ájtatjit	v
gáiihit	gájjdit	v
skáiihit	skájjdit	v
áiihit	ájjdit	v
gákkastit	gákkastit	v
sákkastit	sákkastit	v
ákkastit	ákkastit	v
hállanit	hállanit	v
állanit	állanit	v
állestit	állistit	v
álbmasit	álmmasit	v
bálgalit	bálggalit	v
gálgalit	gálggalit	v
álgalit	álggalit	v
đálgalit	tjálggalit	v
álkidit	álkkedit	v
gálladit	gálladit	v
válladit	válladit	v
állahit	álladit	v
skálmmastit	skálmastit	v
válmmastit	válmastit	v
álmmastit	álmastit	v
fáluhit	fálodit	v
gálo7dit	gálodit	v
gáludit	gálodit	v
háluhit	hálodit	v
áluhit	álodit	v
álustit	álostit	v
ánssáhit	ánsádit	v
ánssášit	ánsátjit	v
háppastit	háppastit	v
áppastit	áppastit	v
áppodit	áppudit	v
háppuhit	háppodit	v
áppodit	áppudit	v
áppuhit	áppodit	v
háppustit	háppostit	v
áppustit	áppostit	v
háppádit	háppádit	v
áppádit	áppádit	v
gáradit	gárádit	v
áradit	árádit	v
đáradit	tjárádit	v
šárahit	sjárádit	v
árasmit	árásmit	v
đárásmit	tjárásmit	v
várašit	váratjit	v
árašit	áratjit	v
árggašit	árgatjit	v
đáđggašit	tjárgatjit	v
árggášit	árgátjit	v
sárggodit	sárgudit	v
árgudit	árggodit	v
árkkálmastalit	árkálmastalit	v
árkkášit	árkátjit	v
árpmihit	ármedit	v
árpmo7štit	ármosjtit	v
árpmášit	ármátjit	v
árranit	árranit	v
árvvasmit	árvasmit	v
árvvašit	árvatjit	v
árvvoštit	árvusjtit	v
árvádahttalit	árvvádahttalit	v
dáráskit	dáráskit	v
áráskit	áráskit	v
ásadit	ásádit	v
ásahit	ásádit	v
ásadit	ásádit	v
ásahit	ásádit	v
ásaidit	ásájdit	v
ásodit	ásudit	v
gástadit	gásstadit	v
ástadit	ásstadit	v
ásustit	ásostit	v
ávaštit	ávasjtit	v
ávddasmit	ávdasmit	v
ávdniditit	ávnneditit	v
bávkkuhit	bávkodit	v
ávkkuhit	ávkodit	v
ávládit	ávlládit	v
ávnnaldit	ávnaldit	v
ávnnastit	ávnastit	v
hávvudit	hávvodit	v
smávvudit	smávvodit	v
ávvudit	ávvodit	v
ávžžuhit	ávtjodit	v
áŋggašit	áŋgatjit	v
háŋggaštit	háŋgasjtit	v
áŋggaštit	áŋgasjtit	v
áŋggirdit	áŋgerdit	v
ášše#meannudit	ássjemiennodit	v
ášše7#ráhkkanit	ássjeráhkkanit	v
ášše#đuođđuhit	ássjetjuottjodit	v
áššodit	ássjudit	v
ráššudit	rássjodit	v
áššudit	ássjodit	v
á≈ßestit	átistit	v
đabadit	tjabádit	v
đabardit	tjabárdit	v
đagalduhte7stit	tjagálduhtestit	v
đagarduhte7stit	tjagárduhtestit	v
đahkkadit	tjahkkadit	v
đahpalit	tjahpalit	v
đahraidit	tjahrajdit	v
đahrralit	tjahrralit	v
đahrádit	tjahrádit	v
đaimme7hit	tjajmedit	v
đaimmihit	tjajmedit	v
đaimme7hit	tjajmedit	v
đaimmihit	tjajmedit	v
đakđulit	tjaktjolit	v
đalbmadit	tjalmmadit	v
đalgadit	tjalggadit	v
đalgge7hit	tjalgedit	v
đalggihit	tjalgedit	v
đalgge7hit	tjalgedit	v
đalggihit	tjalgedit	v
đallasit	tjallasit	v
đallidit	tjalledit	v
đarkkistit	tjarkestit	v
đarvvahit	tjarvadit	v
đaskkašit	tjaskatjit	v
đavddásmit	tjavdásmit	v
đavdudit	tjavddodit	v
đavganit	tjavgganit	v
đavgasit	tjavggasit	v
đavgge7hit	tjavgedit	v
đavggihit	tjavgedit	v
đavgge7hit	tjavgedit	v
đavggihit	tjavgedit	v
đavgánit	tjavggánit	v
đeagŋahit	tjieggŋadit	v
đeahkarit	tjiehkarit	v
đeahppudit	tjiehppodit	v
đeahppulit	tjiehppolit	v
đeakŋagit	tjiegŋagit	v
đealdadit	tjielldadit	v
đeallulit	tjiellolit	v
đealuhit	tjielodit	v
đealádit	tjæládit	v
đeargge7hit	tjiergedit	v
đearggihit	tjiergedit	v
đeargge7hit	tjiergedit	v
đearggihit	tjiergedit	v
đeargulit	tjierggolit	v
đearidit	tjieredit	v
đearssistit	tjiersestit	v
đearssuhit	tjiersodit	v
đearsánit	tjærssánit	v
đeasahit	tjiesadit	v
đeasihit	tjiesedit	v
đeaskkihit	tjieskedit	v
đeaskkuhit	tjieskodit	v
đeaskánit	tjæsskánit	v
đegŋedit	tjeggŋidit	v
đegŋestit	tjeggŋistit	v
đerggiidit	tjergijdit	v
đeskkodit	tjeskudit	v
điehkadit	tjiehkadit	v
điehpastit	tjiehpastit	v
đielgadit	tjielggadit	v
đielgge7hit	tjielgedit	v
đielggihit	tjielgedit	v
đielgge7hit	tjielgedit	v
đielggihit	tjielgedit	v
đierastit	tjierastit	v
đierrasit	tjierrasit	v
đieđihit	tjiededit	v
đieŋašit	tjieŋatjit	v
đigastit	tjigástit	v
đikŋalit	tjigŋalit	v
đilláhit	tjilládit	v
đilgedit	tjilggidit	v
đilgehit	tjilggidit	v
đilgedit	tjilggidit	v
đilgehit	tjilggidit	v
đilgestit	tjilggistit	v
đilluhit	tjillodit	v
đippo7stit	tjippostit	v
đippustit	tjippostit	v
đippo7stit	tjippostit	v
đippustit	tjippostit	v
đirrostit	tjirrustit	v
điradit	tjirádit	v
đirradit	tjirradit	v
đirssuhit	tjirsodit	v
đirsánit	tjirssánit	v
đivhllagit	tjivhlagit	v
đivrragit	tjivragit	v
đivttadit	tjivtadit	v
đivttašit	tjivtatjit	v
điđašit	tjidatjit	v
điđistit	tjidestit	v
điŋadit	tjiŋádit	v
điŋahit	tjiŋádit	v
điŋadit	tjiŋádit	v
điŋahit	tjiŋádit	v
điŋkkodit	tjiŋkudit	v
điŋkkuhit	tjiŋkodit	v
điŋkkádit	tjiŋkádit	v
điŋkulit	tjiŋkkolit	v
đoabmudit	tjoabbmodit	v
đoagganit	tjoagganit	v
đoahkkanit	tjoahkkanit	v
đoahkáidit	tjoahkájdit	v
đoahraidit	tjoahrajdit	v
đoahrihit	tjoahredit	v
đoakkašit	tjoakkatjit	v
đoakkildit	tjoakkeldit	v
đoalkalit	tjoalkkalit	v
đoalđánit	tjoalttjánit	v
đoalđđuhit	tjoaltjodit	v
đoapmuhit	tjoabmodit	v
đoarihit	tjoaredit	v
đoasihit	tjoasedit	v
đoaskkášit	tjoaskátjit	v
đoavddašit	tjoavdatjit	v
đoavjudit	tjoavjjodit	v
đoavlásit	tjoavllásit	v
đoaŋkulit	tjoaŋkkolit	v
đohkadit	tjåhkådit	v
đohkahit	tjåhkådit	v
đohkadit	tjåhkådit	v
đohkahit	tjåhkådit	v
đohkiidit	tjåhkijdit	v
đohkkestit	tjåhkkistit	v
đohkkádit	tjåhkkådit	v
đohkkáhit	tjåhkkådit	v
đohkkádit	tjåhkkådit	v
đohkkáhit	tjåhkkådit	v
đohkodit	tjåhkudit	v
đohkánit	tjåhkånit	v
đomagit	tjåmågit	v
đomastit	tjåmåstit	v
đomistit	tjåmestit	v
đoppaldit	tjåppåldit	v
đorggodit	tjårgudit	v
đođđudit	tjåddodit	v
đođđulit	tjåddolit	v
đudjosit	tjudjusit	v
đuggestit	tjuggistit	v
đuimmodit	tjujmudit	v
đuiuhit	tjujodit	v
đukkodit	tjukkudit	v
đukkoldit	tjukkuldit	v
đulkkihit	tjulkedit	v
đuohcalit	tjuohtsalit	v
đuohkudit	tjuohkodit	v
đuohpaldit	tjuohpaldit	v
đuoibmulit	tjuojmmolit	v
đuoiggaldit	tjuojgaldit	v
đuoimmuhit	tjuojmodit	v
đuoimmádit	tjuojmádit	v
đuoiaidit	tjuojajdit	v
đuoiihit	tjuojjdit	v
đuoiustit	tjuojostit	v
đuokke7hit	tjuokkedit	v
đuokkihit	tjuokkedit	v
đuokke7hit	tjuokkedit	v
đuokkihit	tjuokkedit	v
đuolbmalit	tjuolmmalit	v
đuolddahit	tjuoldadit	v
đuolddastit	tjuoldastit	v
đuolddašit	tjuoldatjit	v
đuollasit	tjuollasit	v
đuoládit	tjuoládit	v
đuonádit	tjuonádit	v
đuorbbidit	tjuorbedit	v
đuorbbášit	tjuorbátjit	v
đuorbudit	tjuorbbodit	v
đuovggildit	tjuovgeldit	v
đuovgguhit	tjuovgodit	v
đuovggášit	tjuovgátjit	v
đuozašit	tjuotsatjit	v
đurbošit	tjurbbutjit	v
đurggodit	tjurgudit	v
đurtahit	tjurttadit	v
đurttuhit	tjurtodit	v
đurvvodit	tjurvudit	v
đuskkodit	tjuskudit	v
đuvddagit	tjuvdagit	v
đuvddiidit	tjuvdijdit	v
đuvddástit	tjuvdástit	v
đuvggiidit	tjuvgijdit	v
đuvggodit	tjuvgudit	v
đuvkudit	tjuvkkodit	v
đuvodit	tjuvudit	v
đuvohahttalit	tjuvuhahttalit	v
đuvvodit	tjuvvudit	v
đuvđđagit	tjuvtjagit	v
đuđđodit	tjuttjudit	v
đužžehit	tjudtjidit	v
đábbudit	tjábbodit	v
đádjidit	tjádjedit	v
đágadit	tjágádit	v
đáhcudit	tjáhtsodit	v
đáhkadit	tjáhkadit	v
đáhpihit	tjáhpedit	v
đáhpildit	tjáhpeldit	v
đáhppádit	tjáhppádit	v
đáhppánit	tjáhppánit	v
ovdan#đáie7hit	åvddåntjájedit	v
đáie7hit	tjájedit	v
đákŋadit	tjágŋadit	v
đálgadit	tjálggadit	v
đálggihit	tjálgedit	v
đáppášit	tjáppátjit	v
đáradit	tjárádit	v
đárdnadit	tjárnnadit	v
đárvasit	tjárvvasit	v
đárvehit	tjárvvidit	v
đárvulit	tjárvvolit	v
đárvvastit	tjárvastit	v
đárvvodit	tjárvudit	v
đárvvuhit	tjárvodit	v
đárvásit	tjárvvásit	v
đárásmit	tjárásmit	v
đáskadit	tjásskadit	v
đáskalit	tjásskalit	v
đáskkadit	tjáskadit	v
đáskkihit	tjáskedit	v
đávvásit	tjávvásit	v
đáŋadit	tjáŋádit	v
đáŋahit	tjáŋádit	v
đáŋadit	tjáŋádit	v
đáŋahit	tjáŋádit	v
šalkudit	sjalkkodit	v
šalmmastit	sjalmastit	v
šealgahit	sjielggadit	v
šealgalit	sjielggalit	v
šealgge7hit	sjielgedit	v
šealggihit	sjielgedit	v
šealgge7hit	sjielgedit	v
šealggihit	sjielgedit	v
šealgguhit	sjielgodit	v
šealggádit	sjælgádit	v
šealgádit	sjælggádit	v
šealmmastit	sjielmastit	v
šealmmádit	sjælmádit	v
šeamihit	sjiemedit	v
šearasmit	sjierasmit	v
šearrahit	sjierradit	v
šeatkkastit	sjietkkastit	v
šeatkkuhit	sjietkkodit	v
šelggodit	sjelgudit	v
šerosmit	sjerusmit	v
šetkkodit	sjetkkudit	v
šiervudit	sjiervvodit	v
šiervvidit	sjiervedit	v
šiggalit	sjiggalit	v
šikkastit	sjikkastit	v
šikkodit	sjikkudit	v
šimuhit	sjimodit	v
širaidit	sjirájdit	v
širgalit	sjirggalit	v
širgguhit	sjirgodit	v
širihit	sjiredit	v
šlahttádit	slahttádit	v
šlahtádit	slahtádit	v
šleaivalit	sliejvvalit	v
šleađgalit	slierggalit	v
šleađgge7hit	sliergedit	v
šleađggihit	sliergedit	v
šleađgge7hit	sliergedit	v
šleađggihit	sliergedit	v
šleađgguhit	sliergodit	v
šleađggádit	slærgádit	v
šleaŋgalit	slieŋggalit	v
šleaŋgasit	slieŋggasit	v
šleaŋgge7hit	slieŋgedit	v
šleaŋggihit	slieŋgedit	v
šleaŋgge7hit	slieŋgedit	v
šleaŋggihit	slieŋgedit	v
šleažaidit	slietjajdit	v
šleidošit	slejddutjit	v
šleŋggodit	sleŋgudit	v
šlieddadit	slieddadit	v
šlieddahit	slieddadit	v
šlieddadit	slieddadit	v
šlieddahit	slieddadit	v
šlieddánit	slieddánit	v
šlienjihit	slienjedit	v
šliettadit	sliettadit	v
šliettihit	sliettedit	v
šliettildit	slietteldit	v
šliettuhit	sliettodit	v
šlihpardit	slihpardit	v
šliividit	slijvvedit	v
šliivvidit	slijvedit	v
šlimpasit	slimppasit	v
šlimppagit	slimpagit	v
šlimppardit	slimpardit	v
šlimppistit	slimpestit	v
šlinzzagit	slintsagit	v
šlivgasit	slivggasit	v
šlivggastit	slivgastit	v
šlivggihit	slivgedit	v
šlivggodit	slivgudit	v
šlivgguhit	slivgodit	v
šlivgásit	slivggásit	v
šliđagit	slidágit	v
šliđardit	slidárdit	v
šloahkuhit	sloahkodit	v
šloahpardit	sloahpardit	v
šloahtalit	sloahtalit	v
šloancce7hit	sloantsedit	v
šloappardit	sloappardit	v
šloavastit	slåvastit	v
šloavgalit	sloavggalit	v
šloavgge7hit	sloavgedit	v
šloavggihit	sloavgedit	v
šloavgge7hit	sloavgedit	v
šloavggihit	sloavgedit	v
šloavihit	sloavedit	v
šloađastit	slådastit	v
šloaŋgasit	sloaŋggasit	v
šloaŋggagit	sloaŋgagit	v
šloaŋggihit	sloaŋgedit	v
šloaŋgguhit	sloaŋgodit	v
šloaŋkalit	sloaŋkkalit	v
šloaŋkke7hit	sloaŋkedit	v
šloaŋkkihit	sloaŋkedit	v
šloaŋkke7hit	sloaŋkedit	v
šloaŋkkihit	sloaŋkedit	v
šloaŋkkistit	sloaŋkestit	v
šloaŋkkuhit	sloaŋkodit	v
šlubbahit	slubbadit	v
šlubbudit	slubbodit	v
šlubistit	slubestit	v
šluhpardit	sluhpardit	v
šluhpasit	sluhpasit	v
šlundahit	slunddadit	v
šlunddagit	slundagit	v
šlundduhit	slundodit	v
šlundudit	slunddodit	v
šlundádit	slunddádit	v
šlundánit	slunddánit	v
šluohkásmit	sluohkásmit	v
šluohkášit	sluohkátjit	v
šluppardit	sluppardit	v
šluppihit	sluppedit	v
šlurvvuhit	slurvodit	v
šluđđuhit	sluttjodit	v
šluđuhit	sludodit	v
šluŋkkagit	sluŋkagit	v
šluŋkkahit	sluŋkadit	v
šluŋkkistit	sluŋkestit	v
šluŋkáhit	sluŋkkádit	v
šluŋkánit	sluŋkkánit	v
šlábirdit	sláberdit	v
šlággalit	slággalit	v
šláhpardit	sláhpardit	v
šlákkihit	slákkedit	v
šlámaidit	slámájdit	v
šlámihit	slámedit	v
šlánddidit	slándedit	v
šlárbmadit	slármmadit	v
šlárvadit	slárvvadit	v
šlárvvidit	slárvedit	v
šláttardit	sláttardit	v
šlávehit	slávidit	v
šnjaggalit	snjaggalit	v
šnjakke7hit	snjakkedit	v
šnjakkuhit	snjakkodit	v
šnjalđadit	snjalttjadit	v
šnjalđđagit	snjaltjagit	v
šnjalžžagit	snjaltjagit	v
šnjalđđahit	snjaltjadit	v
šnjalžžahit	snjaltjadit	v
šnjalđđuhit	snjaltjodit	v
šnjalžžuhit	snjaltjodit	v
šnjalžadit	snjalltjadit	v
šnjalđđagit	snjaltjagit	v
šnjalžžagit	snjaltjagit	v
šnjalđđahit	snjaltjadit	v
šnjalžžahit	snjaltjadit	v
šnjalđđuhit	snjaltjodit	v
šnjalžžuhit	snjaltjodit	v
šnjarvvagit	snjarvagit	v
šnjarvvuhit	snjarvodit	v
šnjilđđagit	snjiltjagit	v
šnjilžžagit	snjiltjagit	v
šnjilđđuhit	snjiltjodit	v
šnjilžžuhit	snjiltjodit	v
šnjilđđagit	snjiltjagit	v
šnjilžžagit	snjiltjagit	v
šnjilđđuhit	snjiltjodit	v
šnjilžžuhit	snjiltjodit	v
šnjirrehit	snjirridit	v
šnjiraidit	snjirájdit	v
šnjirggádit	snjirgádit	v
šnjirihit	snjiredit	v
šnjivaidit	snjivájdit	v
šnjivgalit	snjivggalit	v
šnjivggihit	snjivgedit	v
šnjivgguhit	snjivgodit	v
šnjivihit	snjivedit	v
šnjoalccagit	snjoaltsagit	v
šnjoaraidit	snjårajdit	v
šnjoargge7hit	snjoargedit	v
šnjoarggihit	snjoargedit	v
šnjoargge7hit	snjoargedit	v
šnjoarggihit	snjoargedit	v
šnjoargguhit	snjoargodit	v
šnjuoggasit	snjuoggasit	v
šnjuokkagit	snjuokkagit	v
šnjuokkardit	snjuokkardit	v
šnjuokkuhit	snjuokkodit	v
šoambbistit	sjoambestit	v
šoavaidit	sjåvajdit	v
šoavihit	sjoavedit	v
šoavludit	sjoavllodit	v
šoaŋkkuhit	sjoaŋkodit	v
šogádit	sjågådit	v
šolgadit	sjålggådit	v
šolggiidit	sjålgijdit	v
šolirdit	sjålerdit	v
šombbistit	sjåmbestit	v
šovkkodit	sjåvkudit	v
šođbbodit	sjårbudit	v
šoŋkkuhit	sjåŋkodit	v
šuddidit	sjuddedit	v
šuldderit	sjuldirit	v
šumppihit	sjumpedit	v
šuohkašit	sjuohkatjit	v
šuoŋihit	sjuoŋedit	v
šuraidit	sjurájdit	v
šuvaidit	sjuvájdit	v
šuvgguhit	sjuvgodit	v
šuvihit	sjuvedit	v
šuvđđagit	sjuvtjagit	v
šuđaidit	sjudájdit	v
šuđihit	sjudedit	v
šállošit	sjállutjit	v
šárahit	sjárádit	v
šáraidit	sjárájdit	v
šárgalit	sjárggalit	v
šárggihit	sjárgedit	v
šárgguhit	sjárgodit	v
šárihit	sjáredit	v
šávahit	sjávádit	v
šávaidit	sjávájdit	v
šávgalit	sjávggalit	v
šávggihit	sjávgedit	v
šávgguhit	sjávgodit	v
šávihit	sjávedit	v
