sálvi^a	sálvve^a	n	
gaiba	gajbba	n	
liiba	lijbba	n	
siiba	sijbba	n	
snuiba	snujbba	n	
galba	galbba	n	
vilba	vilbba	n	
rimba	rimbba	n	
gámba	gámbba	n	
jámba	jámbba	n	
virba	virbba	n	
skárba	skárbba	n	
homofoba	håmufoba	n	
doaba	dåba	n	
čađđa	tjadda	n	
mađđa	madda	n	
loađđa	loadda	n	
snoađđa	snoadda	n	
šliedda	sliedda	n	
apart^heida	apárt^hejdda	n	
sneaida	sniejdda	n	
tiida	tijdda	n	
luođđa	luodda	n	
muođđa	muodda	n	
oarda	oardda	n	
fárda	fárdda	n	
gárda	gárdda	n	
duđđa	dudda	n	
guđđa	gudda	n	
šuđđa	sjudda	n	
guovda	guovdda	n	
ruovda	ruovdda	n	
bruvda	bruvdda	n	
rávda	rávdda	n	
skáđđa	skádda	n	
spáđđa	spádda	n	
ráđđa	rádda	n	
gráđđa	grádda	n	
iđa	ida	n	
snaidda	snajda	n	
sex-váidda	sex-vájda	n	
galda	gallda	n	
hoalda	hoallda	n	
bilda	billda	n	
muolda	muollda	n	
bindda	binda	n	
propagánda	pråpågánda	n	
radikánda	radekánda	n	
diskriminánda	diskreminánda	n	
veranda	veránda	n	
ruođa	ruoda	n	
goardda	goarda	n	
	
geardda	gierda	n	
sirdda	sirda	n	
vuordda	vuorda	n	
durdda	durda	n	
jurdda	jurda	n	
rekorda	rekurda	n	
standárda	standdárda	n	
várdda	várda	n	
metoda	metuda	n	
gavdda	gavda	n	
skavdda	skavda	n	
čoavdda	tjoavda	n	
loavdda	loavda	n	
deavdda	dievda	n	
bivdda	bivda	n	
duovdda	duovda	n	
duvdda	duvda	n	
hávdda	hávda	n	
šuhkoláda	sjuhkuláda	n	
šohkoláda	sjåhkuláda	n	
šukkoláda	sjukkuláda	n	
šukuláda	sjukuláda	n	
marináda	marenáda	n	
karbonáda	karbbunáda	n	
master^gráda	masster^gráda	n	
ambassáda	ambbassáda	n	
boađa	båda	n	
nomáda	nåmåda	n	
trofea	tråfea	n	
komitea	kåmetea	n	
disko^grafa	dissko^grafa	n	
etno^grafa	edno^grafa	n	
šeaffa	sjieffa	n	
šeriffa	sjereffa	n	
táriffa	táreffa	n	
gáifa	gájffa	n	
alfa	alffa	n	
šearfa	sjierffa	n	
skárfa	skárffa	n	
širáffa	sjiráffa	n	
deagga	diegga	n	
heagga	hiegga	n	
leagga	liegga	n	
šleagga	sliegga	n	
treagga	triegga	n	
ceagga	tsiegga	n	
taiga	tajgga	n	
teaiga	tiejgga	n	
veaiga	viejgga	n	
siiga	sijgga	n	
jalga	jalgga	n	
oalga	oalgga	n	
boalga	boalgga	n	
ealga	ielgga	n	
fealga	fielgga	n	
skielga	skielgga	n	
mielga	mielgga	n	
gilga	gilgga	n	
guolga	guolgga	n	
snuolga	snuolgga	n	
dálga	dálgga	n	
gálga	gálgga	n	
sálga	sálgga	n	
tálga	tálgga	n	
válga	válgga	n	
cuogga	tsuogga	n	
garga	gargga	n	
goarga	goargga	n	
toarga	toargga	n	
dearga	diergga	n	
fearga	fiergga	n	
jearga	jiergga	n	
čearga	tjiergga	n	
šleađga	sliergga	n	
sieđga	siergga	n	
buođga	buorgga	n	
duorga	duorgga	n	
guorga	guorgga	n	
árga	árgga	n	
áđga	árgga	n	
gárga	gárgga	n	
njárga	njárgga	n	
sáđga	sárgga	n	
cugga	tsugga	n	
leavga	lievgga	n	
divga	divgga	n	
čivga	tjivgga	n	
čuovga	tjuovgga	n	
hávga	hávgga	n	
rávga	rávgga	n	
roaŋga	roaŋgga	n	
po^eŋga	po^eŋgga	n	
po^eaŋga	po^ieŋgga	n	
geaŋga	gieŋgga	n	
laigga	lajga	n	
áigga	ájga	n	
vuolgga	vuolga	n	
álgga	álga	n	
válgga	válga	n	
paviljonga	paveljonga	n	
pedagoga	pedágoga	n	
njeađgga	njierga	n	
čeargga	tjierga	n	
šleađgga	slierga	n	
sárgga	sárga	n	
sentrifuga	sentrefuga	n	
joavgga	joavga	n	
kardaŋga	karddaŋga	n	
kavriŋga	kavrreŋga	n	
gávriŋga	gávrreŋga	n	
šárgoŋga	sjárgguŋga	n	
balkoŋga	balkkuŋga	n	
balloŋga	balluŋga	n	
betoŋga	betuŋga	n	
varjága	varjjága	n	
arkipelága	arkkepelága	n	
šlága	slága	n	
meaddja	mieddja	n	
máđidja	mádedja	n	
deadja	diedja	n	
teadja	tiedja	n	
prog.šládja	pråg.sjládja	n	
šládja	sládja	n	
veaja	vieja	n	
skuolja	skuoljja	n	
gálja	gáljja	n	
fearja	fierjja	n	
šuorja	sjuorjja	n	
árja	árjja	n	
gárja	gárjja	n	
gavja	gavjja	n	
geavja	gievjja	n	
jievja	jievjja	n	
givja	givjja	n	
rivja	rivjja	n	
uvja	uvjja	n	
suvja	suvjja	n	
káija	kájja	n	
spráija	sprájja	n	
gerilja	gerelja	n	
šállja	sjállja	n	
skuotnja	skuodnja	n	
suotnja	suodnja	n	
skátnja	skádnja	n	
spátnja	spádnja	n	
sátnja	sádnja	n	
šlienja	slienja	n	
gavdnja	gavnnja	n	
njoavdnja	njoavnnja	n	
njivdnja	njivnnja	n	
kampánnja	kamppánnja	n	
njivnnja	njivnja	n	
kampánja	kamppánja	n	
kastánja	kasstánja	n	
doarjja	doarja	n	
vikša	viksja	n	
bákša	báksja	n	
šákša	sjáksja	n	
vinša	vinsja	n	
lunša	lunsja	n	
plánša	plánsja	n	
hoašša	hoassja	n	
redišša	redessja	n	
affišša	affessja	n	
eašša	iessja	n	
deašša	diessja	n	
rišša	rissja	n	
ruošša	ruossja	n	
márša	márssja	n	
hušša	hussja	n	
tušša	tussja	n	
gášša	gássja	n	
hášša	hássja	n	
rášša	rássja	n	
reportáša	repurtásja	n	
sabotáša	sabutásja	n	
ruožža	ruodtja	n	
gužža	gudtja	n	
bieža	bietja	n	
skoahča	skoahtja	n	
roahča	roahtja	n	
spahča	spahtja	n	
rahča	rahtja	n	
giehča	giehtja	n	
čiehča	tjiehtja	n	
gihča	gihtja	n	
spihča	spihtja	n	
buohča	buohtja	n	
ruohča	ruohtja	n	
luhča	luhtja	n	
stuhča	stuhtja	n	
čakča	tjaktja	n	
rikča	riktja	n	
njukča	njuktja	n	
čukča	tjuktja	n	
smealčča	smieltja	n	
šnjilža	sjnjilltja	n	
buolža	buolltja	n	
svihčča	svihttja	n	
ráhčča	ráhttja	n	
balča	balttja	n	
šnjilča	sjnjilttja	n	
čuočča	tjuottja	n	
beavža	bievttja	n	
guovža	guovttja	n	
čuovža	tjuovttja	n	
ruvža	ruvttja	n	
ávža	ávttja	n	
rávža	rávttja	n	
dáčča	dáttja	n	
njuovčča	njuovtja	n	
dávžža	dávtja	n	
dáža	dátja	n	
dánskka-dáža	dánska-dátja	n	
láža	látja	n	
garáša	garátja	n	
etáša	etátja	n	
pistáša	pisstátja	n	
váža	vátja	n	
buovjja	buovja	n	
hallika	halleka	n	
medi^ateahka	medi^ateahka	n	
cinemateahka	cinemateahka	n	
medi^eteahka	medi^eteahka	n	
pinakoteahka	pinákoteahka	n	
kinoteahka	kinoteahka	n	
apoteahka	apoteahka	n	
hypoteahka	hypoteahka	n	
glyptoteahka	glyptoteahka	n	
artoteahka	artoteahka	n	
kartoteahka	kartoteahka	n	
fototeahka	fototeahka	n	
čiehka	tjiehka	n	
reahka	riehka	n	
veahka	viehka	n	
apteaika	apteajka	n	
apoteaika	aputeajka	n	
baška	bassjka	n	
gieška	giessjka	n	
njiška	njissjka	n	
gáška	gássjka	n	
háška	hássjka	n	
čiekka	tjiekka	n	
hallikka	hallekka	n	
šahkka	sjahkka	n	
borbehkka	bårbbehkka	n	
kubihkka	kubihkka	n	
grafihkka	grafihkka	n	
trafihkka	trafihkka	n	
logihkka	lågihkka	n	
deahkka	diehkka	n	
jeahkka	jiehkka	n	
šeahkka	sjiehkka	n	
leahkka	liehkka	n	
bleahkka	bliehkka	n	
pleahkka	pliehkka	n	
treahkka	triehkka	n	
seahkka	siehkka	n	
ciehkka	tsiehkka	n	
teahkka	tiehkka	n	
neilihkka	nejlihkka	n	
barohkka	baruhkka	n	
šáhkka	sjáhkka	n	
anoráhkka	anuráhkka	n	
baika	bajkka	n	
eaika	iejkka	n	
beaika	biejkka	n	
leaika	liejkka	n	
streaika	striejkka	n	
steaika	stiejkka	n	
veaika	viejkka	n	
greika	grejkka	n	
apo^teika	apo^tejkka	n	
ap^teika	ap^tejkka	n	
biika	bijkka	n	
liika	lijkka	n	
piika	pijkka	n	
riika	rijkka	n	
stiika	stijkka	n	
guoika	guojkka	n	
čuoika	tjuojkka	n	
áika	ájkka	n	
háika	hájkka	n	
njáika	njájkka	n	
šalka	sjalkka	n	
doalka	doalkka	n	
hoalka	hoalkka	n	
bielka	bielkka	n	
stielka	stielkka	n	
bilka	bilkka	n	
filka	filkka	n	
gilka	gilkka	n	
skilka	skilkka	n	
dulka	dulkka	n	
tulka	tulkka	n	
fylka	fylkka	n	
dálka	dálkka	n	
fálka	fálkka	n	
gálka	gálkka	n	
hálka	hálkka	n	
kálka	kálkka	n	
skálka	skálkka	n	
goarka	goarkka	n	
koarka	koarkka	n	
šearka	sjierkka	n	
mearka	mierkka	n	
vearka	vierkka	n	
gurka	gurkka	n	
hurka	hurkka	n	
árka	árkka	n	
šárka	sjárkka	n	
párka	párkka	n	
spárka	spárkka	n	
várka	várkka	n	
navka	navkka	n	
spivka	spivkka	n	
juovka	juovkka	n	
šuovka	sjuovkka	n	
suovka	suovkka	n	
cuovka	tsuovkka	n	
duvka	duvkka	n	
hávka	hávkka	n	
lávka	lávkka	n	
hoaŋka	hoaŋkka	n	
beaŋka	bieŋkka	n	
skeaŋka	skieŋkka	n	
leaŋka	lieŋkka	n	
fiŋka	fiŋkka	n	
liŋka	liŋkka	n	
miŋka	miŋkka	n	
siŋka	siŋkka	n	
skuŋka	skuŋkka	n	
luŋka	luŋkka	n	
muŋka	muŋkka	n	
puŋka	puŋkka	n	
ruŋka	ruŋkka	n	
áŋka	áŋkka	n	
báŋka	báŋkka	n	
dáŋka	dáŋkka	n	
háŋka	háŋkka	n	
ráŋka	ráŋkka	n	
skráŋka	skráŋkka	n	
táŋka	táŋkka	n	
váŋka	váŋkka	n	
pøŋka	pøŋkka	n	
cealkka	tsielka	n	
rock-funka	råck-funka	n	
oligarka	ålegarka	n	
dárkka	dárka	n	
gaskka	gaska	n	
lesbiska	lesbeska	n	
mastiska	massteska	n	
asteriska	assteriska	n	
bumeránskka	bumeránska	n	
gaska	gasska	n	
easka	iesska	n	
beaska	biesska	n	
jieska	jiesska	n	
leaska	liesska	n	
reaska	riesska	n	
diska	disska	n	
riska	risska	n	
ránska	ránsska	n	
kioska	kiosska	n	
buoska	buosska	n	
luoska	luosska	n	
guska	gusska	n	
čuska	tjusska	n	
kuska	kusska	n	
šluska	slusska	n	
ruska	russka	n	
báska	básska	n	
háska	hásska	n	
máska	másska	n	
fáskka	fáska	n	
hávkka	hávka	n	
preambela	priembbela	n	
eala	iela	n	
parallela	parállela	n	
arkipela	arkkepela	n	
koppela	kåppela	n	
epitela	epetela	n	
maila	majla	n	
e-maila	e-majla	n	
beaila	biejla	n	
feaila	fiejla	n	
leaila	liejla	n	
seaila	siejla	n	
biila	bijla	n	
vegetabiila	vegetabijla	n	
stabiila	stabijla	n	
diila	dijla	n	
krokodiila	kråkudijla	n	
fiila	fijla	n	
bifiila	bifijla	n	
heterofiila	heterofijla	n	
pedofiila	pedufijla	n	
homofiila	håmufijla	n	
profiila	pråfijla	n	
miila	mijla	n	
domisiila	dåmesijla	n	
eksiila	eksijla	n	
fissiila	fissijla	n	
missiila	missijla	n	
stensiila	stenssijla	n	
konsiila	kånssijla	n	
fossiila	fåssijla	n	
klusiila	klusijla	n	
tiila	tijla	n	
pro^sjektiila	pro^sjektijla	n	
reptiila	reptijla	n	
stiila	stijla	n	
tekstiila	tekstijla	n	
ventiila	venttijla	n	
sviila	svijla	n	
bordealla	bårddealla	n	
citadealla	tsitádealla	n	
modealla	mådealla	n	
uskealla	usskealla	n	
parallealla	parállealla	n	
karamealla	karámealla	n	
ritornealla	riturnealla	n	
personealla	perssunealla	n	
propealla	pråpealla	n	
kastealla	kasstealla	n	
kli^entealla	kli^enttealla	n	
kartealla	karttealla	n	
sportealla	spårttealla	n	
hotealla	håtealla	n	
flotealla	flåtealla	n	
motealla	måtealla	n	
novealla	nåvealla	n	
šoalla	sjoalla	n	
sigilla	sigella	n	
seremoni^ealla	seremone^iella	n	
healla	hiella	n	
šiella	sjiella	n	
spealla	spiella	n	
sealla	siella	n	
stealla	stiella	n	
vealla	viella	n	
promilla	pråmella	n	
morella	mårella	n	
basilla	basella	n	
novella	nåvella	n	
krokodilla	kråkudilla	n	
šilla	sjilla	n	
čilla	tjilla	n	
kodisilla	kådesilla	n	
codisilla	tsådesilla	n	
kodicilla	kådetsilla	n	
prohtokolla	pråhtukolla	n	
protokolla	pråtukolla	n	
parasolla	parásolla	n	
kontrolla	kåntrulla	n	
skatolla	skatulla	n	
gavla	gavlla	n	
bievla	bievlla	n	
geavla	gievlla	n	
keavla	kievlla	n	
lievla	lievlla	n	
seavla	sievlla	n	
sivla	sivlla	n	
guovla	guovlla	n	
muovla	muovlla	n	
juvla	juvlla	n	
čuvla	tjuvlla	n	
kuvla	kuvlla	n	
skuvla	skuvlla	n	
muvla	muvlla	n	
hávla	hávlla	n	
klorofylla	klårufylla	n	
šálla	sjálla	n	
korporálla	kårppurálla	n	
amfisálla	amfesálla	n	
kolesterola	kålesterola	n	
gásterola	gássterola	n	
symbola	symbbula	n	
tombola	tåmbbula	n	
idola	idula	n	
modula	mådula	n	
mongola	mångula	n	
parola	parula	n	
rucola	rutsula	n	
sievlla	sievla	n	
njivlla	njivla	n	
alkohovla	alkkuhovla	n	
guovlla	guovla	n	
čuvlla	tjuvla	n	
kuvlla	kuvla	n	
pistovla	pisstuvla	n	
lávlla	lávla	n	
sávlla	sávla	n	
makromolekyla	makrumolekyla	n	
molekyla	målekyla	n	
alkyla	alkkyla	n	
kalkyla	kalkkyla	n	
symbála	symbbála	n	
verbála	verbbála	n	
kannibála	kannebála	n	
skandála	skanddála	n	
potensiála	påtensiála	n	
tertiála	terttiála	n	
šála	sjála	n	
čála	tjála	n	
radikála	radekála	n	
kjemikála	kjemekála	n	
kemikála	kemekála	n	
musikála	musekála	n	
desimála	desemála	n	
ordinála	årddenála	n	
kriminála	krimenála	n	
terminála	termenála	n	
nominála	nåmenála	n	
urinála	urenála	n	
arsenála	arssenála	n	
finala	finála	n	
semifinála	semefinála	n	
originála	åreginála	n	
ab^originála	ab^åreginála	n	
konditionála	kånddetionála	n	
konjunktionála	kånjunktionála	n	
visuála	visoála	n	
audio-visuála	audio-visoála	n	
seksuála	seksoála	n	
rituála	ritoála	n	
partisihpála	parttesihpála	n	
admirála	admerála	n	
inte^grála	intte^grála	n	
korporála	kårppurála	n	
versála	verssála	n	
kapitála	kapetála	n	
hospitála	håsspetála	n	
kvartála	kvarttála	n	
festivála	fesstevála	n	
feastivála	fiesstevála	n	
infinitivála	infenitivála	n	
modála	mådåla	n	
pokála	påkåla	n	
vokála	våkåla	n	
morála	måråla	n	
portála	pårttåla	n	
kapitéla	kapetéla	n	
japma	jabma	n	
doapma	doabma	n	
goapma	goabma	n	
šloapma	sloabma	n	
sapma	sabma	n	
leabma	liebbma	n	
lubma	lubbma	n	
skábma	skábbma	n	
deapma	diebma	n	
jiepma	jiebma	n	
leapma	liebma	n	
liepma	liebma	n	
čipma	tjibma	n	
duopma	duobma	n	
čuopma	tjuobma	n	
luopma	luobma	n	
ruopma	ruobma	n	
suopma	suobma	n	
gupma	gubma	n	
hupma	hubma	n	
jupma	jubma	n	
šlupma	slubma	n	
volubma	vålubma	n	
spupma	spubma	n	
hápma	hábma	n	
šlápma	slábma	n	
rápma	rábma	n	
rekvi^ema	rekve^ema	n	
modema	mådema	n	
morfema	mårffema	n	
zero-morfema	tsero-mårffema	n	
problema	pråblema	n	
te^orema	te^årema	n	
krysantema	krysántema	n	
giimma	gijma	n	
galmma	galma	n	
meamma	miemma	n	
steamma	stiemma	n	
doaibma	doajmma	n	
heaibma	hiejmma	n	
hieibma	hiejmma	n	
reaibma	riejmma	n	
seaibma	siejmma	n	
liibma	lijmma	n	
miibma	mijmma	n	
synoniibma	synunijmma	n	
riibma	rijmma	n	
misseriibma	misserijmma	n	
siibma	sijmma	n	
tiibma	tijmma	n	
sáibma	sájmma	n	
jealbma	jielmma	n	
skealbma	skielmma	n	
filbma	filmma	n	
čuolbma	tjuolmma	n	
bálbma	bálmma	n	
hálbma	hálmma	n	
málbma	málmma	n	
pálbma	pálmma	n	
sálbma	sálmma	n	
foarbma	foarmma	n	
hoarbma	hoarmma	n	
stoarbma	stoarmma	n	
bearbma	biermma	n	
šearbma	sjiermma	n	
leađbma	liermma	n	
tearbma	tiermma	n	
hirbma	hirmma	n	
fuorbma	fuormma	n	
suorbma	suormma	n	
reforbma	refurmma	n	
gárbma	gármma	n	
kárbma	kármma	n	
lárbma	lármma	n	
alarbma	alármma	n	
alárbma	alármma	n	
šlárbma	slármma	n	
nárbma	nármma	n	
	n	
sjiisma	sjijssma	n	
orgasma	årggåsma	n	
algoritma	algguritma	n	
petrole^uma	petrule^uma	n	
kondoma	kåndduma	n	
kostyma	kåsstyma	n	
amalgáma	amálgáma	n	
madapoláma	madápoláma	n	
meiráma	mejráma	n	
oama	åma	n	
domeana	dåmeana	n	
moreana	måreana	n	
gatna	gadna	n	
oatna	oadna	n	
loatna	loadna	n	
spoatna	spoadna	n	
ratna	radna	n	
vuodna	vuoddna	n	
rádna	ráddna	n	
bietna	biedna	n	
jietna	jiedna	n	
leatna	liedna	n	
lietna	liedna	n	
itna	idna	n	
čitna	tjidna	n	
duotna	duodna	n	
juotna	juodna	n	
čuotna	tjuodna	n	
suotna	suodna	n	
vuotna	vuodna	n	
gutna	gudna	n	
hátna	hádna	n	
skátna	skádna	n	
látna	ládna	n	
altádna	alltádna	n	
halogena	halugena	n	
hydrogena	hydrugena	n	
nitrogena	nitrugena	n	
mutagena	mutágena	n	
eana	iena	n	
beana	biena	n	
neana	niena	n	
kveana	kviena	n	
porselena	pårsselena	n	
poly^etylena	påly^etylena	n	
acetylena	atsetylena	n	
fenomena	fenumena	n	
domena	dåmena	n	
karina	karena	n	
morena	mårena	n	
designa	desegna	n	
kantiina	kanttijna	n	
viinna	vijna	n	
vuoinna	vuojna	n	
báinna	bájna	n	
anteanna	antteanna	n	
beanna	bienna	n	
peanna	pienna	n	
kapteaidna	kapteajnna	n	
heaidna	hiejnna	n	
meaidna	miejnna	n	
lidoka^iidna	liduka^ijnna	n	
kaffe^iidna	kaffe^ijnna	n	
koffe^iidna	kåffe^ijnna	n	
kase^iidna	kase^ijnna	n	
te^iidna	te^ijnna	n	
prote^iidna	pråte^ijnna	n	
hero^iidna	hero^ijnna	n	
ligro^iidna	ligro^ijnna	n	
koka^iidna	kåkå^ijnna	n	
trombiidna	tråmbbijnna	n	
turbiidna	turbbijnna	n	
oksyhemo^globiidna	åksyhemo^glåbijnna	n	
gardiidna	garddijnna	n	
sardiidna	sarddijnna	n	
gárdiidna	gárddijnna	n	
olefiidna	ålefijnna	n	
morfiidna	mårffijnna	n	
parafiidna	paráfijnna	n	
mašiidna	masjijnna	n	
mášiidna	másjijnna	n	
auberšiidna	aubertjijnna	n	
pigskiidna	pigskijnna	n	
liidna	lijnna	n	
meskaliidna	messkalijnna	n	
turmaliidna	turmalijnna	n	
adrenaliidna	adrenalijnna	n	
gobeliidna	gåbelijnna	n	
aniliidna	anelijnna	n	
vaseliidna	vaselijnna	n	
porseliidna	pårsselijnna	n	
musseliidna	musselijnna	n	
plastiliidna	plasstelijnna	n	
veliidna	velijnna	n	
kliidna	klijnna	n	
krystalliidna	krysstallijnna	n	
vanilliidna	vanellijnna	n	
penicilliidna	penetsillijnna	n	
kaoliidna	kaolijnna	n	
disipliidna	diseplijnna	n	
popliidna	påplijnna	n	
porsliidna	pårslijnna	n	
tramboliidna	trambbulijnna	n	
globuliidna	glåbulijnna	n	
gamma^globuliidna	gamma^glåbulijnna	n	
tuberkuliidna	tuberkulijnna	n	
renoliidna	renulijnna	n	
insuliidna	inssulijnna	n	
formaliidna	fårmålijnna	n	
miidna	mijnna	n	
amiidna	amijnna	n	
indamiidna	inddamijnna	n	
kamiidna	kamijnna	n	
amfetamiidna	amfetamijnna	n	
histamiidna	hisstamijnna	n	
palmiidna	palmijnna	n	
karmiidna	karmijnna	n	
termiidna	termijnna	n	
albumiidna	albbumijnna	n	
alumiidna	alumijnna	n	
duralumiidna	durálumijnna	n	
melamiidna	melámijnna	n	
vitamiidna	vitámijnna	n	
cy^aniidna	tsy^anijnna	n	
kaniidna	kanijnna	n	
ligniidna	lignijnna	n	
kiniidna	kinijnna	n	
tanniidna	tannijnna	n	
lupiidna	lupijnna	n	
atropiidna	atrupijnna	n	
supiidna	supijnna	n	
ste^ariidna	ste^arijnna	n	
mandariidna	manddarijnna	n	
fariidna	farijnna	n	
margariidna	marggarijnna	n	
sakkariidna	sakkarijnna	n	
mariidna	marijnna	n	
nektariidna	nektarijnna	n	
antifebriidna	anttefebrijnna	n	
misseriidna	misserijnna	n	
skriidna	skrijnna	n	
sriidna	srijnna	n	
dekstriidna	dekstrijnna	n	
tamburiidna	tambburijnna	n	
syriidna	syrijnna	n	
máriidna	márijnna	n	
rosmariidna	råssmårijnna	n	
medisiidna	medesijnna	n	
offisiidna	åffesijnna	n	
resiidna	resijnna	n	
vaksiidna	vaksijnna	n	
tyroksiidna	tyruksijnna	n	
váksiidna	váksijnna	n	
di^oksiidna	di^åksijnna	n	
toksiidna	tåksijnna	n	
appelsiidna	appelsijnna	n	
pepsiidna	pepsijnna	n	
bensiidna	benssijnna	n	
streptomyciidna	streptumytsijnna	n	
dusiidna	dusijnna	n	
rusiidna	rusijnna	n	
magasiidna	magásijnna	n	
bombasiidna	båmbbåsijnna	n	
latiidna	latijnna	n	
gratiidna	gratijnna	n	
palmitiidna	palmetijnna	n	
terppetiidna	terpetijnna	n	
kitiidna	kitijnna	n	
pektiidna	pektijnna	n	
klementiidna	klementijnna	n	
serpentiidna	serppentijnna	n	
terpentiidna	terppentijnna	n	
kantiidna	kanttijnna	n	
nikotiidna	nikutijnna	n	
rutiidna	rutijnna	n	
kelatiidna	kelátijnna	n	
keratiidna	kerátijnna	n	
viidna	vijnna	n	
pingviidna	pingvijnna	n	
vuoidna	vuojnna	n	
báidna	bájnna	n	
aldna	alnna	n	
doardna	doarnna	n	
lego-doardna	lego-doarnna	n	
toardna	toarnna	n	
bierdna	biernna	n	
deardna	diernna	n	
feardna	fiernna	n	
veardna	viernna	n	
buordna	buornna	n	
duordna	duornna	n	
suordna	suornna	n	
urdna	urnna	n	
árdna	árnna	n	
kloavdna	kloavnna	n	
rievdna	rievnna	n	
elvovdna	elvvåvnnå	n	
hávdna	hávnna	n	
vávdna	vávnna	n	
kalsedona	kalssedona	n	
antifona	anttefona	n	
konsearna	konsearna	n	
konserna	konserna	n	
ikona	ikuna	n	
indiána	inddiána	n	
meridiána	merediána	n	
vulkána	vulkkána	n	
šamána	sjamána	n	
tulipána	tulepána	n	
marsipána	marssepána	n	
tulpána	tulppána	n	
altána	alltána	n	
selvána	selvvána	n	
orgána	organa	n	
orkána	årkkåna	n	
romána	råmåna	n	
sex-romána	sex-råmåna	n	
geahpa	giehpa	n	
čiehpa	tjiehpa	n	
horoskohpa	håruskohpa	n	
biotohpa	biotuhpa	n	
proto^tyhpa	pråto^tyhpa	n	
šliippa	slijpa	n	
lašpa	lasjpa	n	
albumpa	albbumpa	n	
čiehppa	tjiehppa	n	
cihppa	tsihppa	n	
cuohppa	tsuohppa	n	
deaipa	diejppa	n	
greaipa	griejppa	n	
teaipa	tiejppa	n	
greipa	grejppa	n	
teipa	tejppa	n	
diipa	dijppa	n	
skiipa	skijppa	n	
rom^skiipa	råm^skijppa	n	
šliipa	slijppa	n	
tiipa	tijppa	n	
háipa	hájppa	n	
skoalpa	skoalppa	n	
vilpa	vilppa	n	
geampa	giemppa	n	
šlimpa	slimppa	n	
bumpa	bumppa	n	
skumpa	skumppa	n	
šlumpa	slumppa	n	
pumpa	pumppa	n	
rumpa	rumppa	n	
stumpa	stumppa	n	
dámpa	dámppa	n	
kámpa	kámppa	n	
rámpa	rámppa	n	
krámpa	krámppa	n	
stámpa	stámppa	n	
goarpa	goarppa	n	
skoarpa	skoarppa	n	
soarpa	soarppa	n	
šearpa	sjierppa	n	
sirpa	sirppa	n	
árpa	árppa	n	
gárpa	gárppa	n	
hárpa	hárppa	n	
várpa	várppa	n	
bispa	bisspa	n	
dispa	disspa	n	
ráspa	rásspa	n	
miljoneara	miljjuneara	n	
mišuneara	misjuneara	n	
višuneara	visjuneara	n	
miššoneara	missjuneara	n	
kommišuneara	kåmmetjuneara	n	
offiseara	åffeseara	n	
militeara	mileteara	n	
brigadera	brigádera	n	
grenadera	grenádera	n	
safira	safera	n	
beara	biera	n	
atmo^sfeara	atmo^sfiera	n	
átmo^sfeara	átmo^sfiera	n	
tropo^sfeara	tråpo^sfiera	n	
stráhto^sfeara	stráhto^sfiera	n	
jeara	jiera	n	
peara	piera	n	
ampera	amppera	n	
opera	åpera	n	
leaira	liejra	n	
giira	gijra	n	
bankiira	bankijra	n	
satiira	satijra	n	
reviira	revijra	n	
guoira	guojra	n	
láira	lájra	n	
endofora	enddufora	n	
eksofora	eksufora	n	
anafora	anáfora	n	
metafora	metáfora	n	
humaniora	humániora	n	
revisora	revesora	n	
observatora	åbservatora	n	
redaktora	redáktora	n	
investora	invvestora	n	
amatora	amátora	n	
šnjoarra	sjnjoarra	n	
gearra	gierra	n	
kearra	kierra	n	
mearra	mierra	n	
searra	sierra	n	
vearra	vierra	n	
cihrra	tsihrra	n	
šnjirra	sjnjirra	n	
širra	sjirra	n	
šurra	sjurra	n	
gievra	gievrra	n	
čievra	tjievrra	n	
kievra	kievrra	n	
čivra	tjivrra	n	
sivra	sivrra	n	
stivra	stivrra	n	
duvra	duvrra	n	
luvra	luvrra	n	
muvra	muvrra	n	
snuvra	snuvrra	n	
tuvra	tuvrra	n	
gávra	gávrra	n	
lávra	lávrra	n	
rávra	rávrra	n	
šárra	sjárra	n	
bismárra	bissmárra	n	
proletárra	pråletárra	n	
jánovárra	jánuvárra	n	
pedi^atra	pedi^atra	n	
psyki^atra	psyki^atra	n	
inšenevra	insjenevra	n	
rešissevra	resjessevra	n	
operatevra	åperatevra	n	
inspektevra	insspektevra	n	
konduktevra	kåndduktevra	n	
redaktevra	redáktevra	n	
raportevra	rapurtevra	n	
amatevra	amátevra	n	
sivrra	sivra	n	
rámbuvra	rámbbuvra	n	
suvrra	suvra	n	
ligatuvra	ligatuvrra	n	
prosedyra	prosedyra	n	
brošyra	brosjyra	n	
martyra	martyra	n	
šáŋra	sjáŋra	n	
barbára	barbbára	n	
denara	denára	n	
seminára	semenára	n	
lavuára	lavoára	n	
honorára	hånurára	n	
cára	tsára	n	
sitara	sitára	n	
kommentára	kåmmentára	n	
dokumentára	dokumentára	n	
inventára	invventára	n	
antikvára	anttekvára	n	
boara	båra	n	
goara	gåra	n	
ambassadøra	ambbassadøra	n	
rešissøra	resjessøra	n	
observatøra	åbservatøra	n	
redaktøra	redáktøra	n	
im^portøra	im^pårttøra	n	
majonesa	majunesa	n	
syntesa	synttesa	n	
foto^syntesa	fåto^synttesa	n	
hypotesa	hyputesa	n	
paradiisa	parádijsa	n	
buliisa	bulijsa	n	
analiisa	análijsa	n	
boliisa	bålijsa	n	
poliisa	pålijsa	n	
advertiisa	advertijsa	n	
aviisa	avijsa	n	
áviisa	ávijsa	n	
sáissa	sájsa	n	
indeaksa	inddeaksa	n	
kardeaksa	karddeaksa	n	
prefiksa	prefeksa	n	
affiksa	affeksa	n	
suffiksa	suffeksa	n	
geaksa	gieksa	n	
heaksa	hieksa	n	
čeaksa	tjieksa	n	
keaksa	kieksa	n	
re^fleaksa	re^flieksa	n	
seaksa	sieksa	n	
mastriksa	mastreksa	n	
čiksa	tjiksa	n	
paradoksa	parádoksa	n	
sardonyksa	sarddunyksa	n	
syntáksa	synttáksa	n	
fonotáksa	fånutáksa	n	
hypotáksa	hyputáksa	n	
paratáksa	parátáksa	n	
impulsa	imppulsa	n	
kompetensa	kompetænssa	n	
eksistensa	eksistænssa	n	
amanuensa	amánuænssa	n	
provinsa	provinsa	n	
annonsa	annonsa	n	
responsa	resspunsa	n	
signifikánsa	signefikánsa	n	
balansa	balánsa	n	
ambulánsa	ambbulánsa	n	
assonánsa	assunánsa	n	
dissonánsa	dissunánsa	n	
konsonánsa	kånssunánsa	n	
konferánsa	kånferánsa	n	
toleránsa	tåleránsa	n	
resistánsa	resestánsa	n	
restánsa	resstánsa	n	
instánsa	insstánsa	n	
románsa	råmånsa	n	
symbiosa	symbbiosa	n	
aprikosa	aprekosa	n	
sovhoosa	såvhoosa	n	
ellipsa	ellepsa	n	
turnipsa	turnepsa	n	
šlipsa	slipsa	n	
konkursa	kånkursa	n	
diskursa	disskursa	n	
gárssa	gársa	n	
prinseassa	prinsseassa	n	
proseassa	pråseassa	n	
eassa	iessa	n	
re^greassa	re^griessa	n	
kon^greassa	kån^griessa	n	
preassa	priessa	n	
streassa	striessa	n	
abskissa	abskessa	n	
remissa	remessa	n	
premissa	premessa	n	
narsissa	narssessa	n	
kompromissa	kåmprumissa	n	
cissa	tsissa	n	
beisa	bejssa	n	
heaisa	hiejssa	n	
gneaisa	gniejssa	n	
sneaisa	sniejssa	n	
sveisa	svejssa	n	
dia^liisa	dia^lijssa	n	
niisa	nijssa	n	
riisa	rijssa	n	
kriisa	krijssa	n	
epi^kriisa	epe^krijssa	n	
viisa	vijssa	n	
máisa	májssa	n	
balsa	balssa	n	
palsa	palssa	n	
healsa	hielssa	n	
válsa	válssa	n	
goamsa	goamssa	n	
jámsa	jámssa	n	
čámsa	tjámssa	n	
prese^ansa	prese^anssa	n	
linsa	linssa	n	
prinsa	prinssa	n	
lunsa	lunssa	n	
dánsa	dánssa	n	
sjánsa	sjánssa	n	
nyánsa	nyánssa	n	
isoglossa	isuglossa	n	
albatrossa	albbatrossa	n	
noarsa	noarssa	n	
vearsa	vierssa	n	
girsa	girssa	n	
hirsa	hirssa	n	
čirsa	tjirssa	n	
bursa	burssa	n	
gursa	gurssa	n	
kursa	kurssa	n	
mársa	márssa	n	
šluvsa	sluvssa	n	
nuvsa	nuvssa	n	
bruvsa	bruvssa	n	
terassa	terássa	n	
gombássa	gåmbbåssa	n	
gompássa	gåmppåssa	n	
kompássa	kåmppåssa	n	
cuozza	tsuodtsa	n	
kreatsa	krietsa	n	
čahca	tjahtsa	n	
lahca	lahtsa	n	
goahca	goahtsa	n	
joahca	joahtsa	n	
cahca	tsahtsa	n	
vahca	vahtsa	n	
smiehca	smiehtsa	n	
gihca	gihtsa	n	
rihca	rihtsa	n	
cihca	tsihtsa	n	
juhca	juhtsa	n	
cuokca	tsuoktsa	n	
jukca	juktsa	n	
cukca	tsuktsa	n	
lákca	láktsa	n	
nákca	náktsa	n	
loahcca	loahttsa	n	
struhcca	struhttsa	n	
fáhcca	fáhttsa	n	
buica	bujttsa	n	
gáica	gájttsa	n	
nalca	nalttsa	n	
gulca	gulttsa	n	
fanca	fanttsa	n	
vanca	vanttsa	n	
garca	garttsa	n	
fierca	fierttsa	n	
vierca	vierttsa	n	
kvárca	kvárttsa	n	
javza	javttsa	n	
sávza	sávttsa	n	
civzza	tsivtsa	n	
vuovzza	vuovtsa	n	
čáza	tjátsa	n	
psykosa	psykusa	n	
applosa	applusa	n	
prognosa	prågnusa	n	
matrosa	matrusa	n	
eksosa	eksusa	n	
bavssa	bavsa	n	
snuvssa	snuvsa	n	
hypofysa	hypufysa	n	
analysa	análysa	n	
ikonostása	ikunostása	n	
topasa	tåpåsa	n	
heata	hieta	n	
cabareta	tsabáreta	n	
automahta	autumahta	n	
dearvvuohta	diervuohta	n	
nieidavuohta	niejddavuohta	n	
fáŋgavuohta	fáŋggavuohta	n	
bahčavuohta	bahtjavuohta	n	
skálkavuohta	skálkkavuohta	n	
gaskavuohta	gasskavuohta	n	
gievravuohta	gievrravuohta	n	
kievravuohta	kievrravuohta	n	
hávrravuohta	hávravuohta	n	
deskriptiivavuohta	deskreptijvavuohta	n	
šlávvavuohta	slávvavuohta	n	
čuorbivuohta	tjuorbbevuohta	n	
noaidevuohta	noajddevuohta	n	
buoidivuohta	buojddevuohta	n	
verddevuohta	verdevuohta	n	
geafivuohta	giefevuohta	n	
geaffivuohta	gieffevuohta	n	
árgivuohta	árggevuohta	n	
šláddjivuohta	sláddjevuohta	n	
lodjivuohta	lådjevuohta	n	
valljivuohta	valljevuohta	n	
vaššivuohta	vassjevuohta	n	
buoššivuohta	buossjevuohta	n	
áhččivuohta	áhttjevuohta	n	
veahkkivuohta	viehkkevuohta	n	
sáhkkivuohta	sáhkkevuohta	n	
láikivuohta	lájkkevuohta	n	
fuolkevuohta	fuolkkevuohta	n	
álkivuohta	álkkevuohta	n	
doavkivuohta	doavkkevuohta	n	
baskivuohta	basskevuohta	n	
nuoskivuohta	nuosskevuohta	n	
ropmivuohta	råbmevuohta	n	
jierbmivuohta	jiermmevuohta	n	
sámivuohta	sámevuohta	n	
eadnivuohta	ieddnevuohta	n	
vátnivuohta	vádnevuohta	n	
bárdnivuohta	bárnnevuohta	n	
unnivuohta	unnevuohta	n	
čeahppivuohta	tjiehppevuohta	n	
vearrivuohta	vierrevuohta	n	
sávrivuohta	sávrrevuohta	n	
bassivuohta	bassevuohta	n	
buohccivuohta	buohttsevuohta	n	
uhccivuohta	uhttsevuohta	n	
fastivuohta	fasstevuohta	n	
searvevuohta	siervvevuohta	n	
searvivuohta	siervvevuohta	n	
olahahttivuohta	ålåhahttivuohta	n	
sáhkkiivuohta	sáhkkijvuohta	n	
gáđašvuohta	gádasjvuohta	n	
lagašvuohta	lagasjvuohta	n	
vuollegašvuohta	vuollegasjvuohta	n	
asehašvuohta	asehasjvuohta	n	
dieđalašvuohta	diedalasjvuohta	n	
duođalašvuohta	duodalasjvuohta	n	
čearddalašvuohta	tjierdalasjvuohta	n	
genetihkalašvuohta	genetihkalasjvuohta	n	
fuolalašvuohta	fuolalasjvuohta	n	
genehtalašvuohta	genehtalasjvuohta	n	
risttalašvuohta	ristalasjvuohta	n	
kristtalašvuohta	kristalasjvuohta	n	
sápmelašvuohta	sábmelasjvuohta	n	
oktilašvuohta	åktelasjvuohta	n	
ollislašvuohta	ålleslasjvuohta	n	
beasatlašvuohta	biesatlasjvuohta	n	
ustitlašvuohta	usstetlasjvuohta	n	
álbmotlašvuohta	álmmutlasjvuohta	n	
gelbbolašvuohta	gelbulasjvuohta	n	
sirdolašvuohta	sirddulasjvuohta	n	
aiddolašvuohta	ajdulasjvuohta	n	
sirddolašvuohta	sirdulasjvuohta	n	
luđolašvuohta	ludulasjvuohta	n	
šigolašvuohta	sjigulasjvuohta	n	
barggolašvuohta	bargulasjvuohta	n	
vejolašvuohta	vejulasjvuohta	n	
čujolašvuohta	tjujulasjvuohta	n	
rihkolašvuohta	rihkulasjvuohta	n	
gulolašvuohta	gululasjvuohta	n	
almmolašvuohta	almulasjvuohta	n	
jámolašvuohta	jámulasjvuohta	n	
anolašvuohta	anulasjvuohta	n	
virolašvuohta	virulasjvuohta	n	
behtolašvuohta	behtulasjvuohta	n	
šattolašvuohta	sjattulasjvuohta	n	
govttolašvuohta	gåvtulasjvuohta	n	
máŧolašvuohta	mátulasjvuohta	n	
dorvvolašvuohta	dårvulasjvuohta	n	
agálašvuohta	agálasjvuohta	n	
vuogálašvuohta	vuogálasjvuohta	n	
girjjálašvuohta	girjálasjvuohta	n	
dilálašvuohta	dilálasjvuohta	n	
mearálašvuohta	mærálasjvuohta	n	
sogalašvuohta	sågålasjvuohta	n	
dohkálašvuohta	dåhkålasjvuohta	n	
oppalašvuohta	åppålasjvuohta	n	
ovttalašvuohta	åvtålasjvuohta	n	
válmmašvuohta	válmasjvuohta	n	
sullasašvuohta	sullasasjvuohta	n	
sadjásašvuohta	sadjásasjvuohta	n	
dássásašvuohta	dássásasjvuohta	n	
oktasašvuohta	åktåsasjvuohta	n	
gierdavašvuohta	gierddavasjvuohta	n	
duhtavašvuohta	duhtavasjvuohta	n	
dearvvašvuohta	diervasjvuohta	n	
jugešvuohta	jugesjvuohta	n	
borešvuohta	båresjvuohta	n	
várvešvuohta	várvvesjvuohta	n	
dološvuohta	dålusjvuohta	n	
olmmošvuohta	ålmusjvuohta	n	
lágášvuohta	lágásjvuohta	n	
dálášvuohta	dálásjvuohta	n	
maŋášvuohta	maŋásjvuohta	n	
hohppuivuohta	håhppujvuohta	n	
girjáivuohta	girjjájvuohta	n	
veahkkáivuohta	væhkkájvuohta	n	
hutkáivuohta	hutkájvuohta	n	
almmáivuohta	almájvuohta	n	
vuovdnáivuohta	vuovnnájvuohta	n	
borakeahttáivuohta	båråkeahttájvuohta	n	
olmmáivuohta	ålmåjvuohta	n	
viššalvuohta	vissjalvuohta	n	
čieŋalvuohta	tjieŋalvuohta	n	
suvdilvuohta	suvddelvuohta	n	
čuoddjilvuohta	tjuoddjelvuohta	n	
gillilvuohta	gillelvuohta	n	
ipmilvuohta	ibmelvuohta	n	
áicilvuohta	ájttselvuohta	n	
johtilvuohta	jåhtelvuohta	n	
gávvilvuohta	gávvelvuohta	n	
eaiggáduššanvuohta	æjgádussjanvuohta	n	
geahččalanvuohta	giehttjalanvuohta	n	
beassanvuohta	biessanvuohta	n	
buozanvuohta	buotsanvuohta	n	
ráđđenvuohta	ráddenvuohta	n	
báhkinvuohta	báhkenvuohta	n	
jápminvuohta	jábmenvuohta	n	
fertenvuohta	ferttenvuohta	n	
árkkálmastinvuohta	árkálmastinvuohta	n	
udnonvuohta	uddnunvuohta	n	
jávkameahttunvuohta	jávkkameahttunvuohta	n	
veadjemeahttunvuohta	viedjemeahttunvuohta	n	
ráhkismeahttunvuohta	ráhkesmeahttunvuohta	n	
buhtismeahttunvuohta	buhtesmeahttunvuohta	n	
áŋgirvuohta	áŋggervuohta	n	
meašttirvuohta	miesjtervuohta	n	
ealjárvuohta	æljjárvuohta	n	
borgárvuohta	bårggårvuohta	n	
váibbasvuohta	vájbasvuohta	n	
oskkáldasvuohta	åskåldasvuohta	n	
geatnegasvuohta	giednegasvuohta	n	
ávdugasvuohta	ávddugasvuohta	n	
árbmugasvuohta	ármmugasvuohta	n	
dávggasvuohta	dávgasvuohta	n	
unohasvuohta	unuhasvuohta	n	
evttohasvuohta	evtuhasvuohta	n	
joavdelasvuohta	joavddelasvuohta	n	
vuostelasvuohta	vuosstelasvuohta	n	
vuostálasvuohta	vuosstálasvuohta	n	
buozalmasvuohta	buotsalmasvuohta	n	
mihtilmasvuohta	mihtelmasvuohta	n	
válmmasvuohta	válmasvuohta	n	
iehčanasvuohta	iehtjanasvuohta	n	
divrrasvuohta	divrasvuohta	n	
hávrrasvuohta	hávrasvuohta	n	
láittasvuohta	lájtasvuohta	n	
viiddisvuohta	vijdesvuohta	n	
stirddisvuohta	stirdesvuohta	n	
láđisvuohta	ládesvuohta	n	
stáđisvuohta	stádesvuohta	n	
balahkesvuohta	baláhkesvuohta	n	
ráhkisvuohta	ráhkesvuohta	n	
goikkisvuohta	gåjkesvuohta	n	
čoahkkisvuohta	tjoahkkesvuohta	n	
rikkisvuohta	rikkesvuohta	n	
nákkisvuohta	nákkesvuohta	n	
jaskesvuohta	jasskesvuohta	n	
gielisvuohta	gielesvuohta	n	
ollisvuohta	ållesvuohta	n	
lámisvuohta	lámesvuohta	n	
rámisvuohta	rámesvuohta	n	
hánisvuohta	hánesvuohta	n	
vánisvuohta	vánesvuohta	n	
sniehpisvuohta	sniehpesvuohta	n	
boarisvuohta	boaresvuohta	n	
stuorisvuohta	stuoresvuohta	n	
viissisvuohta	vijsesvuohta	n	
bealatkeahtesvuohta	bielatkeahtesvuohta	n	
bealátkeahtesvuohta	bælátkeahtesvuohta	n	
sorjjakeahtesvuohta	sårjåkeahtesvuohta	n	
váttisvuohta	váttesvuohta	n	
oaivvesvuohta	oajvesvuohta	n	
čuovggahisvuohta	tjuovgahisvuohta	n	
doaimmahisvuohta	doajmahisvuohta	n	
vuovnnahisvuohta	vuovnahisvuohta	n	
jođihisvuohta	jådehisvuohta	n	
vigihisvuohta	vigehisvuohta	n	
sajihisvuohta	sajehisvuohta	n	
bealjehisvuohta	bieljjehisvuohta	n	
dilihisvuohta	dilehisvuohta	n	
čalmmehisvuohta	tjalmehisvuohta	n	
botnihisvuohta	bådnehisvuohta	n	
skunihisvuohta	skunehisvuohta	n	
mearehisvuohta	mierehisvuohta	n	
mearihisvuohta	mierehisvuohta	n	
visttehisvuohta	vistehisvuohta	n	
dovdduhisvuohta	dåvduhisvuohta	n	
jođuhisvuohta	jåduhisvuohta	n	
jeaguhisvuohta	jieguhisvuohta	n	
bargguhisvuohta	barguhisvuohta	n	
lihkohisvuohta	lihkuhisvuohta	n	
áimmuhisvuohta	ájmuhisvuohta	n	
udnohisvuohta	uddnuhisvuohta	n	
geainnohisvuohta	giejnuhisvuohta	n	
asttuhisvuohta	astuhisvuohta	n	
lusttuhisvuohta	lustuhisvuohta	n	
šattohisvuohta	sjattuhisvuohta	n	
šattuhisvuohta	sjattuhisvuohta	n	
doaivvuhisvuohta	doajvuhisvuohta	n	
siivvuhisvuohta	sijvuhisvuohta	n	
dorvvuhisvuohta	dårvuhisvuohta	n	
oktilisvuohta	åktelisvuohta	n	
gážžárisvuohta	gádtjárisvuohta	n	
oskkáldusvuohta	åskåldusvuohta	n	
čiegusvuohta	tjiegusvuohta	n	
almmusvuohta	almusvuohta	n	
guorosvuohta	guorusvuohta	n	
gozusvuohta	gåtsusvuohta	n	
náittusvuohta	nájtusvuohta	n	
luovosvuohta	luovusvuohta	n	
lagasvuohta	lagásvuohta	n	
birasvuohta	birásvuohta	n	
hearvásvuohta	hærvvásvuohta	n	
sorjjasvuohta	sårjåsvuohta	n	
hilbatvuohta	hilbbatvuohta	n	
vuoigatvuohta	vuojggatvuohta	n	
vielgatvuohta	vielggatvuohta	n	
njuolgatvuohta	njuolggatvuohta	n	
stargatvuohta	starggatvuohta	n	
čuovgatvuohta	tjuovggatvuohta	n	
seavdnjatvuohta	sievnnjatvuohta	n	
bealatvuohta	bielatvuohta	n	
lášmatvuohta	lássjmatvuohta	n	
eatnatvuohta	iednatvuohta	n	
heahpatvuohta	hiehpatvuohta	n	
šearratvuohta	sjierratvuohta	n	
viđetvuohta	videtvuohta	n	
vádjitvuohta	vádjetvuohta	n	
ahkitvuohta	ahketvuohta	n	
alitvuohta	aletvuohta	n	
ortnetvuohta	årnetvuohta	n	
isitvuohta	isetvuohta	n	
dássitvuohta	dássetvuohta	n	
ustitvuohta	usstetvuohta	n	
bivnnutvuohta	bivnutvuohta	n	
eaiggátvuohta	æjgátvuohta	n	
máŋggabealátvuohta	máŋgabealátvuohta	n	
bealátvuohta	bælátvuohta	n	
čorgatvuohta	tjårggåtvuohta	n	
lossatvuohta	låssåtvuohta	n	
njáiguvuohta	njájgguvuohta	n	
bonjuvuohta	bånjuvuohta	n	
olluvuohta	ålluvuohta	n	
oluvuohta	åluvuohta	n	
gomuvuohta	gåmuvuohta	n	
buohcuvuohta	buohtsuvuohta	n	
aktovuohta	aktuvuohta	n	
oktovuohta	åktuvuohta	n	
boasttovuohta	boastuvuohta	n	
boasttuvuohta	boastuvuohta	n	
boastovuohta	boasstuvuohta	n	
boastuvuohta	boasstuvuohta	n	
lahttovuohta	lahttuvuohta	n	
gábavuohta	gábávuohta	n	
hearrávuohta	hærrávuohta	n	
borakeahttávuohta	båråkeahttávuohta	n	
sohkavuohta	såhkåvuohta	n	
oktavuohta	åktåvuohta	n	
sojohta	såjuhta	n	
pilohta	piluhta	n	
kanohta	kanuhta	n	
mandáhta	manddáhta	n	
kandidáhta	kanddedáhta	n	
sulfáhta	sulffáhta	n	
antikvariáhta	anttekvariáhta	n	
predikáhta	predekáhta	n	
affrikáhta	affrekáhta	n	
advokáhta	advukáhta	n	
plákahta	plákáhta	n	
korreláhta	kårreláhta	n	
unduláhta	undduláhta	n	
konsuláhta	kånssuláhta	n	
automáhta	autumáhta	n	
ko^ordináhta	ko^årddenáhta	n	
gemináhta	gemenáhta	n	
nomináhta	nåmenáhta	n	
internáhta	intternáhta	n	
homeopáhta	håmeopáhta	n	
aristo^kráhta	aresto^kráhta	n	
lektoráhta	lekturáhta	n	
in^spektoráhta	in^spekturáhta	n	
endossáhta	enddussáhta	n	
buohkkistáhta	buohkkestáhta	n	
tomáhta	tåmåhta	n	
notáhta	nåtåhta	n	
moaitta	moajta	n	
buđeita	budejta	n	
beaitta	biejta	n	
hiitta	hijta	n	
šliitta	slijta	n	
luoitta	luojta	n	
gušta	gussjta	n	
uštta	usjta	n	
áitta	ájta	n	
láitta	lájta	n	
perfeakta	perffeakta	n	
imperfeakta	impperfeakta	n	
objeakta	åbjeakta	n	
kneakta	kniekta	n	
reakta	riekta	n	
kreakta	kriekta	n	
veakta	viekta	n	
relikta	relekta	n	
konflikta	kånflekta	n	
distrikta	distrekta	n	
ánsikta	ánssekta	n	
produkta	prådukta	n	
arte^fákta	artte^fákta	n	
šákta	sjákta	n	
šlákta	slákta	n	
kontrákta	kåntråkta	n	
kontákta	kånttåkta	n	
nalta	nallta	n	
skoalta	skoallta	n	
fealta	fiellta	n	
vealta	viellta	n	
filta	fillta	n	
šilta	sjillta	n	
silta	sillta	n	
kulta	kullta	n	
smulta	smullta	n	
málta	mállta	n	
spálta	spállta	n	
	n	
momenta	måmenta	n	
korinta	kårenta	n	
hy^asinta	hy^asenta	n	
konstituenta	kånstituenta	n	
labirinta	laberinta	n	
kommandánta	kåmmåndánta	n	
seršánta	serssjánta	n	
praktikánta	praktekánta	n	
sibilánta	sibelánta	n	
interpellánta	intterpellánta	n	
konfirmánta	kånfermánta	n	
reformánta	refurmánta	n	
informánta	infurmánta	n	
leutnánta	leudnánta	n	
konsonánta	kånssunánta	n	
partisipánta	parttesipánta	n	
kontinuánta	kånttenuánta	n	
formánta	fårmånta	n	
konseapta	kånsseapta	n	
konsepta	kånssepta	n	
konsearta	kånssearta	n	
aborta	aburta	n	
jogurta	jågurta	n	
raporta	rapurta	n	
rapporta	rappurta	n	
rápporta	ráppurta	n	
eksporta	ekspurta	n	
ráporta	rápurta	n	
inseasta	insseasta	n	
proteasta	pråteasta	n	
noastta	noasta	n	
eastta	iesta	n	
biestta	biesta	n	
meastta	miesta	n	
miestta	miesta	n	
reastta	riesta	n	
ide^alista	ide^alesta	n	
re^alista	re^alesta	n	
spesi^alista	spese^alesta	n	
sosi^alista	såse^alesta	n	
kanslista	kanslesta	n	
stylista	stylesta	n	
solista	sålesta	n	
stremista	stremesta	n	
fenno^ugrista	fenno^ugresta	n	
jurista	juresta	n	
turista	turesta	n	
nasista	nasesta	n	
rasista	rasesta	n	
grossista	gråssesta	n	
nazista	natsesta	n	
statista	statesta	n	
artista	arttesta	n	
lingvista	lingvesta	n	
sosio^lingvista	såsio^lingvesta	n	
gistta	gista	n	
evangelista	evángelista	n	
filatelista	filátelista	n	
alkoholista	alkkuholista	n	
vokalista	våkålista	n	
pessimista	pessemista	n	
optimista	åptemista	n	
feminista	femenista	n	
akšunista	aksjunista	n	
ákšunista	áksjunista	n	
penšunista	pensjunista	n	
kaušunista	kautjunista	n	
kolonista	kålunista	n	
kommunista	kåmmunista	n	
komponista	kåmppunista	n	
humanista	humánista	n	
satanista	satánista	n	
artillerista	arttellerista	n	
terrorista	terrurista	n	
seminárista	semenárista	n	
gitarista	gitárista	n	
zapatista	tsapátista	n	
vistta	vista	n	
aktivista	aktevista	n	
máistta	májsta	n	
konteaksta	kåntteaksta	n	
deaksta	dieksta	n	
teaksta	tieksta	n	
guostta	guosta	n	
kuostta	kuosta	n	
obersta	åbersta	n	
basta	bassta	n	
lasta	lassta	n	
masta	massta	n	
boasta	boassta	n	
poasta	poassta	n	
deasta	diessta	n	
feasta	fiessta	n	
heasta	hiessta	n	
jeasta	jiessta	n	
jiesta	jiessta	n	
šeasta	sjiessta	n	
reasta	riessta	n	
teasta	tiessta	n	
veasta	viessta	n	
ate^ista	ate^issta	n	
lista	lissta	n	
rista	rissta	n	
vista	vissta	n	
goansta	goanssta	n	
koansta	koanssta	n	
ruosta	ruossta	n	
gusta	gussta	n	
kusta	kussta	n	
lusta	lussta	n	
rusta	russta	n	
návsta	návssta	n	
básta	bássta	n	
gásta	gássta	n	
kásta	kássta	n	
lásta	lássta	n	
plásta	plássta	n	
kon^trásta	kon^trássta	n	
komposta	kompusta	n	
entusiásta	enttusiásta	n	
vástta	vásta	n	
deatta	dietta	n	
learretta	lierretta	n	
opportunisteahtta	opportunistæhtta	n	
šloahtta	sloahtta	n	
hábitahtta	hábitahtta	n	
kredihtta	kredihtta	n	
servi^eahtta	servi^iehtta	n	
šleahtta	sliehtta	n	
neahtta	niehtta	n	
reahtta	riehtta	n	
breahtta	briehtta	n	
seahtta	siehtta	n	
learrehtta	lierrehtta	n	
bauksihtta	bauksihtta	n	
kvarcihtta	kvarttsehtta	n	
kvárcihtta	kvárttsehtta	n	
kvantitehtta	kvanttetehtta	n	
modernitehtta	mådernitehtta	n	
inte^gritehtta	inte^gritehtta	n	
minoritehtta	minoritehtta	n	
kapasitehtta	kapásitehtta	n	
kontinuitehtta	konttenujtehtta	n	
levihtta	levehtta	n	
inu^ihtta	inu^ihtta	n	
čihtta	tjihtta	n	
krysolihtta	krysolihtta	n	
dolomihtta	dålumihtta	n	
dynamihtta	dynámihtta	n	
favorihtta	favurihtta	n	
parasihtta	parásihtta	n	
abohtta	abuhtta	n	
attribuhtta	attrebuhtta	n	
boikohtta	båjkkuhtta	n	
kalohtta	kaluhtta	n	
gonfeluhtta	gånfeluhtta	n	
konfeluhtta	kånfeluhtta	n	
konfoluhtta	kånfuluhtta	n	
konvoluhtta	kånvvuluhtta	n	
konfaluhtta	kånfåluhtta	n	
konvaluhtta	kånvvåluhtta	n	
servituhtta	servvetuhtta	n	
proselyhtta	pråselyhtta	n	
trombocyhtta	tråmbbutsyhtta	n	
hanse^áhtta	hansse^áhtta	n	
kandidáhtta	kanddedáhtta	n	
sulfáhtta	sulffáhtta	n	
njálfáhtta	njálffáhtta	n	
proletariáhtta	pråletariáhtta	n	
affrikáhtta	affrekáhtta	n	
ko^ordináhtta	ko^årddenáhtta	n	
	n	
professoráhtta	pråfessoráhtta	n	
preparáhtta	prepáráhtta	n	
hábitáhtta	hábetáhtta	n	
formáhtta	fårmåhtta	n	
tomáhtta	tåmåhtta	n	
šliita	slijtta	n	
riita	rijtta	n	
kriita	krijtta	n	
spriita	sprijtta	n	
guoita	guojtta	n	
fløita	fløjtta	n	
klieanta	klieantta	n	
foanta	foantta	n	
abituri^enta	abeture^entta	n	
kvoti^enta	kvåte^entta	n	
kli^enta	kli^entta	n	
pasi^eanta	pase^ientta	n	
kvoti^eanta	kvåte^ientta	n	
leanta	lientta	n	
reanta	rientta	n	
finta	fintta	n	
minta	mintta	n	
sprinta	sprintta	n	
vinta	vintta	n	
bunta	buntta	n	
lunta	luntta	n	
bánta	bántta	n	
liánta	liántta	n	
bliánta	bliántta	n	
kánta	kántta	n	
dia^mánta	dia^mántta	n	
pánta	pántta	n	
ruoŧŧa	ruotta	n	
barta	bartta	n	
doarta	doartta	n	
goarta	goartta	n	
id-goarta	id-goartta	n	
koarta	koartta	n	
poarta	poartta	n	
soarta	soartta	n	
earta	iertta	n	
bierta	biertta	n	
hearta	hiertta	n	
jearta	jiertta	n	
vearta	viertta	n	
nuorta	nuortta	n	
urta	urtta	n	
smurta	smurtta	n	
árta	ártta	n	
fárta	fártta	n	
gárta	gártta	n	
kárta	kártta	n	
skárta	skártta	n	
stárta	stártta	n	
kvárta	kvártta	n	
hurttiruvtta	hurteruvtta	n	
selota	seluta	n	
lavtta	lavta	n	
terapevta	terápevta	n	
buvtta	buvta	n	
ruvtta	ruvta	n	
skruvtta	skruvta	n	
sruvtta	sruvta	n	
astronávta	astrunávta	n	
neava	nieva	n	
breava	brieva	n	
doaivva	doajva	n	
seaivva	siejva	n	
suoivva	suojva	n	
oblikva	åblekva	n	
gilvva	gilva	n	
konsearva	kånssearva	n	
sarvva	sarva	n	
dearvva	dierva	n	
šoavva	sjoavva	n	
neavva	nievva	n	
greavva	grievva	n	
veavva	vievva	n	
šnjivva	sjnjivva	n	
veaiva	viejvva	n	
greiva	grejvva	n	
liiva	lijvva	n	
skuoiva	skuojvva	n	
suoiva	suojvva	n	
sáiva	sájvva	n	
alva	alvva	n	
balva	balvva	n	
goalva	goalvva	n	
gealva	gielvva	n	
buolva	buolvva	n	
duolva	duolvva	n	
álva	álvva	n	
gálva	gálvva	n	
sálva	sálvva	n	
arva	arvva	n	
sarva	sarvva	n	
hearva	hiervva	n	
nearva	niervva	n	
kurva	kurvva	n	
báđva	bárvva	n	
hárva	hárvva	n	
čárva	tjárvva	n	
kárva	kárvva	n	
šlárva	slárvva	n	
šuvva	sjuvva	n	
šávva	sjávva	n	
šlávva	slávva	n	
bustávva	busstávva	n	
bokstávva	båkståvva	n	
šláva	sláva	n	
skandináva	skanddenáva	n	
poava	påva	n	
oktáva	åktåva	n	
šakŋa	sjagŋa	n	
cakŋa	tsagŋa	n	
vakŋa	vagŋa	n	
diekŋa	diegŋa	n	
jiekŋa	jiegŋa	n	
siekŋa	siegŋa	n	
dikŋa	digŋa	n	
čikŋa	tjigŋa	n	
buokŋa	buogŋa	n	
šuokŋa	sjuogŋa	n	
ruokŋa	ruogŋa	n	
eaŋŋa	ieŋŋa	n	
po^eaŋŋa	po^ieŋŋa	n	
jeaŋŋa	jieŋŋa	n	
vikiŋŋa	vikeŋŋa	n	
vuoigŋa	vuojŋŋa	n	
algŋa	alŋŋa	n	
jargŋa	jarŋŋa	n	
šargoŋŋa	sjargguŋŋa	n	
šárgoŋŋa	sjárgguŋŋa	n	
baloŋŋa	baluŋŋa	n	
balloŋŋa	balluŋŋa	n	
tampoŋŋa	tamppuŋŋa	n	
kupoŋŋa	kupuŋŋa	n	
sesoŋŋa	sesuŋŋa	n	
šláŋŋa	sláŋŋa	n	
restauráŋŋa	resstauráŋŋa	n	
restoráŋŋa	ressturáŋŋa	n	
komitéa	kåmetéa	n	
apart^heid	apárt^hejd	n	
standard	standdard	n	
snow^board	snåw^board	n	
standárd	standdárd	n	
njabbi	njabbe	n	
soabbi	soabbe	n	
cabbi	tsabbe	n	
čibbi	tjibbe	n	
roaibi	roajbbe	n	
leaibi	liejbbe	n	
seaibi	siejbbe	n	
niibi	nijbbe	n	
siibe	sijbbe	n	
suoibi	suojbbe	n	
skuibi	skujbbe	n	
ruibi	rujbbe	n	
gáibi	gájbbe	n	
láibi	lájbbe	n	
njalbi	njalbbe	n	
boalbi	boalbbe	n	
bealbi	bielbbe	n	
bielbi	bielbbe	n	
guolbi	guolbbe	n	
gálbi	gálbbe	n	
válbi	válbbe	n	
holbi	hålbbe	n	
rámbi	rámbbe	n	
rombe	råmbbe	n	
ruobbi	ruobbe	n	
beađbi	bierbbe	n	
vuorbi	vuorbbe	n	
urbi	urbbe	n	
árbi	árbbe	n	
njárbe	njárbbe	n	
gubbi	gubbe	n	
čábbe	tjábbe	n	
rábbi	rábbe	n	
hobbi	håbbe	n	
čeabi	tjiebe	n	
siibbe	sijbe	n	
stobe	ståbe	n	
šukkulade	sjukkulade	n	
stadi	stade	n	
addi	adde	n	
haddi	hadde	n	
lađđi	ladde	n	
mađđi	madde	n	
oađđi	oadde	n	
njoađđi	njoadde	n	
skoađđi	skoadde	n	
noađđi	noadde	n	
roađđi	roadde	n	
raddi	radde	n	
duhkaraddi	duhkaradde	n	
duhkoraddi	duhkuradde	n	
saddi	sadde	n	
beađđi	biedde	n	
feaddi	fiedde	n	
gieddi	giedde	n	
geađđi	giedde	n	
gieđđi	giedde	n	
lieđđi	liedde	n	
readdi	riedde	n	
seađđi	siedde	n	
veaddi	viedde	n	
biddi	bidde	n	
diddi	didde	n	
noaidi	noajdde	n	
geaidi	giejdde	n	
sieidi	siejdde	n	
riidi	rijdde	n	
buoidi	buojdde	n	
áidi	ájdde	n	
báidi	bájdde	n	
t-báidi	t-bájdde	n	
gáidi	gájdde	n	
njáide	njájdde	n	
skáidi	skájdde	n	
láidi	lájdde	n	
ráidi	rájdde	n	
sáidi	sájdde	n	
váidi	vájdde	n	
soandi	soandde	n	
meandi	miendde	n	
reandi	riendde	n	
rindi	rindde	n	
sundi	sundde	n	
duoddi	duodde	n	
guoddi	guodde	n	
ruođđi	ruodde	n	
dardi	dardde	n	
soardi	soardde	n	
geardi	gierdde	n	
meardi	mierdde	n	
veardi	vierdde	n	
girdi	girdde	n	
stirdi	stirdde	n	
virdi	virdde	n	
urdi	urdde	n	
durdi	durdde	n	
nurdi	nurdde	n	
bárdi	bárdde	n	
gárdi	gárdde	n	
sárdi	sárdde	n	
ordi	årdde	n	
bordi	bårdde	n	
buddi	budde	n	
duddi	dudde	n	
šuddi	sjudde	n	
čuđđi	tjudde	n	
molsašuddi	målssåtjudde	n	
ruddi	rudde	n	
suddi	sudde	n	
jierástuddi	jierástudde	n	
boavdi	boavdde	n	
goavdi	goavdde	n	
skoavdi	skoavdde	n	
beavdi	bievdde	n	
jeavdi	jievdde	n	
njeavdi	njievdde	n	
lievdi	lievdde	n	
bivdi	bivdde	n	
guovdi	guovdde	n	
luovdi	luovdde	n	
ruovdi	ruovdde	n	
suovdi	suovdde	n	
vuovdi	vuovdde	n	
čuvdi	tjuvdde	n	
suvdi	suvdde	n	
dávdi	dávdde	n	
gávdi	gávdde	n	
hávdi	hávdde	n	
lávdi	lávdde	n	
návdi	návdde	n	
rávdi	rávdde	n	
dovdi	dåvdde	n	
báddi	bádde	n	
dáđđi	dádde	n	
gáddi	gádde	n	
láddi	ládde	n	
láđđi	ládde	n	
bláđđi	bládde	n	
máddi	mádde	n	
ráddi	rádde	n	
ráđđi	rádde	n	
stáđđi	stádde	n	
bođđi	bådde	n	
goddi	gådde	n	
čođđi	tjådde	n	
loddi	lådde	n	
mođđi	mådde	n	
soddi	sådde	n	
sođđi	sådde	n	
leade	liede	n	
šaldi	sjallde	n	
smoaldi	smoallde	n	
dealdi	diellde	n	
dildi	dillde	n	
spildi	spillde	n	
sildi	sillde	n	
duoldi	duollde	n	
buldi	bullde	n	
muldi	mullde	n	
fáldi	fállde	n	
háldi	hállde	n	
váldi	vállde	n	
doldi	dållde	n	
moldi	mållde	n	
mástorándi	mássturánde	n	
bondde	bånde	n	
verdde	verde	n	
šuhkoláde	sjuhkuláde	n	
šukkoláde	sjukkuláde	n	
jode	jåde	n	
skuolfi	skuolffe	n	
bolfi	bålffe	n	
barfi	barffe	n	
darfi	darffe	n	
jarfi	jarffe	n	
smarfi	smarffe	n	
loarfi	loarffe	n	
bierfi	bierffe	n	
lurfi	lurffe	n	
márfi	márffe	n	
várfi	várffe	n	
ráffi	ráffe	n	
áfi	áfe	n	
ráfi	ráfe	n	
heage	hiege	n	
baggi	bagge	n	
faggi	fagge	n	
jaggi	jagge	n	
laggi	lagge	n	
boaggi	boagge	n	
čoaggi	tjoagge	n	
loaggi	loagge	n	
moaggi	moagge	n	
soaggi	soagge	n	
spaggi	spagge	n	
caggi	tsagge	n	
beaggi	biegge	n	
deaggi	diegge	n	
gieggi	giegge	n	
jeaggi	jiegge	n	
leaggi	liegge	n	
diggi	digge	n	
riggi	rigge	n	
goaigi	goajgge	n	
dieigi	diejgge	n	
veaigi	viejgge	n	
liigi	lijgge	n	
juoigi	juojgge	n	
čuoigi	tjuojgge	n	
áigi	ájgge	n	
dáigi	dájgge	n	
gáigi	gájgge	n	
láigi	lájgge	n	
ráigi	rájgge	n	
oalgi	oalgge	n	
bealgi	bielgge	n	
dealgi	dielgge	n	
dielgi	dielgge	n	
čielgi	tjielgge	n	
nealgi	nielgge	n	
sealgi	sielgge	n	
vealgi	vielgge	n	
šelge	sjelgge	n	
juolgi	juolgge	n	
dolgi	dålgge	n	
njolgi	njålgge	n	
smolge	smålgge	n	
solgi	sålgge	n	
buoggi	buogge	n	
duoggi	duogge	n	
guoggi	guogge	n	
bargi	bargge	n	
čoađgi	tjoargge	n	
fiergi	fiergge	n	
geargi	giergge	n	
geađgi	giergge	n	
heargi	hiergge	n	
viergi	viergge	n	
irgi	irgge	n	
virgi	virgge	n	
post-doc-virgi	påst-dåc-virgge	n	
suorgi	suorgge	n	
čurge	tjurgge	n	
sárgi	sárgge	n	
sáđgi	sárgge	n	
borgi	bårgge	n	
čorgi	tjårgge	n	
buggi	bugge	n	
juggi	jugge	n	
njavge	njavgge	n	
bivgi	bivgge	n	
huvgi	huvgge	n	
dávgi	dávgge	n	
šávge	sjávgge	n	
gaŋgi	gaŋgge	n	
njaŋgi	njaŋgge	n	
doaŋgi	doaŋgge	n	
heŋge	heŋgge	n	
deaŋgi	dieŋgge	n	
leŋge	leŋgge	n	
njáŋgi	njáŋgge	n	
goŋge	gåŋgge	n	
roŋge	råŋgge	n	
ággi	ágge	n	
bággi	bágge	n	
dággi	dágge	n	
fággi	fágge	n	
gággi	gágge	n	
nággi	nágge	n	
rággi	rágge	n	
sággi	ságge	n	
vággi	vágge	n	
boggi	bågge	n	
doggi	dågge	n	
smoggi	smågge	n	
roggi	rågge	n	
soggi	sågge	n	
seargge	sierge	n	
prog.suorgi	pråg.suorge	n	
boahi	boahe	n	
rahi	rahe	n	
geahi	giehe	n	
bihi	bihe	n	
aji	aje	n	
badji	badje	n	
máđeadji	mádeadje	n	
soadji	soadje	n	
sadji	sadje	n	
juogadeaddji	juogadeaddje	n	
iskkadeaddji	iskadeaddje	n	
časkadeaddji	tjasskadeaddje	n	
guoradeaddji	guoradeaddje	n	
immuneastadeaddji	immuneastadeaddje	n	
buvttadeaddji	buvtadeaddje	n	
lágideaddji	lágedeaddje	n	
gearjideaddji	gierjjedeaddje	n	
bilkideaddji	bilkkedeaddje	n	
sárdnideaddji	sárnnedeaddje	n	
sivdnideaddji	sivnnedeaddje	n	
doarrideaddji	doarredeaddje	n	
fievrredeaddji	fievredeaddje	n	
uhcideaddji	uhtsedeaddje	n	
goasttedeaddji	goastedeaddje	n	
goasttideaddji	goastedeaddje	n	
koasttedeaddji	koastedeaddje	n	
koasttideaddji	koastedeaddje	n	
vástideaddji	vásstedeaddje	n	
šloavaideaddji	slåvajdeaddje	n	
oaivvildeaddji	oajveldeaddje	n	
buđaldeaddji	budáldeaddje	n	
áittardeaddji	ájtardeaddje	n	
geardudeaddji	gierddudeaddje	n	
nealgudeaddji	nielggudeaddje	n	
dálkkodeaddji	dálkudeaddje	n	
bagadeaddji	bagádeaddje	n	
eaiggádeaddji	æjgádeaddje	n	
gažadeaddji	gatjádeaddje	n	
boradeaddji	bårådeaddje	n	
čuoiggaheaddji	tjuojgaheaddje	n	
barggaheaddji	bargaheaddje	n	
čuojaheaddji	tjuojaheaddje	n	
fuolaheaddji	fuolaheaddje	n	
doaimmaheaddji	doajmaheaddje	n	
duolmmaheaddji	duolmaheaddje	n	
oahpaheaddji	oahpaheaddje	n	
buozaheaddji	buotsaheaddje	n	
juovssaheaddji	juovsaheaddje	n	
geavaheaddji	gievaheaddje	n	
jođiheaddji	jådeheaddje	n	
vuojeheaddji	vuojeheaddje	n	
veahkeheaddji	viehkeheaddje	n	
stevnneheaddji	stevneheaddje	n	
hukseheaddji	hukseheaddje	n	
bisseheaddji	bisseheaddje	n	
goziheaddji	gåtseheaddje	n	
guotteheaddji	guotteheaddje	n	
guođoheaddji	guoduheaddje	n	
velggoheaddji	velguheaddje	n	
namuheaddji	namuheaddje	n	
fámuheaddji	fámuheaddje	n	
ánuheaddji	ánuheaddje	n	
guossoheaddji	guossuheaddje	n	
duostuheaddji	duosstuheaddje	n	
dagaheaddji	dagáheaddje	n	
gulaheaddji	guláheaddje	n	
ásaheaddji	ásáheaddje	n	
hohkaheaddji	håhkåheaddje	n	
golaheaddji	gålåheaddje	n	
máhtajeaddji	máhtajeaddje	n	
árbejeaddji	árbbejeaddje	n	
jeđđejeaddji	jeddejeaddje	n	
láidejeaddji	lájddejeaddje	n	
luddejeaddji	luddejeaddje	n	
hovdejeaddji	håvddejeaddje	n	
báddejeaddji	báddejeaddje	n	
ráđđejeaddji	ráddejeaddje	n	
čilgejeaddji	tjilggejeaddje	n	
biđgejeaddji	birggejeaddje	n	
čorgejeaddji	tjårggejeaddje	n	
láddjejeaddji	láddjejeaddje	n	
válljejeaddji	válljejeaddje	n	
suhččejeaddji	suhttjejeaddje	n	
fillejeaddji	fillejeaddje	n	
sállejeaddji	sállejeaddje	n	
málejeaddji	málejeaddje	n	
molejeaddji	målejeaddje	n	
sorbmejeaddji	sårmmejeaddje	n	
ordnejeaddji	årnnejeaddje	n	
plánejeaddji	plánejeaddje	n	
guhppejeaddji	guhppejeaddje	n	
gávpejeaddji	gávppejeaddje	n	
sirrejeaddji	sirrejeaddje	n	
murrejeaddji	murrejeaddje	n	
stivrejeaddji	stivrrejeaddje	n	
muvrejeaddji	muvrrejeaddje	n	
ruhttejeaddji	ruhttejeaddje	n	
gáhttejeaddji	gáhttejeaddje	n	
govvejeaddji	gåvvejeaddje	n	
dallegustojeaddji	dallegustojeaddje	n	
hálddašeaddji	háldatjeaddje	n	
gonstošeaddji	gånsstutjeaddje	n	
diŋgojeaddji	diŋggujeaddje	n	
dárkojeaddji	dárkkujeaddje	n	
lávlojeaddji	lávllujeaddje	n	
veaddjájeaddji	væddjájeaddje	n	
máhttájeaddji	máhttájeaddje	n	
guoddaleaddji	guoddaleaddje	n	
guldaleaddji	gulldaleaddje	n	
doarjaleaddji	doarjjaleaddje	n	
geahččaleaddji	giehttjaleaddje	n	
bassaleaddji	bassaleaddje	n	
muitaleaddji	mujttaleaddje	n	
mun-muitaleaddji	mun-mujttaleaddje	n	
bálvaleaddji	bálvvaleaddje	n	
vuodjeleaddji	vuodjeleaddje	n	
vuodjileaddji	vuodjeleaddje	n	
vuostáleaddji	vuosstáleaddje	n	
johtaleaddji	jåhtåleaddje	n	
johttáleaddji	jåhttåleaddje	n	
buorráneaddji	buorráneaddje	n	
báhtareaddji	báhtareaddje	n	
veastareaddji	viesstareaddje	n	
buleteaddji	buleteaddje	n	
politeaddji	påleteaddje	n	
duođašteaddji	duodasjteaddje	n	
mieđušteaddji	miedusjteaddje	n	
diđošteaddji	didusjteaddje	n	
bealušteaddji	bielusjteaddje	n	
valášteaddji	valásjteaddje	n	
morašteaddji	måråsjteaddje	n	
jieanasteaddji	jieanasteaddje	n	
jienasteaddji	jienasteaddje	n	
láidesteaddji	lájddesteaddje	n	
duvddesteaddji	duvdesteaddje	n	
dárkkisteaddji	dárkesteaddje	n	
lonisteaddji	lånesteaddje	n	
oahpisteaddji	oahpesteaddje	n	
gaskkusteaddji	gaskusteaddje	n	
einnosteaddji	ejnusteaddje	n	
njoarosteaddji	njoarusteaddje	n	
guolásteaddji	guolásteaddje	n	
ovddasteaddji	åvdåsteaddje	n	
eaddji	ieddje	n	
vuoddji	vuoddje	n	
šláddji	sláddje	n	
ráddji	ráddje	n	
leadji	liedje	n	
veadji	viedje	n	
duodji	duodje	n	
šuodji	sjuodje	n	
suodji	suodje	n	
gudji	gudje	n	
ádji	ádje	n	
bádji	bádje	n	
rádji	rádje	n	
modji	mådje	n	
sodji	sådje	n	
boahji	boahje	n	
láhji	láhje	n	
oarji	oarjje	n	
jearji	jierjje	n	
girje	girjje	n	
girji	girjje	n	
viđji	virjje	n	
muorji	muorjje	n	
durji	durjje	n	
sturji	sturjje	n	
árji	árjje	n	
gárji	gárjje	n	
hárji	hárjje	n	
sárji	sárjje	n	
borji	bårjje	n	
sorji	sårjje	n	
boavji	boavjje	n	
čoavji	tjoavjje	n	
ruovji	ruovjje	n	
ávji	ávjje	n	
vallji	vallje	n	
beallji	biellje	n	
billji	billje	n	
duollji	duollje	n	
bullji	bullje	n	
mállji	mállje	n	
dollji	dållje	n	
latnji	ladnje	n	
boadnji	boaddnje	n	
readnji	rieddnje	n	
vitnji	vidnje	n	
látnji	ládnje	n	
botnji	bådnje	n	
lotnji	lådnje	n	
sotnji	sådnje	n	
mannji	mannje	n	
oardnji	oarnnje	n	
skurdnji	skurnnje	n	
lavdnji	lavnnje	n	
doavdnji	doavnnje	n	
skoavdnji	skoavnnje	n	
roavdnji	roavnnje	n	
eavdnji	ievnnje	n	
givdnji	givnnje	n	
skivdnji	skivnnje	n	
rivdnji	rivnnje	n	
guovdnji	guovnnje	n	
suovdnji	suovnnje	n	
guvdnji	guvnnje	n	
skuvdnji	skuvnnje	n	
luvdnji	luvnnje	n	
gávdnji	gávnnje	n	
rávdnji	rávnnje	n	
el-rávdnji	el-rávnnje	n	
sávdnji	sávnnje	n	
čuonji	tjuonje	n	
bikši	biksje	n	
vašši	vassje	n	
njeašši	njiessje	n	
reašši	riessje	n	
hoalši	hoalssje	n	
šealši	sjielssje	n	
gilši	gilssje	n	
vilši	vilssje	n	
vuolši	vuolssje	n	
šulši	sjulssje	n	
loamši	loamssje	n	
roamši	roamssje	n	
limši	limssje	n	
guošši	guossje	n	
ruošši	ruossje	n	
marši	marssje	n	
duorši	duorssje	n	
bárši	bárssje	n	
dušši	dussje	n	
ášši	ássje	n	
sex-ášši	sex-ássje	n	
njášši	njássje	n	
drošše	dråssje	n	
háše	hásje	n	
oažži	oadtje	n	
doažži	doadtje	n	
loažži	loadtje	n	
speažži	spiedtje	n	
steažži	stiedtje	n	
gižži	gidtje	n	
njižži	njidtje	n	
čižži	tjidtje	n	
vuožži	vuodtje	n	
ružži	rudtje	n	
skahči	skahtje	n	
skoahči	skoahtje	n	
spahči	spahtje	n	
geahči	giehtje	n	
šuhči	sjuhtje	n	
skuhči	skuhtje	n	
suhči	suhtje	n	
gohči	gåhtje	n	
skohči	skåhtje	n	
rohči	råhtje	n	
stohči	ståhtje	n	
gakči	gaktje	n	
njakči	njaktje	n	
roakči	roaktje	n	
čiekči	tjiektje	n	
leakši	liektje	n	
šleakči	sliektje	n	
reakči	riektje	n	
buokči	buoktje	n	
lákči	láktje	n	
šnjalži	sjnjalltje	n	
šnjilži	sjnjilltje	n	
skilži	skilltje	n	
bulži	bulltje	n	
spulži	spulltje	n	
molži	målltje	n	
ranči	rantje	n	
rinči	rintje	n	
ránči	rántje	n	
bahčči	bahttje	n	
geahčči	giehttje	n	
spiehčči	spiehttje	n	
skihčči	skihttje	n	
smuhčči	smuhttje	n	
áhčči	áhttje	n	
báhčči	báhttje	n	
gáhčči	gáhttje	n	
váhčči	váhttje	n	
bohčči	båhttje	n	
njalči	njalttje	n	
šnjalči	sjnjalttje	n	
boalči	boalttje	n	
čoalči	tjoalttje	n	
vealči	vielttje	n	
smilči	smilttje	n	
steanži	stienttje	n	
stánži	stánttje	n	
skoarči	skoarttje	n	
dirči	dirttje	n	
skirči	skirttje	n	
skurči	skurttje	n	
hárči	hárttje	n	
gorži	gårttje	n	
morči	mårttje	n	
gavži	gavttje	n	
skavži	skavttje	n	
čeavži	tjievttje	n	
skeavži	skievttje	n	
reavži	rievttje	n	
steavži	stievttje	n	
skivži	skivttje	n	
ávži	ávttje	n	
lávži	lávttje	n	
ahki	ahke	n	
jahki	jahke	n	
njahki	njahke	n	
čahki	tjahke	n	
goahki	goahke	n	
loahki	loahke	n	
šloahki	sloahke	n	
soahki	soahke	n	
coahki	tsoahke	n	
sahki	sahke	n	
eahki	iehke	n	
heahki	hiehke	n	
leahki	liehke	n	
seahki	siehke	n	
vihki	vihke	n	
duohki	duohke	n	
čuohki	tjuohke	n	
ruohki	ruohke	n	
vuohki	vuohke	n	
jáhki	jáhke	n	
láhki	láhke	n	
snáhki	snáhke	n	
ráhki	ráhke	n	
váhki	váhke	n	
ohki	åhke	n	
bohki	båhke	n	
lohki	låhke	n	
cohki	tsåhke	n	
limški	limssjke	n	
rimški	rimssjke	n	
rámški	rámssjke	n	
ruški	russjke	n	
dáški	dássjke	n	
njáški	njássjke	n	
loški	låssjke	n	
dahkki	dahkke	n	
lahkki	lahkke	n	
doahkki	doahkke	n	
čoahkki	tjoahkke	n	
loahkki	loahkke	n	
roahkki	roahkke	n	
rahkki	rahkke	n	
biehkki	biehkke	n	
deahkki	diehkke	n	
jiehkki	jiehkke	n	
skiehkki	skiehkke	n	
miehkki	miehkke	n	
niehkki	niehkke	n	
riehkki	riehkke	n	
ceahkki	tsiehkke	n	
veahkki	viehkke	n	
viehkki	viehkke	n	
dihkki	dihkke	n	
buohkki	buohkke	n	
guohkki	guohkke	n	
juohkki	juohkke	n	
luohkki	luohkke	n	
snuohkki	snuohkke	n	
cuohkki	tsuohkke	n	
uhkki	uhkke	n	
duhkki	duhkke	n	
juhkki	juhkke	n	
muhkki	muhkke	n	
báhkki	báhkke	n	
dáhkki	dáhkke	n	
láhkki	láhkke	n	
náhkki	náhkke	n	
lohkki	låhkke	n	
mohkki	måhkke	n	
rohkki	råhkke	n	
stohkki	ståhkke	n	
veaiki	viejkke	n	
liiki	lijkke	n	
duoiki	duojkke	n	
báiki	bájkke	n	
stáiki	stájkke	n	
goalki	goalkke	n	
moalki	moalkke	n	
mielki	mielkke	n	
spielki	spielkke	n	
cealki	tsielkke	n	
silki	silkke	n	
fuolki	fuolkke	n	
bulki	bulkke	n	
dálki	dálkke	n	
snolki	snålkke	n	
cearki	tsierkke	n	
vearki	vierkke	n	
vierki	vierkke	n	
snirki	snirkke	n	
sirki	sirkke	n	
cirki	tsirkke	n	
nurki	nurkke	n	
márki	márkke	n	
snárki	snárkke	n	
norke	nårkke	n	
norki	nårkke	n	
njavki	njavkke	n	
lavki	lavkke	n	
goavki	goavkke	n	
hoavki	hoavkke	n	
noavki	noavkke	n	
gievke	gievkke	n	
mievki	mievkke	n	
neavki	nievkke	n	
nievki	nievkke	n	
rievki	rievkke	n	
ruvke	ruvkke	n	
ruvki	ruvkke	n	
ávki	ávkke	n	
lávke	lávkke	n	
lávki	lávkke	n	
rávki	rávkke	n	
faŋki	faŋkke	n	
goaŋki	goaŋkke	n	
šoaŋki	sjoaŋkke	n	
roaŋki	roaŋkke	n	
vaŋki	vaŋkke	n	
veaŋki	vieŋkke	n	
siŋke	siŋkke	n	
duŋke	duŋkke	n	
luŋki	luŋkke	n	
šluŋki	sluŋkke	n	
aski	asske	n	
boaski	boasske	n	
goaski	goasske	n	
njoaski	njoasske	n	
roaski	roasske	n	
easki	iesske	n	
beaski	biesske	n	
fieski	fiesske	n	
rieski	riesske	n	
vieski	viesske	n	
niski	nisske	n	
siski	sisske	n	
guiski	gujsske	n	
báiski	bájsske	n	
gáiski	gájsske	n	
ráiski	rájsske	n	
rámski	rámsske	n	
nuoski	nuosske	n	
dorski	dårsske	n	
uski	usske	n	
duski	dusske	n	
áski	ásske	n	
moski	måsske	n	
roski	råsske	n	
joatki	joatke	n	
geatki	gietke	n	
meatki	mietke	n	
muotki	muotke	n	
butki	butke	n	
dutki	dutke	n	
hutki	hutke	n	
mátki	mátke	n	
bišáŋke	bisjáŋke	n	
kara^oke	kara^åke	n	
ensemble	enssemble	n	
meänkieli	meänkiele	n	
bihli	bihle	n	
gihli	gihle	n	
koaili	koajle	n	
biile	bijle	n	
váili	vájle	n	
duhkordalli	duhkurdalle	n	
bagadalli	bagádalle	n	
doarrádalli	doarrádalle	n	
oarpmealle	oarmealle	n	
oarpmealli	oarmealle	n	
gieđahalli	giedahalle	n	
álggahalli	álgahalle	n	
gilvvohalli	gilvuhalle	n	
čájáhalli	tjájáhalle	n	
njalli	njalle	n	
nalli	nalle	n	
oalli	oalle	n	
doalli	doalle	n	
čoalli	tjoalle	n	
leaikkastalli	liejkastalle	n	
bissostalli	bissustalle	n	
noaiddástalli	noajdástalle	n	
ealli	ielle	n	
bealle	bielle	n	
bealli	bielle	n	
dealli	dielle	n	
gealli	gielle	n	
jielli	jielle	n	
mealli	mielle	n	
mielli	mielle	n	
sealli	sielle	n	
stealli	stielle	n	
bihlli	bihlle	n	
máihli	májhlle	n	
bavhli	bavhlle	n	
doavhli	doavhlle	n	
goavhli	goavhlle	n	
skoavhli	skoavhlle	n	
hivhli	hivhlle	n	
čivhli	tjivhlle	n	
guvhli	guvhlle	n	
skávhli	skávhlle	n	
billi	bille	n	
dilli	dille	n	
gilli	gille	n	
čilli	tjille	n	
milli	mille	n	
silli	sille	n	
guolli	guolle	n	
vuolli	vuolle	n	
ulli	ulle	n	
bulli	bulle	n	
gulli	gulle	n	
lulli	lulle	n	
šoavli	sjoavlle	n	
soavli	soavlle	n	
feavli	fievlle	n	
geavli	gievlle	n	
čeavli	tjievlle	n	
leavli	lievlle	n	
seavli	sievlle	n	
njivli	njivlle	n	
sivli	sivlle	n	
stivli	stivlle	n	
duovli	duovlle	n	
suvli	suvlle	n	
dávli	dávlle	n	
fávli	fávlle	n	
skávli	skávlle	n	
lávli	lávlle	n	
návli	návlle	n	
álli	álle	n	
bálli	bálle	n	
fálli	fálle	n	
gálli	gálle	n	
hálli	hálle	n	
čálli	tjálle	n	
málli	málle	n	
nálli	nálle	n	
spálli	spálle	n	
stálli	stálle	n	
válli	válle	n	
olle	ålle	n	
olli	ålle	n	
golli	gålle	n	
jolli	jålle	n	
smolli	smålle	n	
nolli	nålle	n	
colli	tsålle	n	
tivoli	tivule	n	
šále	sjále	n	
stole	ståle	n	
dapmi	dabme	n	
lapmi	labme	n	
oapmi	oabme	n	
loapmi	loabme	n	
čoabmi	tjoabbme	n	
sabmi	sabbme	n	
giebmi	giebbme	n	
bubme	bubbme	n	
hubmi	hubbme	n	
submi	subbme	n	
jábmi	jábbme	n	
gobmi	gåbbme	n	
eapmi	iebme	n	
ipmi	ibme	n	
bipmi	bibme	n	
gipmi	gibme	n	
guopmi	guobme	n	
ruopmi	ruobme	n	
vuopmi	vuobme	n	
hápmi	hábme	n	
lápmi	lábme	n	
rápmi	rábme	n	
sápmi	sábme	n	
čopmi	tjåbme	n	
reašmi	riessjme	n	
muošmi	muossjme	n	
šušmi	sjussjme	n	
soimme	såjme	n	
eammi	iemme	n	
čáihmi	tjájhmme	n	
doaibmi	doajmme	n	
joaibmi	joajmme	n	
eaibmi	iejmme	n	
gieibmi	giejmme	n	
leaibmi	liejmme	n	
liibmi	lijmme	n	
viibmi	vijmme	n	
guoibmi	guojmme	n	
čuoibmi	tjuojmme	n	
vuoibmi	vuojmme	n	
stuibmi	stujmme	n	
áibmi	ájmme	n	
gáibmi	gájmme	n	
albmi	almme	n	
šalbmi	sjalmme	n	
čalbmi	tjalmme	n	
čoalbmi	tjoalmme	n	
skoalbmi	skoalmme	n	
healbmi	hielmme	n	
ilbmi	ilmme	n	
má^ilbmi	má^ilmme	n	
ulbmi	ulmme	n	
gulbmi	gulmme	n	
álbmi	álmme	n	
fálbmi	fálmme	n	
gálbmi	gálmme	n	
njálbmi	njálmme	n	
smarbmi	smarmme	n	
dearbmi	diermme	n	
fierbmi	fiermme	n	
gieđbmi	giermme	n	
jierbmi	jiermme	n	
lieđbmi	liermme	n	
guorbmi	guormme	n	
suorbmi	suormme	n	
urbmi	urmme	n	
surbmi	surmme	n	
curbmi	tsurmme	n	
árbmi	ármme	n	
dárbmi	dármme	n	
fárbmi	fármme	n	
čáđbmi	tjármme	n	
jorbmi	jårmme	n	
sorbmi	sårmme	n	
gummi	gumme	n	
námmi	námme	n	
kuomi	kuome	n	
luomi	luome	n	
šaddadeapmi	sjaddadeapme	n	
rievdadeapmi	rievddadeapme	n	
čielggadeapmi	tjielgadeapme	n	
juogadeapmi	juogadeapme	n	
gavjadeapmi	gavjjadeapme	n	
lihkadeapmi	lihkadeapme	n	
ráhkadeapmi	ráhkadeapme	n	
loavkadeapmi	loavkkadeapme	n	
sinkadeapmi	sinkadeapme	n	
iskkadeapmi	iskadeapme	n	
iskadeapmi	isskadeapme	n	
suoladeapmi	suoladeapme	n	
gávnnadeapmi	gávnadeapme	n	
eastadeapmi	iesstadeapme	n	
buvttadeapmi	buvtadeapme	n	
oaivvadeapmi	oajvadeapme	n	
deaivvadeapmi	diejvadeapme	n	
njuovadeapmi	njuovadeapme	n	
oaivadeapmi	oajvvadeapme	n	
dulvadeapmi	dulvvadeapme	n	
gearjideapmi	gierjjedeapme	n	
nuoskkideapmi	nuoskedeapme	n	
alideapmi	aledeapme	n	
galledeapmi	galledeapme	n	
stelledeapmi	stelledeapme	n	
njunnedeapmi	njunnedeapme	n	
sivdnideapmi	sivnnedeapme	n	
geahpideapmi	giehpedeapme	n	
givssideapmi	givsedeapme	n	
rievideapmi	rievedeapme	n	
cihraideapmi	tsihrajdeapme	n	
biđggiideapmi	birgijdeapme	n	
hevrriideapmi	hevrijdeapme	n	
ovttaideapmi	åvtåjdeapme	n	
gaskkaldeapmi	gaskaldeapme	n	
jeagildeapmi	jiegeldeapme	n	
rasttildeapmi	rasteldeapme	n	
buđaldeapmi	budáldeapme	n	
vánddardeapmi	vándardeapme	n	
duoittardeapmi	duojtardeapme	n	
reaidudeapmi	riejddudeapme	n	
govdudeapmi	gåvddudeapme	n	
sevnnjodeapmi	sevnjudeapme	n	
joavkudeapmi	joavkkudeapme	n	
smokkodeapmi	småkkudeapme	n	
dálkkodeapmi	dálkudeapme	n	
čoaskudeapmi	tjoasskudeapme	n	
áimmudeapmi	ájmudeapme	n	
suolbmudeapmi	suolmmudeapme	n	
sártnodeapmi	sárnudeapme	n	
orodeapmi	årudeapme	n	
dusttodeapmi	dustudeapme	n	
ávvudeapmi	ávvudeapme	n	
hávdádeapmi	hávddádeapme	n	
bagadeapmi	bagádeapme	n	
riegádeapmi	riegádeapme	n	
lágadeapmi	lágádeapme	n	
rágadeapmi	rágádeapme	n	
gažadeapmi	gatjádeapme	n	
dihkádeapmi	dihkádeapme	n	
suoládeapmi	suoládeapme	n	
háladeapmi	háládeapme	n	
guorbmádeapmi	guormmádeapme	n	
sánádeapmi	sánádeapme	n	
doahppádeapmi	doahppádeapme	n	
ásadeapmi	ásádeapme	n	
luoitádeapmi	luojttádeapme	n	
golgadeapmi	gålggådeapme	n	
šuvččageapmi	sjuvtjageapme	n	
čuvččageapmi	tjuvtjageapme	n	
suvččageapmi	suvtjageapme	n	
soabaheapmi	såbaheapme	n	
barggaheapmi	bargaheapme	n	
vuojaheapmi	vuojaheapme	n	
vealaheapmi	vielaheapme	n	
fuolaheapmi	fuolaheapme	n	
luohpaheapmi	luohpaheapme	n	
ruosaheapmi	ruosaheapme	n	
geavaheapmi	gievaheapme	n	
válddiheapmi	váldeheapme	n	
jorggiheapmi	jårgeheapme	n	
vuojeheapmi	vuojeheapme	n	
beaškkiheapmi	biesjkeheapme	n	
falleheapmi	falleheapme	n	
čáliheapmi	tjáleheapme	n	
aniheapmi	aneheapme	n	
joriheapmi	jåreheapme	n	
lasiheapmi	laseheapme	n	
geaseheapmi	gieseheapme	n	
guođoheapmi	guoduheapme	n	
geardduheapmi	gierduheapme	n	
biggoheapmi	bigguheapme	n	
láigoheapmi	lájgguheapme	n	
vuojuheapmi	vuojuheapme	n	
váikkuheapmi	vájkuheapme	n	
almmuheapmi	almuheapme	n	
roasmmoheapmi	roasmuheapme	n	
mánoheapmi	mánuheapme	n	
oahpoheapmi	oahpuheapme	n	
vearroheapmi	vierruheapme	n	
soiccuheapmi	såjtsuheapme	n	
coiccuheapmi	tsåjtsuheapme	n	
luoittuheapmi	luojtuheapme	n	
čađaheapmi	tjadáheapme	n	
vihaheapmi	viháheapme	n	
logaheapmi	lågåheapme	n	
rohkkáheapmi	råhkkåheapme	n	
joraheapmi	jåråheapme	n	
hálddašeapmi	háldatjeapme	n	
návddašeapmi	návdatjeapme	n	
mearkkašeapmi	mierkatjeapme	n	
anašeapmi	anatjeapme	n	
gávppašeapmi	gávpatjeapme	n	
áhcešeapmi	áhtsetjeapme	n	
lágážeapmi	lágátjeapme	n	
riiddáskeapmi	rijdáskeapme	n	
suodjaleapmi	suodjaleapme	n	
geahččaleapmi	giehttjaleapme	n	
oaidnaleapmi	oajnnaleapme	n	
biehttaleapmi	biehttaleapme	n	
náitaleapmi	nájttaleapme	n	
bálvaleapmi	bálvvaleapme	n	
vádjoleapmi	vádjuleapme	n	
eaškáleapmi	æssjkáleapme	n	
jorraleapmi	jårråleapme	n	
ohcaleapmi	åhtsåleapme	n	
luoddaneapmi	luoddaneapme	n	
čoagganeapmi	tjoagganeapme	n	
čuovganeapmi	tjuovgganeapme	n	
cuovkaneapmi	tsuovkkaneapme	n	
luoskaneapmi	luosskaneapme	n	
njuorraneapmi	njuorraneapme	n	
lahkoneapmi	lahkuneapme	n	
albmoneapmi	almmuneapme	n	
badjáneapmi	badjáneapme	n	
hárjáneapmi	hárjjáneapme	n	
earráneapmi	ærráneapme	n	
lassáneapmi	lassáneapme	n	
ovdáneapmi	åvddåneapme	n	
morráneapmi	mårråneapme	n	
bohtaneapmi	båhtåneapme	n	
caggaseapmi	tsaggaseapme	n	
sitnjaseapmi	sidnjaseapme	n	
spiehkkaseapmi	spiehkkaseapme	n	
máhccaseapmi	máhttsaseapme	n	
elloseapmi	elluseapme	n	
julggašteapmi	julgasjteapme	n	
guovddušteapmi	guovdusjteapme	n	
árvvošteapmi	árvusjteapme	n	
gieđasteapmi	giedasteapme	n	
loaiddasteapmi	loajdasteapme	n	
bierggasteapmi	biergasteapme	n	
cirggasteapmi	tsirgasteapme	n	
sihkasteapmi	sihkasteapme	n	
oamasteapmi	åmasteapme	n	
jienasteapmi	jienasteapme	n	
vuoiŋŋasteapmi	vuojŋasteapme	n	
sirddesteapmi	sirdesteapme	n	
bálkesteapmi	bálkkesteapme	n	
botkkisteapmi	båtkkesteapme	n	
loaŋkkisteapmi	loaŋkesteapme	n	
gallesteapmi	gallesteapme	n	
buhtisteapmi	buhtesteapme	n	
buonjusteapmi	buonjusteapme	n	
čuojusteapmi	tjuojusteapme	n	
gaskkusteapmi	gaskusteapme	n	
čalmmusteapmi	tjalmusteapme	n	
njoarosteapmi	njoarusteapme	n	
bárusteapmi	bárusteapme	n	
orusteapmi	årusteapme	n	
viđásteapmi	vidásteapme	n	
vuollásteapmi	vuollásteapme	n	
čorpmasteapmi	tjårmåsteapme	n	
govasteapmi	gåvåsteapme	n	
doaladupmi	dåladupme	n	
vuolidupmi	vuoledupme	n	
sivdnidupmi	sivnnedupme	n	
vealggáidupmi	vælgájdupme	n	
vuogáidupmi	vuogájdupme	n	
guomáidupmi	guomájdupme	n	
ásaidupmi	ásájdupme	n	
dagaldupmi	dagáldupme	n	
láidejupmi	lájddejupme	n	
muddejupmi	muddejupme	n	
bovdejupmi	båvddejupme	n	
áddejupmi	áddejupme	n	
ráđđejupmi	ráddejupme	n	
birgejupmi	birggejupme	n	
čuvgejupmi	tjuvggejupme	n	
dohkkejupmi	dåhkkejupme	n	
skuvlejupmi	skuvllejupme	n	
nannejupmi	nannejupme	n	
ordnejupmi	årnnejupme	n	
industri^aliserejupmi	inddustre^aleserejupme	n	
hehttejupmi	hehttejupme	n	
arvvosmahttojupmi	arvusmahttojupme	n	
áhpásmahttojupmi	áhpásmahttojupme	n	
hearvásmahttojupmi	hærvvásmahttojupme	n	
bahkašupmi	bahkatjupme	n	
juohkašupmi	juohkatjupme	n	
bálkkašupmi	bálkatjupme	n	
spelle^manns^bálkkašupmi	spelle^manns^bálkatjupme	n	
mearkkašupmi	mierkatjupme	n	
billašupmi	billatjupme	n	
várašupmi	váratjupme	n	
beahttašupmi	biehttatjupme	n	
fuopmášupmi	fuobmátjupme	n	
fuomášupmi	fuomátjupme	n	
ollašupmi	ållåtjupme	n	
molsašupmi	målssåtjupme	n	
rohtašupmi	råhtåtjupme	n	
rohttašupmi	råhttåtjupme	n	
addojupmi	addujupme	n	
oidojupmi	åjddujupme	n	
devdojupmi	devddujupme	n	
čovdojupmi	tjåvddujupme	n	
gáddjojupmi	gáddjujupme	n	
celkojupmi	tselkkujupme	n	
sárdnojupmi	sárnnujupme	n	
bestojupmi	besstujupme	n	
heitojupmi	hejttujupme	n	
geahččalupmi	giehttjalupme	n	
eanalupmi	ienalupme	n	
ihtalupmi	ihtalupme	n	
eaškálupmi	æssjkálupme	n	
hárjánupmi	hárjjánupme	n	
ovdánupmi	åvddånupme	n	
čatnasupmi	tjadnasupme	n	
varrasupmi	varrasupme	n	
čuoldásupmi	tjuolldásupme	n	
gillásupmi	gillásupme	n	
gávdnoštupmi	gávnnusjtupme	n	
beroštupmi	berusjtupme	n	
mielastupmi	mielastupme	n	
báljestupmi	báljjestupme	n	
anistupmi	anestupme	n	
lihkostupmi	lihkustupme	n	
gávdnostupmi	gávnnustupme	n	
duššástupmi	dussjástupme	n	
nuppástupmi	nuppástupme	n	
ovttastupmi	åvtåstupme	n	
vasmi	vassme	n	
jiesmi	jiessme	n	
leasmi	liessme	n	
lusmi	lussme	n	
básmi	bássme	n	
satmi	satme	n	
fátmi	fátme	n	
tsunami	tsunáme	n	
komi	kåme	n	
datni	dadne	n	
olbmáheadni	ålmmåheadne	n	
spoatni	spoadne	n	
spatni	spadne	n	
ratni	radne	n	
adni	addne	n	
badni	baddne	n	
ladni	laddne	n	
goadni	goaddne	n	
eadni	ieddne	n	
idni	iddne	n	
gidni	giddne	n	
skidni	skiddne	n	
sidni	siddne	n	
gudni	guddne	n	
ludni	luddne	n	
rudni	ruddne	n	
bodni	båddne	n	
geatni	giedne	n	
ritni	ridne	n	
luotni	luodne	n	
skutni	skudne	n	
bátni	bádne	n	
sátni	sádne	n	
vátni	vádne	n	
hámmelheanni	hámmelheanne	n	
manni	manne	n	
nanni	nanne	n	
čáihni	tjájhnne	n	
cinni	tsinne	n	
oaidni	oajnne	n	
bieidni	biejnne	n	
seaidni	siejnne	n	
veaidni	viejnne	n	
liidni	lijnne	n	
spiidni	spijnne	n	
viidni	vijnne	n	
suoidni	suojnne	n	
áidni	ájnne	n	
dáidni	dájnne	n	
máidni	májnne	n	
váidni	vájnne	n	
suoldni	suolnne	n	
boldni	bålnne	n	
bierdni	biernne	n	
geardni	giernne	n	
veardni	viernne	n	
irdni	irnne	n	
bárdni	bárnne	n	
gárdni	gárnne	n	
sárdni	sárnne	n	
sálovárdni	sáluvárnne	n	
gordni	gårnne	n	
njunni	njunne	n	
munni	munne	n	
gievdni	gievnne	n	
heavdni	hievnne	n	
rievdni	rievnne	n	
ivdni	ivnne	n	
duvdni	duvnne	n	
guvdni	guvnne	n	
tuvdni	tuvnne	n	
gávdni	gávnne	n	
sávdni	sávnne	n	
stávdni	stávnne	n	
bánni	bánne	n	
ránni	ránne	n	
gonne	gånne	n	
monni	månne	n	
pepperoni	pepperone	n	
vuoni	vuone	n	
mieđašeatni	miedatjeatne	n	
ášešeatni	ásjetjeatne	n	
áhčešeatni	áhtjetjeatne	n	
áhcešeatni	áhtsetjeatne	n	
háhcešeatni	háhtsetjeatne	n	
háhtešeatni	háhtetjeatne	n	
njávešeatni	njávetjeatne	n	
gálojeatni	gálujeatne	n	
gone	gåne	n	
mánoheahpi	mánuheahpe	n	
roahpi	roahpe	n	
neahpi	niehpe	n	
seahpi	siehpe	n	
lihpi	lihpe	n	
duohpi	duohpe	n	
cuohpi	tsuohpe	n	
suhpi	suhpe	n	
áhpi	áhpe	n	
dáhpi	dáhpe	n	
jáhpi	jáhpe	n	
skáhpi	skáhpe	n	
láhpi	láhpe	n	
náhpi	náhpe	n	
ráhpi	ráhpe	n	
stáhpi	stáhpe	n	
váhpi	váhpe	n	
dohpi	dåhpe	n	
gohpi	gåhpe	n	
lohpi	låhpe	n	
rohpi	råhpe	n	
reašpi	riesjpe	n	
rušpi	rusjpe	n	
apokope	apukope	n	
oahppi	oahppe	n	
loahppi	loahppe	n	
roahppi	roahppe	n	
rahppi	rahppe	n	
sahppi	sahppe	n	
diehppi	diehppe	n	
giehppi	giehppe	n	
čeahppi	tjiehppe	n	
leahppi	liehppe	n	
liehppi	liehppe	n	
riehppi	riehppe	n	
njuohppi	njuohppe	n	
čuohppi	tjuohppe	n	
luohppi	luohppe	n	
vuohppi	vuohppe	n	
áhppi	áhppe	n	
rei^skáhppi	rej^skáhppe	n	
sel^skáhppi	sel^skáhppe	n	
selskáhppi	selskáhppe	n	
reiskáhppi	rejsskáhppe	n	
náhppi	náhppe	n	
sáhppi	sáhppe	n	
gohppi	gåhppe	n	
čohppi	tjåhppe	n	
skohppi	skåhppe	n	
cohppi	tsåhppe	n	
skaipi	skajppe	n	
duipi	dujppe	n	
cuipi	tsujppe	n	
gáipi	gájppe	n	
háipi	hájppe	n	
cáipi	tsájppe	n	
stáipi	stájppe	n	
váipe	vájppe	n	
njalpi	njalppe	n	
doalpi	doalppe	n	
njoalpi	njoalppe	n	
gilpe	gilppe	n	
dulpi	dulppe	n	
culpi	tsulppe	n	
stálpi	stálppe	n	
čolpi	tjålppe	n	
skolpi	skålppe	n	
rampi	ramppe	n	
kempe	kemppe	n	
šlimpi	slimppe	n	
bumpe	bumppe	n	
gumpe	gumppe	n	
humpi	humppe	n	
cumpi	tsumppe	n	
garpi	garppe	n	
soarpi	soarppe	n	
nirpi	nirppe	n	
sirpe	sirppe	n	
gurpi	gurppe	n	
fárpi	fárppe	n	
várpi	várppe	n	
gávpi	gávppe	n	
luspi	lusspe	n	
synkope	synkupe	n	
biire	bijre	n	
gáiri	gájre	n	
láiri	lájre	n	
darri	darre	n	
harri	harre	n	
jarri	jarre	n	
snarri	snarre	n	
oarri	oarre	n	
boarri	boarre	n	
čoarri	tjoarre	n	
skoarri	skoarre	n	
moarri	moarre	n	
sarri	sarre	n	
earri	ierre	n	
bearri	bierre	n	
dearri	dierre	n	
dierri	dierre	n	
gierri	gierre	n	
njearri	njierre	n	
čierri	tjierre	n	
skearri	skierre	n	
skierri	skierre	n	
mearre	mierre	n	
mearri	mierre	n	
vearri	vierre	n	
birri	birre	n	
dirri	dirre	n	
hirri	hirre	n	
skirri	skirre	n	
duorri	duorre	n	
guorri	guorre	n	
nuorri	nuorre	n	
suorri	suorre	n	
vuorri	vuorre	n	
hurri	hurre	n	
curre	tsurre	n	
davri	davrre	n	
gavri	gavrre	n	
goavri	goavrre	n	
hoavri	hoavrre	n	
evre	evrre	n	
geavri	gievrre	n	
mievri	mievrre	n	
neavri	nievrre	n	
reavri	rievrre	n	
revre	revrre	n	
divri	divrre	n	
givri	givrre	n	
suovri	suovrre	n	
buvri	buvrre	n	
guvri	guvrre	n	
skuvri	skuvrre	n	
suvri	suvrre	n	
fávre	fávrre	n	
gávri	gávrre	n	
jávri	jávrre	n	
gárri	gárre	n	
ávs^gárri	ávs^gárre	n	
hárri	hárre	n	
skárri	skárre	n	
nárri	nárre	n	
snárri	snárre	n	
sárri	sárre	n	
várri	várre	n	
borri	bårre	n	
dorri	dårre	n	
gorri	gårre	n	
jorri	jårre	n	
snorri	snårre	n	
sorri	sårre	n	
rambuvri	rambbuvre	n	
rámbuvri	rámbbuvre	n	
kabare	kabáre	n	
ore	åre	n	
ma^ori	ma^åre	n	
gore	gåre	n	
kore	kåre	n	
lore	låre	n	
desi	dese	n	
manjsi	manjse	n	
laksi	lakse	n	
oaksi	oakse	n	
taksi	takse	n	
fieksi	fiekse	n	
lieksi	liekse	n	
veaksi	viekse	n	
vieksi	viekse	n	
giksi	gikse	n	
liksi	likse	n	
guoksi	guokse	n	
ruoksi	ruokse	n	
vuoksi	vuokse	n	
guksi	gukse	n	
áksi	ákse	n	
táksi	tákse	n	
váksi	vákse	n	
doksi	dåkse	n	
assi	asse	n	
bassi	basse	n	
lassi	lasse	n	
oassi	oasse	n	
loassi	loasse	n	
beassi	biesse	n	
geassi	giesse	n	
miessi	miesse	n	
siessi	siesse	n	
rissi	risse	n	
biise	bijsse	n	
giisi	gijsse	n	
kiisi	kijsse	n	
gáisi	gájsse	n	
máisi	májsse	n	
njalsi	njalsse	n	
goalsi	goalsse	n	
soalsi	soalsse	n	
realsi	rielsse	n	
vealsi	vielsse	n	
bulsi	bulsse	n	
bálsi	bálsse	n	
hálsi	hálsse	n	
bamse	bamsse	n	
roamsi	roamsse	n	
leamsi	liemsse	n	
himsi	himsse	n	
rimsi	rimsse	n	
simsi	simsse	n	
guossi	guosse	n	
čuossi	tjuosse	n	
muossi	muosse	n	
suossi	suosse	n	
vuossi	vuosse	n	
doarsi	doarsse	n	
moarsi	moarsse	n	
gearsi	giersse	n	
čearsi	tjiersse	n	
girse	girsse	n	
girsi	girsse	n	
čirsi	tjirsse	n	
suorsi	suorsse	n	
gurse	gursse	n	
jursi	jursse	n	
nursi	nursse	n	
dársi	dársse	n	
vársi	vársse	n	
čussi	tjusse	n	
ássi	ásse	n	
dássi	dásse	n	
gássi	gásse	n	
rássi	rásse	n	
bossi	båsse	n	
gombásse	gåmbbåsse	n	
gompásse	gåmppåsse	n	
boazzi	boadtse	n	
giezzi	giedtse	n	
njeazzi	njiedtse	n	
bázzi	bádtse	n	
gázzi	gádtse	n	
vázzi	vádtse	n	
oahci	oahtse	n	
beahci	biehtse	n	
čeahci	tjiehtse	n	
bihci	bihtse	n	
ruhci	ruhtse	n	
áhci	áhtse	n	
čáhci	tjáhtse	n	
coakci	tsoaktse	n	
njeakci	njiektse	n	
reakci	riektse	n	
gákci	gáktse	n	
okci	åktse	n	
cecce	tsettse	n	
oahcci	oahttse	n	
goahcci	goahttse	n	
meahcci	miehttse	n	
reahcci	riehttse	n	
gihcci	gihttse	n	
buohcci	buohttse	n	
báhcci	báhttse	n	
gáhcci	gáhttse	n	
háhcci	háhttse	n	
máhcci	máhttse	n	
ohcci	åhttse	n	
bohcci	båhttse	n	
gohcci	gåhttse	n	
cohcci	tsåhttse	n	
buici	bujttse	n	
juice	jujttse	n	
cáici	tsájttse	n	
njoalci	njoalttse	n	
šnjoalci	sjnjoalttse	n	
bulci	bulttse	n	
culci	tsulttse	n	
el-culci	el-tsulttse	n	
janzi	janttse	n	
goanzi	goanttse	n	
šloanci	sloanttse	n	
roanci	roanttse	n	
leanzi	lienttse	n	
šleanci	slienttse	n	
šleanzi	slienttse	n	
reanzi	rienttse	n	
veanzi	vienttse	n	
linci	linttse	n	
šlinzi	slinttse	n	
rinzi	rinttse	n	
bunci	bunttse	n	
runzi	runttse	n	
ránce	ránttse	n	
ránci	ránttse	n	
hearci	hierttse	n	
birzi	birttse	n	
gurci	gurttse	n	
sturci	sturttse	n	
geavzi	gievttse	n	
livzi	livttse	n	
rivzi	rivttse	n	
juovzi	juovttse	n	
gávzi	gávttse	n	
bizebáze	bitsebátse	n	
laktose	laktuse	n	
goahti	goahte	n	
moahti	moahte	n	
soahti	soahte	n	
heahti	hiehte	n	
miehti	miehte	n	
neahti	niehte	n	
vihti	vihte	n	
guohti	guohte	n	
čuohti	tjuohte	n	
luohti	luohte	n	
čuhti	tjuhte	n	
áhti	áhte	n	
báhti	báhte	n	
jáhti	jáhte	n	
lohti	låhte	n	
mohti	måhte	n	
sohti	såhte	n	
eitte	ejte	n	
lakti	lakte	n	
oakti	oakte	n	
loakti	loakte	n	
riekti	riekte	n	
føy^dalriekti	føy^dalriekte	n	
seakti	siekte	n	
luokti	luokte	n	
lukti	lukte	n	
bákti	bákte	n	
dákti	dákte	n	
gákti	gákte	n	
fielti	fiellte	n	
jielti	jiellte	n	
čielti	tjiellte	n	
vielti	viellte	n	
filte	fillte	n	
sulti	sullte	n	
hálti	hállte	n	
sálti	sállte	n	
destamente	desstamente	n	
testamente	tesstamente	n	
deastámente	dæsstámente	n	
vuostálasti	vuosstálaste	n	
sihkkarasti	sihkkaraste	n	
baste	basste	n	
oasti	oasste	n	
sasti	sasste	n	
beste	besste	n	
beasti	biesste	n	
niesti	niesste	n	
sisti	sisste	n	
visti	visste	n	
luiste	lujsste	n	
báiste	bájsste	n	
luosti	luosste	n	
vuosti	vuosste	n	
jávsti	jávsste	n	
návste	návsste	n	
návsti	návsste	n	
fásti	fásste	n	
lásti	lásste	n	
náste	násste	n	
násti	násste	n	
raŧŧi	ratte	n	
uhcidahtti	uhtsedahtte	n	
geardudahtti	gierddudahtte	n	
gahtti	gahtte	n	
juogihahtti	juogehahtte	n	
šlahtti	slahtte	n	
mahtti	mahtte	n	
boahtti	boahtte	n	
diehtti	diehtte	n	
niehtti	niehtte	n	
pe^a-niehtti	pe^a-niehtte	n	
riehtti	riehtte	n	
dihtti	dihtte	n	
šihtti	sjihtte	n	
lihtti	lihtte	n	
skuohtti	skuohtte	n	
muohtti	muohtte	n	
nuohtti	nuohtte	n	
ruohtti	ruohtte	n	
áhtti	áhtte	n	
fáhtti	fáhtte	n	
láhtti	láhtte	n	
bohtti	båhtte	n	
johtti	jåhtte	n	
vuoiti	vuojtte	n	
buiti	bujtte	n	
guite	gujtte	n	
kuite	kujtte	n	
muiti	mujtte	n	
suite	sujtte	n	
áiti	ájtte	n	
skáiti	skájtte	n	
smáiti	smájtte	n	
sáiti	sájtte	n	
hanti	hantte	n	
sente	sentte	n	
finte	fintte	n	
vinte	vintte	n	
suonti	suontte	n	
šlánte	slántte	n	
bonte	båntte	n	
gonte	gåntte	n	
smarti	smartte	n	
boarti	boartte	n	
sarti	sartte	n	
earti	iertte	n	
guorti	guortte	n	
nuorti	nuortte	n	
suorti	suortte	n	
gurti	gurtte	n	
čurti	tjurtte	n	
smurti	smurtte	n	
bárti	bártte	n	
dorte	dårtte	n	
horti	hårtte	n	
juvtte	juvte	n	
ruvtte	ruvte	n	
karate	karáte	n	
ereive	erejve	n	
avvi	avve	n	
davvi	davve	n	
njavvi	njavve	n	
goavvi	goavve	n	
roavvi	roavve	n	
beavvi	bievve	n	
bievvi	bievve	n	
skievvi	skievve	n	
reavvi	rievve	n	
ceavvi	tsievve	n	
hivvi	hivve	n	
oaivi	oajvve	n	
beaivi	biejvve	n	
šleaivi	sliejvve	n	
reive	rejvve	n	
e-reive	e-rejvve	n	
breive	brejvve	n	
veive	vejvve	n	
šliivi	slijvve	n	
skuoivi	skuojvve	n	
duivi	dujvve	n	
ruivi	rujvve	n	
láivi	lájvve	n	
sáivi	sájvve	n	
váivi	vájvve	n	
moivi	måjvve	n	
jalvi	jalvve	n	
doalvi	doalvve	n	
goalvi	goalvve	n	
soalvi	soalvve	n	
valvi	valvve	n	
čilvi	tjilvve	n	
silvi	silvve	n	
njuolvi	njuolvve	n	
dulvi	dulvve	n	
álvi	álvve	n	
dálvi	dálvve	n	
jálvi	jálvve	n	
skálvi	skálvve	n	
golve	gålvve	n	
holve	hålvve	n	
njolvi	njålvve	n	
duovvi	duovve	n	
njuovvi	njuovve	n	
luovvi	luovve	n	
muovvi	muovve	n	
nuovvi	nuovve	n	
suovvi	suovve	n	
arvi	arvve	n	
bađvi	barvve	n	
darvi	darvve	n	
njarvi	njarvve	n	
šnjarvi	sjnjarvve	n	
smarvi	smarvve	n	
doarvi	doarvve	n	
goarvi	goarvve	n	
njoađve	njoarvve	n	
njoađvi	njoarvve	n	
čoarvi	tjoarvve	n	
noarvi	noarvve	n	
soarvi	soarvve	n	
searvi	siervve	n	
irvi	irvve	n	
njirvi	njirvve	n	
šnjirvi	sjnjirvve	n	
liđvi	lirvve	n	
nirvi	nirvve	n	
siđvi	sirvve	n	
hurvi	hurvve	n	
lurvi	lurvve	n	
šlurvi	slurvve	n	
smurvi	smurvve	n	
bárvi	bárvve	n	
dáđvi	dárvve	n	
gárvi	gárvve	n	
nárvi	nárvve	n	
várve	várvve	n	
dorve	dårvve	n	
torve	tårvve	n	
luvvi	luvve	n	
hávvi	hávve	n	
njávvi	njávve	n	
skávvi	skávve	n	
lávvi	lávve	n	
skovvi	skåvve	n	
rovvi	råvve	n	
čeagŋi	tjieggŋe	n	
čávgŋi	tjávgŋe	n	
bákŋi	bágŋe	n	
čuoŋi	tjuoŋe	n	
maŋŋi	maŋŋe	n	
jargŋi	jarŋŋe	n	
meargŋi	mierŋŋe	n	
gárgŋi	gárŋŋe	n	
jiddisch	jiddesch	n	
Kárášjoh	Kárásjjoh	n	
máđii	mádij	n	
ásii	ásij	n	
gaccebaš	gattsebasj	n	
ustibaš	usstebasj	n	
dárbbaš	dárbasj	n	
áddjubaš	áddjubasj	n	
giljobaš	giljjubasj	n	
gilljobaš	gilljubasj	n	
áhkkubaš	áhkkubasj	n	
geađaš	giedasj	n	
eahkedaš	iehkedasj	n	
hiđaš	hidasj	n	
nieiddaš	niejdasj	n	
buđaš	budasj	n	
gibbagaš	gibbagasj	n	
várjjagaš	várjagasj	n	
lagaš	lagasj	n	
gáhpagaš	gáhpagasj	n	
sivjjogaš	sivjugasj	n	
mágaš	mágasj	n	
buolbmágaš	buolmmágasj	n	
gearjahaš	gierjjahasj	n	
miellahaš	miellahasj	n	
oapmahaš	oabmahasj	n	
unnahaš	unnahasj	n	
bánnahaš	bánnahasj	n	
nuorahaš	nuorahasj	n	
uhcahaš	uhtsahasj	n	
láhkkehaš	láhkkehasj	n	
áinnuhaš	ájnuhasj	n	
háldejaš	hálldejasj	n	
boldejaš	bålldejasj	n	
láskejaš	lásskejasj	n	
dullejaš	dullejasj	n	
dulejaš	dulejasj	n	
báidnejaš	bájnnejasj	n	
vieljaš	vieljjasj	n	
vuonjaš	vuonjasj	n	
vuojaš	vuojasj	n	
bihkaš	bihkasj	n	
herodi^alaš	herude^alasj	n	
syri^alaš-feniki^alaš	syre^alasj-feneke^alasj	n	
antioki^alaš	anttioke^alasj	n	
galile^alaš	galele^alasj	n	
itali^alaš	itále^alasj	n	
makedoni^alaš	makedone^alasj	n	
etiopi^alaš	etiope^alasj	n	
hebre^alaš	hebre^alasj	n	
aleksandri^alaš	aleksandre^alasj	n	
bere^alaš	bere^alasj	n	
syri^alaš	syre^alasj	n	
bulgári^alaš	bulggáre^alasj	n	
samari^alaš	samáre^alasj	n	
farise^alaš	farese^alasj	n	
arimate^alaš	aremate^alasj	n	
galati^alaš	galáte^alasj	n	
arabalaš	arábalasj	n	
nieidalaš	niejddalasj	n	
gándalaš	gánddalasj	n	
saddukealaš	saddukealasj	n	
aramealaš	arámealasj	n	
hål^øygalaš	hål^øygalasj	n	
diakritihkalaš	diakretihkalasj	n	
tessalonikalaš	tessalonikalasj	n	
heakkalaš	hiekkalasj	n	
greikalaš	grejkkalasj	n	
duiskalaš	dujsskalasj	n	
dánskalaš	dánsskalasj	n	
ránskalaš	ránsskalasj	n	
beallalaš	biellalasj	n	
katolalaš	katulalasj	n	
dammalaš	dammalasj	n	
sodomalaš	sådumalasj	n	
pakistanalaš	pakestanalasj	n	
atenalaš	atenalasj	n	
ty^atiralaš	ty^ateralasj	n	
epikuralaš	epekuralasj	n	
gursalaš	gurssalasj	n	
gerasalaš	gerásalasj	n	
korintalaš	kårentalasj	n	
egyptalaš	egyptalasj	n	
hammerfeastalaš	hammerfeastalasj	n	
hámmárfeastalaš	hámmárfeastalasj	n	
heasttalaš	hiestalasj	n	
filistalaš	filestalasj	n	
germanisttalaš	germanistalasj	n	
kristtalaš	kristalasj	n	
partalaš	parttalasj	n	
nuortalaš	nuorttalasj	n	
generatiivalaš	generatijvalasj	n	
substantiivvalaš	substantijvvalasj	n	
moablaš	moablasj	n	
lehablaš	leháblasj	n	
arvadlaš	arvvadlasj	n	
derbelaš	derbbelasj	n	
bieđđilaš	bieddelasj	n	
šuđđilaš	sjuddelasj	n	
suđđilaš	suddelasj	n	
láddelaš	láddelasj	n	
ludelaš	ludelasj	n	
ládelaš	ládelasj	n	
ofelaš	åfelasj	n	
bealaš	bielasj	n	
náhkkelaš	náhkkelasj	n	
arkilaš	arkkelasj	n	
birkelaš	birkkelasj	n	
moskilaš	måsskelasj	n	
beallelaš	biellelasj	n	
oapmelaš	oabmelasj	n	
suopmelaš	suobmelasj	n	
suopmilaš	suobmelasj	n	
sápmelaš	sábmelasj	n	
kyrenelaš	kyrenelasj	n	
sinilaš	sinelasj	n	
bárdnelaš	bárnnelasj	n	
mázelaš	mátselasj	n	
ruoŧŧelaš	ruottelasj	n	
ruoŧŧilaš	ruottelasj	n	
hevilaš	hevelasj	n	
hávvelaš	hávvelasj	n	
kasluhlaš	kasluhlasj	n	
naftuhlaš	naftuhlasj	n	
korahlaš	kåråhlasj	n	
durdnosleagilaš	durnnusleagilasj	n	
romanilaš	råmånilasj	n	
filippilaš	fileppilasj	n	
girgašlaš	girggasjlasj	n	
letušlaš	letusjlasj	n	
amaleklaš	amáleklasj	n	
isma^ellaš	issma^ellasj	n	
isra^ellaš	isra^ellasj	n	
ciellaš	tsiellasj	n	
gárjillaš	gárjjellasj	n	
hamlaš	hamlasj	n	
adullamlaš	adullamlasj	n	
emlaš	emlasj	n	
edomlaš	edumlasj	n	
leumlaš	leumlasj	n	
elamlaš	elámlasj	n	
anamlaš	anámlasj	n	
kanaanlaš	kanaanlasj	n	
midjanlaš	midjanlasj	n	
kenlaš	kenlasj	n	
kadmonlaš	kadmunlasj	n	
ammonlaš	ammunlasj	n	
finnmárkolaš	finnmárkolasj	n	
buolaš	buolasj	n	
aššurlaš	assjurlasj	n	
amorlaš	amurlasj	n	
kaftorlaš	kafturlasj	n	
hagarlaš	hagárlasj	n	
semarlaš	semárlasj	n	
kenislaš	keneslasj	n	
perislaš	pereslasj	n	
nikolaoslaš	nikulaoslasj	n	
efesoslaš	efesoslasj	n	
jebuslaš	jebuslasj	n	
ealáhuslaš	æláhuslasj	n	
damaskuslaš	damáskuslasj	n	
kyproslaš	kypruslasj	n	
patroslaš	patruslasj	n	
suslaš	suslasj	n	
hetlaš	hetlasj	n	
nasaretlaš	nasáretlasj	n	
hamatlaš	hamátlasj	n	
árbbolaš	árbulasj	n	
ráidolaš	rájddulasj	n	
sirdolaš	sirddulasj	n	
sirddolaš	sirdulasj	n	
láigolaš	lájggulasj	n	
golgolaš	gålggulasj	n	
gárgolaš	gárggulasj	n	
porsáŋgulaš	pårssåŋgulasj	n	
sogolaš	sågulasj	n	
vašolaš	vasjulasj	n	
niehkulaš	niehkulasj	n	
bálkkolaš	bálkulasj	n	
finnmárkulaš	finnmárkulasj	n	
dálolaš	dálulasj	n	
albmulaš	almmulasj	n	
deatnulaš	diednulasj	n	
ainolaš	ajnulasj	n	
gáidnulaš	gájnnulasj	n	
gávpolaš	gávppulasj	n	
osolaš	åsulasj	n	
lihtolaš	lihtulasj	n	
sáhttolaš	sáhttulasj	n	
gievvulaš	gievvulasj	n	
judálaš	judálasj	n	
juvddálaš	juvdálasj	n	
heađálaš	hædálasj	n	
refalaš	refálasj	n	
sifalaš	sifálasj	n	
filosofálaš	filusofálasj	n	
bahálaš	bahálasj	n	
behálaš	behálasj	n	
bajálaš	bajálasj	n	
vašálaš	vasjálasj	n	
amerihkálaš	amerihkálasj	n	
náhkálaš	náhkálasj	n	
mátkkálaš	mátkkálasj	n	
bupmálaš	bubmálasj	n	
gummálaš	gummálasj	n	
bárdnálaš	bárnnálasj	n	
mánnálaš	mánnálasj	n	
gávppálaš	gávpálasj	n	
sálaš	sálasj	n	
kretalaš	kretálasj	n	
spihtálaš	spihtálasj	n	
skytalaš	skytálasj	n	
sogalaš	sågålasj	n	
romalaš	råmålasj	n	
skoltalaš	skålltålasj	n	
stoalaš	stålasj	n	
čiehčamaš	tjiehtjamasj	n	
čiehččamaš	tjiehttjamasj	n	
runtamaš	runttamasj	n	
čihččemaš	tjihttjemasj	n	
váhnemaš	váhnemasj	n	
gorremaš	gårremasj	n	
imaš	imasj	n	
almmaš	almasj	n	
gearpmaš	giermasj	n	
genddomaš	gendumasj	n	
rumaš	rumasj	n	
goarrámaš	goarrámasj	n	
huonaš	huonasj	n	
náránaš	náránasj	n	
gahcepaš	gahtsepasj	n	
gaccepaš	gattsepasj	n	
vuohpaš	vuohpasj	n	
ráppaš	ráppasj	n	
cizopaš	tsitsupasj	n	
áhpparaš	áhpparasj	n	
bearaš	bierasj	n	
unnoraš	unnurasj	n	
návrraš	návrasj	n	
anáraš	anárasj	n	
skihpáraš	skihpárasj	n	
eahpáraš	æhpárasj	n	
nammasaš	nammasasj	n	
gazzaš	gadtsasj	n	
fárrosaš	fárrusasj	n	
sadjásaš	sadjásasj	n	
ráhkkásaš	ráhkkásasj	n	
sásaš	sásasj	n	
ovdasaš	åvddåsasj	n	
lasttaš	lastasj	n	
johttevaš	jåhttevasj	n	
dáivvaš	dájvasj	n	
ruvaš	ruvasj	n	
seaŋaš	sieŋasj	n	
vuoiŋŋaš	vuojŋasj	n	
gáibbeš	gájbesj	n	
orbbeš	årbesj	n	
ovdeš	åvddesj	n	
viđeš	videsj	n	
verddeš	verdesj	n	
guđeš	gudesj	n	
čuđeš	tjudesj	n	
lovddeš	låvdesj	n	
lageš	lagesj	n	
bárggeš	bárgesj	n	
logeš	lågesj	n	
njelješ	njeljjesj	n	
gižeš	gitjesj	n	
čižeš	tjitjesj	n	
behkeš	behkesj	n	
cekkeš	tsekkesj	n	
herkkeš	herkesj	n	
čeŋkkeš	tjeŋkesj	n	
naleš	nalesj	n	
beleš	belesj	n	
spileš	spilesj	n	
galleš	gallesj	n	
jalleš	jallesj	n	
luleš	lulesj	n	
doleš	dålesj	n	
golmmeš	gålmesj	n	
jumeš	jumesj	n	
jámeš	jámesj	n	
ganeš	ganesj	n	
ganiš	ganesj	n	
golnneš	gålnesj	n	
gáneš	gánesj	n	
curreš	tsurresj	n	
oreš	åresj	n	
gacceš	gattsesj	n	
gávcceš	gávttsesj	n	
ovcceš	åvttsesj	n	
guvtteš	guvtesj	n	
ovtteš	åvtesj	n	
maŋeš	maŋesj	n	
maŋŋeš	maŋŋesj	n	
bárefuoš	bárefuosj	n	
bártnehuoš	bárnehuosj	n	
bárehuoš	bárehuosj	n	
albmáhuoš	almmáhuosj	n	
mánáhuoš	mánáhuosj	n	
olbmáhuoš	ålmmåhuosj	n	
jámeškuoš	jámesjkuosj	n	
heabuš	hiebusj	n	
vuolebuš	vuolebusj	n	
vuolibuš	vuolebusj	n	
beibboš	bejbusj	n	
seaibbuš	siejbusj	n	
bađoš	badusj	n	
bađuš	badusj	n	
goidoš	gåjddusj	n	
mieđuš	miedusj	n	
fuđoš	fudusj	n	
báđoš	bádusj	n	
gálgoš	gálggusj	n	
gárgoš	gárggusj	n	
bávgoš	bávggusj	n	
rávgoš	rávggusj	n	
rovgoš	råvggusj	n	
olggoš	ålgusj	n	
barggoš	bargusj	n	
bajoš	bajusj	n	
bajuš	bajusj	n	
hejoš	hejusj	n	
áhkoš	áhkusj	n	
beškkoš	besjkusj	n	
gietkkuš	gietkkusj	n	
ruotkkuš	ruotkkusj	n	
mátkkuš	mátkkusj	n	
šákkoš	sjákkusj	n	
siskkoš	siskusj	n	
juolgeluš	juolggelusj	n	
siskeluš	sisskelusj	n	
siskiluš	sisskelusj	n	
bátneluš	bádnelusj	n	
oaiveluš	oajvvelusj	n	
sulloš	sullusj	n	
vuoluš	vuolusj	n	
vuloš	vulusj	n	
bajáluš	bajálusj	n	
figgamuš	figgamusj	n	
viggamuš	viggamusj	n	
galgamuš	galggamusj	n	
dadjamuš	dadjamusj	n	
viežžamuš	viedtjamusj	n	
rahčamuš	rahtjamusj	n	
dahkamuš	dahkamusj	n	
juhkamuš	juhkamusj	n	
dutkamuš	dutkamusj	n	
ballamuš	ballamusj	n	
hállamuš	hállamusj	n	
soahpamuš	soahpamusj	n	
gáhtamuš	gáhtamusj	n	
smiehttamuš	smiehttamusj	n	
njuovvamuš	njuovvamusj	n	
boaldimuš	boalldemusj	n	
birgemuš	birggemusj	n	
báhčimuš	báhtjemusj	n	
siskkimuš	siskemusj	n	
sállemuš	sállemusj	n	
manimuš	manemusj	n	
monimuš	månemusj	n	
máksimuš	máksemusj	n	
boahtimuš	boahtemusj	n	
diktemuš	diktemusj	n	
fáktemuš	fáktemusj	n	
giitimuš	gijttemusj	n	
láitimuš	lájttemusj	n	
olmmoš	ålmusj	n	
olbmoš	ålmmusj	n	
vuomuš	vuomusj	n	
derpmoš	dermusj	n	
genddomuš	gendumusj	n	
cuoigumuš	tsuojggumusj	n	
áigumuš	ájggumusj	n	
buotnjomuš	buodnjumusj	n	
buotnjumuš	buodnjumusj	n	
čuožžumuš	tjuodtjumusj	n	
oskumuš	åsskumusj	n	
boaibmumuš	boajmmumusj	n	
átnumuš	ádnumusj	n	
sárdnumuš	sárnnumusj	n	
goarrumuš	goarrumusj	n	
dáhttumuš	dáhttumusj	n	
čuovvumuš	tjuovvumusj	n	
addámuš	addámusj	n	
váidámuš	vájddámusj	n	
vuordámuš	vuorddámusj	n	
boaldámuš	boalldámusj	n	
vuodjámuš	vuodjámusj	n	
bahčámuš	bahtjámusj	n	
báhčámuš	báhtjámusj	n	
cealkámuš	tsælkkámusj	n	
veto-cealkámuš	veto-tsælkkámusj	n	
gillámuš	gillámusj	n	
čállámuš	tjállámusj	n	
eallámuš	ællámusj	n	
atnámuš	adnámusj	n	
oaidnámuš	oajnnámusj	n	
máksámuš	máksámusj	n	
luohttámuš	luohttámusj	n	
moaitámuš	moajttámusj	n	
giitámuš	gijttámusj	n	
láitámuš	lájttámusj	n	
oaivámuš	oajvvámusj	n	
dovdamuš	dåvddåmusj	n	
bohčámuš	båhtjåmusj	n	
lohkamuš	låhkåmusj	n	
borramuš	bårråmusj	n	
ohcamuš	åhtsåmusj	n	
ednoš	eddnusj	n	
njunuš	njunusj	n	
duohpuš	duohpusj	n	
fuohpuš	fuohpusj	n	
náhpoš	náhpusj	n	
náppoš	náppusj	n	
bátneruš	bádnerusj	n	
viroš	virusj	n	
beasuš	biesusj	n	
bohtoš	båhtusj	n	
bearttuš	biertusj	n	
rattuš	rattusj	n	
oaivvuš	oajvusj	n	
leivvoš	lejvusj	n	
čoarvvuš	tjoarvusj	n	
soarvvuš	soarvusj	n	
searvvuš	siervusj	n	
maŋuš	maŋusj	n	
buoiddáš	buojdásj	n	
guovddáš	guovdásj	n	
ruovddáš	ruovdásj	n	
heađáš	hædásj	n	
gáđffáš	gádffásj	n	
čuoggáš	tjuoggásj	n	
jalggáš	jalgásj	n	
juolggáš	juolgásj	n	
duogáš	duogásj	n	
čuovggáš	tjuovgásj	n	
lágáš	lágásj	n	
eagáš	ægásj	n	
leagáš	lægásj	n	
baháš	bahásj	n	
veháš	vehásj	n	
veaháš	væhásj	n	
bajáš	bajásj	n	
soajáš	soajásj	n	
ádjáš	ádjásj	n	
njealjáš	njæljjásj	n	
manjáš	manjásj	n	
kránnjáš	kránnjásj	n	
seavnnjáš	sævnjásj	n	
girjjáš	girjásj	n	
oaččáš	oattjásj	n	
čoahkáš	tjoahkásj	n	
juhkkáš	juhkkásj	n	
seakkáš	sækkásj	n	
goaskkáš	goaskásj	n	
muoskkáš	muoskásj	n	
láskkáš	láskásj	n	
aláš	alásj	n	
oarpmealáš	oarmealásj	n	
liin-elláš	lijn-ellásj	n	
liidn-elláš	lijnn-ellásj	n	
cielláš	tsiellásj	n	
vuoláš	vuolásj	n	
dábáláš	dábálásj	n	
dáláš	dálásj	n	
boaimmáš	boajmásj	n	
guoimmáš	guojmásj	n	
njammáš	njammásj	n	
albmáš	almmásj	n	
eatnáš	ædnásj	n	
ránnáš	ránnásj	n	
bártnáš	bárnásj	n	
mánáš	mánásj	n	
beanáš	bænásj	n	
suohpáš	suohpásj	n	
oappáš	oappásj	n	
buoráš	buorásj	n	
birráš	birrásj	n	
náráš	nárásj	n	
earáš	ærásj	n	
siesáš	siesásj	n	
beassáš	bæssásj	n	
cizáš	tsitsásj	n	
čeazáš	tjætsásj	n	
rásáš	rásásj	n	
muoŧáš	muotásj	n	
rásttáš	rástásj	n	
ráttáš	ráttásj	n	
guovttáš	guovtásj	n	
beaivváš	bæjvásj	n	
soarvváš	soarvásj	n	
beavváš	bævvásj	n	
maŋáš	maŋásj	n	
saŋáš	saŋásj	n	
seakŋáš	sægŋásj	n	
seaŋáš	sæŋásj	n	
bođaš	bådåsj	n	
jogaš	jågåsj	n	
rogaš	rågåsj	n	
lojáš	låjåsj	n	
goikkáš	gåjkåsj	n	
gollaš	gållåsj	n	
golláš	gållåsj	n	
olbmáš	ålmmåsj	n	
otnáš	ådnåsj	n	
moraš	måråsj	n	
losáš	låsåsj	n	
lottáš	låttåsj	n	
bovttáš	båvtåsj	n	
mái	máj	n	
almmái	almáj	n	
masai	masáj	n	
olmmái	ålmåj	n	
rock	råck	n	
hallik	hallek	n	
biibal	bijbbal	n	
biibbal	bijbal	n	
hándal	hánddal	n	
guonddal	guondal	n	
hánddal	hándal	n	
eaŋgal	ieŋggal	n	
fáŋgal	fáŋggal	n	
hiŋggal	hiŋgal	n	
riŋggal	riŋgal	n	
speadjal	spiedjal	n	
speajal	spiejal	n	
fenihkal	fenehkal	n	
matrihkal	matrehkal	n	
artihkal	arttehkal	n	
partihkal	parttehkal	n	
martihkkal	marttihkkal	n	
partihkkal	parttihkkal	n	
firkkal	firkal	n	
siŋkkal	siŋkal	n	
gáinnal	gájnal	n	
steampal	stiemppal	n	
fárppal	fárpal	n	
bearal	bieral	n	
bearral	bierral	n	
kapihtal	kapehtal	n	
kápihtal	kápehtal	n	
ginttal	gintal	n	
kinttal	kintal	n	
snárttal	snártal	n	
apoasttal	apoastal	n	
episttal	epestal	n	
apostal	apustal	n	
seattal	siettal	n	
kapihttal	kapehttal	n	
kápihttal	kápehttal	n	
muoŧŧal	muottal	n	
heavval	hievval	n	
feambil	fiembbel	n	
veambil	viembbel	n	
humbil	humbbel	n	
hombil	håmbbel	n	
bearbil	bierbbel	n	
urbil	urbbel	n	
veabel	viebel	n	
bearbbil	bierbel	n	
mandel	manddel	n	
gándil	gánddel	n	
mándel	mánddel	n	
sándil	sánddel	n	
ordel	årddel	n	
ordil	årddel	n	
seđel	sedel	n	
jeagil	jiegel	n	
smeargil	smierggel	n	
orgel	årggel	n	
orgil	årggel	n	
gávgil	gávggel	n	
eŋgel	eŋggel	n	
juŋgel	juŋggel	n	
háŋgil	háŋggel	n	
triáŋgel	triáŋggel	n	
hiŋggil	hiŋgel	n	
gárjel	gárjjel	n	
gárjil	gárjjel	n	
goatnjil	goadnjel	n	
gardnjil	garnnjel	n	
heahkel	hiehkel	n	
áhkil	áhkel	n	
guškil	gussjkel	n	
vehikkel	vehekkel	n	
heakkel	hiekkel	n	
matrikkel	matrekkel	n	
rohkkil	råhkkel	n	
skoarkil	skoarkkel	n	
fearkil	fierkkel	n	
sirkil	sirkkel	n	
viŋkil	viŋkkel	n	
ákkil	ákkel	n	
sákkil	sákkel	n	
spetakkel	spetákkel	n	
muskel	musskel	n	
háskil	hásskel	n	
orakel	åråkel	n	
ipmil	ibmel	n	
jipmil	jibmel	n	
ápmil	ábmel	n	
njoammil	njoammel	n	
ulbmil	ulmmel	n	
formel	fårmel	n	
sámil	sámel	n	
goatnil	goadnel	n	
geahpil	giehpel	n	
eappel	ieppel	n	
goahppil	goahppel	n	
eahppel	iehppel	n	
guhppil	guhppel	n	
bohppel	båhppel	n	
sampel	samppel	n	
steampil	stiemppel	n	
tempel	temppel	n	
stempel	stemppel	n	
vispil	visspel	n	
ápril	áprel	n	
veaksel	vieksel	n	
veaksil	vieksel	n	
áksil	áksel	n	
meaisil	miejssel	n	
brensel	brenssel	n	
ránsel	ránssel	n	
azzil	adtsel	n	
goaktil	goaktel	n	
kapihttel	kapehttel	n	
goartil	goarttel	n	
koartil	koarttel	n	
máttil	máttel	n	
čavil	tjavel	n	
soavvil	soavvel	n	
oaivil	oajvvel	n	
ruoivil	ruojvvel	n	
duivil	dujvvel	n	
kervel	kervvel	n	
guorvil	guorvvel	n	
ávil	ável	n	
gargŋil	garŋŋel	n	
e-mail	e-majl	n	
paint^ball	pajnt^ball	n	
bumbol	bumbbul	n	
láfol	láful	n	
fidjol	fidjul	n	
suhkol	suhkul	n	
váhkol	váhkul	n	
suhkkol	suhkkul	n	
báhkkol	báhkkul	n	
sukkol	sukkul	n	
ruŋkul	ruŋkkul	n	
bubmol	bubbmul	n	
upmol	ubmul	n	
bupmol	bubmul	n	
seamul	siemul	n	
bummol	bummul	n	
gáhpol	gáhpul	n	
náhpol	náhpul	n	
guppol	guppul	n	
cuppol	tsuppul	n	
fássol	fássul	n	
suvvol	suvvul	n	
poly^akryl	påly^akryl	n	
ganjal	ganjál	n	
náskál	násskál	n	
ginal	ginál	n	
vearál	værál	n	
biŋal	biŋál	n	
diŋal	diŋál	n	
gohkal	gåhkål	n	
oskál	åsskål	n	
oppal	åppål	n	
bohtal	båhtål	n	
ketchup-bohtal	ketchup-båhtål	n	
skohtal	skåhtål	n	
skohttal	skåhttål	n	
balsam	balssam	n	
team	tiem	n	
muslim	muslem	n	
totem	tåtem	n	
medi^um	mede^um	n	
evangeli^um	evángele^um	n	
evaŋgeli^um	eváŋgele^um	n	
opi^um	åpe^um	n	
terrári^um	terráre^um	n	
cesi^um	tsese^um	n	
arti^um	artte^um	n	
album	albbum	n	
kompendium	kåmppendium	n	
kalsium	kalssium	n	
vakuum	vakoum	n	
forum	fårum	n	
pensum	penssum	n	
philoso^phicum	philuso^phitsum	n	
facultatum	fatsultatum	n	
CD-rom	CD-råm	n	
cd-rom	cd-råm	n	
guolban	guolbban	n	
cieban	tsieban	n	
guorbban	guorban	n	
čuorbban	tjuorban	n	
skurbban	skurban	n	
skárbban	skárban	n	
olgodaddan	ålggudaddan	n	
ráđđádaddan	ráddádaddan	n	
šaddan	sjaddan	n	
muitaladdan	mujttaladdan	n	
árvaladdan	árvvaladdan	n	
duhkoraddan	duhkuraddan	n	
suođđan	suoddan	n	
rivihuddan	rivehuddan	n	
gulaskuddan	guláskuddan	n	
rievdan	rievddan	n	
bieđan	biedan	n	
duolddan	duoldan	n	
hárddan	hárdan	n	
soađan	sådan	n	
čiegan	tjiegan	n	
seagan	siegan	n	
juoigan	juojggan	n	
čuoigan	tjuojggan	n	
gálgan	gálggan	n	
čuoiggan	tjuojgan	n	
ráiggan	rájgan	n	
gálggan	gálgan	n	
njurggan	njurgan	n	
árggan	árgan	n	
oagan	ågan	n	
hoagan	hågan	n	
coagan	tsågan	n	
stoagan	stågan	n	
čuojan	tjuojan	n	
vuorjjan	vuorjan	n	
reaššan	riessjan	n	
vuoššan	vuossjan	n	
eaiggáduššan	æjgádussjan	n	
skievttáruššan	skievtárussjan	n	
viežžan	viedtjan	n	
spahčan	spahtjan	n	
čiekčan	tjiektjan	n	
buošan	buotjan	n	
luovččan	luovtjan	n	
dávžžan	dávtjan	n	
skeaikkan	skiejkan	n	
huikkan	hujkan	n	
láikkan	lájkan	n	
cakkan	tsakkan	n	
čáhkkan	tjáhkkan	n	
giikan	gijkkan	n	
márkan	márkkan	n	
gievkan	gievkkan	n	
jávkan	jávkkan	n	
gilkkan	gilkan	n	
gulkkan	gulkan	n	
faskkan	faskan	n	
časkkan	tjaskan	n	
gaskan	gasskan	n	
iskan	isskan	n	
doavkkan	doavkan	n	
stoavkkan	stoavkan	n	
beavkkan	bievkan	n	
gievkkan	gievkan	n	
kievkkan	kievkan	n	
civkkan	tsivkan	n	
hiŋkkan	hiŋkan	n	
cielan	tsielan	n	
iskkadallan	iskadallan	n	
šiehtadallan	sjiehtadallan	n	
ladnjedallan	laddnjedallan	n	
logaldallan	lågåldallan	n	
ráđđádallan	ráddádallan	n	
gieđahallan	giedahallan	n	
ráimmahallan	rájmahallan	n	
jearahallan	jierahallan	n	
báhcahallan	báhtsahallan	n	
ráđđehallan	ráddehallan	n	
hárjehallan	hárjjehallan	n	
dohppehallan	dåhppehallan	n	
heivehallan	hejvvehallan	n	
lášmmohallan	lásjmuhallan	n	
erohallan	eruhallan	n	
gilvvohallan	gilvuhallan	n	
bijahallan	bijáhallan	n	
čájáhallan	tjájáhallan	n	
logahallan	lågåhallan	n	
sojahallan	såjåhallan	n	
govahallan	gåvåhallan	n	
digaštallan	digasjtallan	n	
háleštallan	hálesjtallan	n	
meroštallan	merusjtallan	n	
árvvoštallan	árvusjtallan	n	
faláštallan	falásjtallan	n	
valáštallan	valásjtallan	n	
guovžžastallan	guovtjastallan	n	
biepmastallan	biebmastallan	n	
čierastallan	tjierastallan	n	
barttastallan	bartastallan	n	
áđđestallan	áddestallan	n	
gálbbostallan	gálbustallan	n	
girkostallan	girkkustallan	n	
kirkostallan	kirkkustallan	n	
biepmostallan	biebmustallan	n	
erostallan	erustallan	n	
vurostallan	vurustallan	n	
seaibbástallan	sæjbástallan	n	
lađastallan	ladástallan	n	
ságastallan	ságástallan	n	
chat-ságastallan	chat-ságástallan	n	
oaččástallan	oattjástallan	n	
ladnástallan	laddnástallan	n	
seainnástallan	sæjnástallan	n	
hearrástallan	hærrástallan	n	
rollastallan	rållåstallan	n	
dolastallan	dålåstallan	n	
speallan	spiellan	n	
veallan	viellan	n	
čuolan	tjuolan	n	
doalan	dålan	n	
hoalan	hålan	n	
oapman	oabman	n	
biebman	biebbman	n	
siepman	siebman	n	
suopman	suobman	n	
vuopman	vuobman	n	
hápman	hábman	n	
šeaman	sjieman	n	
gieimman	giejman	n	
luoimman	luojman	n	
buimman	bujman	n	
báimman	bájman	n	
duolmman	duolman	n	
čatnan	tjadnan	n	
vietnan	viednan	n	
čuotnan	tjuodnan	n	
ruoinnan	ruojnan	n	
bárdnan	bárnnan	n	
čuonan	tjuonan	n	
čuohpan	tjuohpan	n	
fearan	fieran	n	
cihran	tsihran	n	
čirran	tjirran	n	
hoavrran	hoavran	n	
fievrran	fievran	n	
stivrran	stivran	n	
rávrran	rávran	n	
boaran	båran	n	
goaran	gåran	n	
šoaran	sjåran	n	
skoaran	skåran	n	
seasan	siesan	n	
beassan	biessan	n	
gársan	gárssan	n	
áiccan	ájtsan	n	
buozan	buotsan	n	
goazan	gåtsan	n	
njoazan	njåtsan	n	
láittan	lájtan	n	
visttan	vistan	n	
cievan	tsievan	n	
goaivvan	goajvan	n	
suoivvan	suojvan	n	
ruivvan	rujvan	n	
deaivan	diejvvan	n	
duolvan	duolvvan	n	
searvan	siervvan	n	
gealddohuvvan	gielduhuvvan	n	
suorgásuvvan	suorggásuvvan	n	
šávvan	sjávvan	n	
vuoigŋan	vuojŋŋan	n	
skárben	skárbben	n	
molybden	målybden	n	
addin	adden	n	
meađđen	miedden	n	
doidin	dåjdden	n	
gándin	gándden	n	
girdin	girdden	n	
sirdin	sirdden	n	
vuordin	vuordden	n	
gárdin	gárdden	n	
bordin	bårdden	n	
čoavdin	tjoavdden	n	
vuovdin	vuovdden	n	
njuvdin	njuvdden	n	
bovden	båvdden	n	
goddin	gådden	n	
gođđin	gådden	n	
lodden	lådden	n	
heđen	heden	n	
boaldin	boallden	n	
goldin	gållden	n	
standárden	standdárden	n	
goden	gåden	n	
beaggin	bieggen	n	
helgen	helggen	n	
čilgen	tjilggen	n	
bolgen	bålggen	n	
sáđgin	sárggen	n	
levgen	levggen	n	
jeŋgen	jeŋggen	n	
gáŋgen	gáŋggen	n	
máŋgen	máŋggen	n	
glykogen	glykugen	n	
halogen	halugen	n	
androgen	andrugen	n	
hydrogen	hydrugen	n	
østrogen	østrugen	n	
oksygen	åksygen	n	
doadjin	doadjen	n	
goadjin	goadjen	n	
sadjin	sadjen	n	
vuodjin	vuodjen	n	
gavjen	gavjjen	n	
gálljin	gálljen	n	
čelččen	tjeltjen	n	
leahkin	liehken	n	
juohkin	juohken	n	
šuohkin	sjuohken	n	
báhkin	báhken	n	
sohken	såhken	n	
došken	dåssjken	n	
čoahkkin	tjoahkken	n	
alken	alkken	n	
cealkin	tsielkken	n	
parken	parkken	n	
sákkin	sákken	n	
skabilken	skabelken	n	
herkken	herken	n	
goaskin	goassken	n	
čoaskin	tjoassken	n	
rátkin	rátken	n	
sovkken	såvken	n	
ballin	ballen	n	
eallin	iellen	n	
buollin	buollen	n	
skuvlen	skuvllen	n	
čállin	tjállen	n	
gollen	gållen	n	
pollen	pållen	n	
rollen	rållen	n	
sulin	sulen	n	
álin	álen	n	
folin	fålen	n	
lubmen	lubbmen	n	
hábmen	hábbmen	n	
jápmin	jábmen	n	
áhččemin	áhttjemen	n	
fenomen	fenumen	n	
pronomen	prånumen	n	
ieš-pronomen	iesj-prånumen	n	
examen	exámen	n	
omen	åmen	n	
nomen	nåmen	n	
manin	manen	n	
atnin	adnen	n	
vadnin	vaddnen	n	
ednen	eddnen	n	
vátnen	vádnen	n	
monnen	månnen	n	
monin	månen	n	
reahpen	riehpen	n	
láhppin	láhppen	n	
campen	tsamppen	n	
jarin	jaren	n	
kopi^eren	kåpe^eren	n	
konsenderen	kånssenderen	n	
parkeren	parkkeren	n	
kalkuleren	kalkkuleren	n	
mašineren	masjeneren	n	
mohtoriseren	måhturiseren	n	
automatiseren	autumatiseren	n	
bio^prospekteren	bio^pråsspekteren	n	
inventeren	invventeren	n	
diskonteren	disskunteren	n	
investeren	invvesteren	n	
birrin	birren	n	
skuvrin	skuvrren	n	
muvren	muvrren	n	
jorin	jåren	n	
haksin	haksen	n	
boksen	båksen	n	
moksin	måksen	n	
sveisen	svejssen	n	
liisen	lijssen	n	
sponsen	spånssen	n	
arsen	arssen	n	
vázzin	vádtsen	n	
gohcin	gåhtsen	n	
cikcen	tsiktsen	n	
benzen	benttsen	n	
runzen	runttsen	n	
boahtin	boahten	n	
johtin	jåhten	n	
laktin	lakten	n	
sálten	sállten	n	
njealjehastin	njieljjehasten	n	
guđahastin	gudáhasten	n	
válddalastin	váldalasten	n	
sihkkelastin	sihkkelasten	n	
vuollálastin	vuollálasten	n	
gárggalmastin	gárgalmasten	n	
rehkenastin	rehkenasten	n	
olgunastin	ålggunasten	n	
suotnjarastin	suodnjarasten	n	
sihkkarastin	sihkkarasten	n	
feberastin	feberasten	n	
laborastin	laburasten	n	
kopi^astin	kåpe^assten	n	
oastin	oassten	n	
eastin	iessten	n	
luisten	lujssten	n	
máistin	májssten	n	
dusten	dussten	n	
suorggidahttin	suorgedahtten	n	
vuolidahttin	vuoledahtten	n	
ovttaidahttin	åvtåjdahtten	n	
čuojaldahttin	tjuojaldahtten	n	
áigodahttin	ájggudahtten	n	
gabahahttin	gabáhahtten	n	
ealáskahttin	æláskahtten	n	
jorgalahttin	jårggålahtten	n	
oainnálmahttin	oajnálmahtten	n	
govastahttin	gåvåstahtten	n	
ruoššaduhttin	ruossjaduhtten	n	
veajuiduhttin	viejujduhtten	n	
dáruiduhttin	dárujduhtten	n	
váráiduhttin	várájduhtten	n	
válddálašvuođahuhttin	váldálasjvuodahuhtten	n	
vuovddehuhttin	vuovdehuhtten	n	
buolehuhttin	buolehuhtten	n	
vearjjohuhttin	vierjuhuhtten	n	
áššáskuhttin	ássjáskuhtten	n	
arvvosmuhttin	arvusmuhtten	n	
rohtten	råhtten	n	
soaitin	soajtten	n	
luoitin	luojtten	n	
fánten	fántten	n	
konten	kåntten	n	
karoten	karuten	n	
trinitrotoluen	trinetrotoluen	n	
herven	hervven	n	
gárven	gárvven	n	
várven	várvven	n	
govven	gåvven	n	
čegŋen	tjeggŋen	n	
Guovdageain	Guovddageajn	n	
kokain	kåkåjn	n	
marathon	maráthon	n	
audition	audetion	n	
leksikon	leksekon	n	
áššáiduhtton	ássjájduhtton	n	
maraton	maráton	n	
leabbun	liebbun	n	
karbon	karbbun	n	
kárbon	kárbbun	n	
čábbon	tjábbun	n	
obbon	åbbun	n	
ribon	ribun	n	
roibbon	råjbun	n	
šlembbon	slembun	n	
durbbon	durbun	n	
rábon	rábun	n	
lieđđun	lieddun	n	
láidon	lájddun	n	
láidun	lájddun	n	
geardun	gierddun	n	
suddon	suddun	n	
láiddon	lájdun	n	
máiddon	májdun	n	
váiddon	vájdun	n	
gerddon	gerdun	n	
muđon	mudun	n	
luvddon	luvdun	n	
govddon	gåvdun	n	
márffon	márfun	n	
láfon	láfun	n	
megon	megun	n	
vilgon	vilggun	n	
sárgun	sárggun	n	
njigon	njigun	n	
šelggon	sjelgun	n	
čulggon	tjulgun	n	
mulggon	mulgun	n	
čerggon	tjergun	n	
šleđggon	slergun	n	
biđggon	birgun	n	
cirggon	tsirgun	n	
njurggon	njurgun	n	
bárggon	bárgun	n	
sárggon	sárgun	n	
ravggon	ravgun	n	
heŋggon	heŋgun	n	
šleŋggon	sleŋgun	n	
ogon	ågun	n	
rogon	rågun	n	
doddjon	dåddjun	n	
ledjon	ledjun	n	
giljon	giljjun	n	
jievjun	jievjjun	n	
gilljon	gilljun	n	
šlietnjun	sliednjun	n	
dikšun	diksjun	n	
oažžun	oadtjun	n	
vuohčun	vuohtjun	n	
vuhččon	vuhttjun	n	
gohččun	gåhttjun	n	
vujon	vujun	n	
dájon	dájun	n	
fahkon	fahkun	n	
ihkon	ihkun	n	
fihkon	fihkun	n	
rihkon	rihkun	n	
sihkon	sihkun	n	
čohkun	tjåhkun	n	
fiikkon	fijkun	n	
biškkon	bisjkun	n	
giškon	gissjkun	n	
njiškun	njissjkun	n	
doškkon	dåsjkun	n	
njuikkon	njujkun	n	
ceahkkun	tsiehkkun	n	
ihkkon	ihkkun	n	
báhkkon	báhkkun	n	
fiikon	fijkkun	n	
niikun	nijkkun	n	
njuikun	njujkkun	n	
dulkon	dulkkun	n	
dálkun	dálkkun	n	
gálkon	gálkkun	n	
dárkun	dárkkun	n	
dutkkon	dutkkun	n	
botkkon	båtkkun	n	
el-botkkon	el-båtkkun	n	
sotkkon	såtkkun	n	
čukkon	tjukkun	n	
okkon	åkkun	n	
lokkon	låkkun	n	
snelkkon	snelkun	n	
ferkkon	ferkun	n	
merkkon	merkun	n	
faskkon	faskun	n	
vuskkon	vuskun	n	
lávkkon	lávkun	n	
čiŋkkon	tjiŋkun	n	
gilon	gilun	n	
silon	silun	n	
deallun	diellun	n	
meallun	miellun	n	
gávlun	gávllun	n	
lávlun	lávllun	n	
lávllon	lávlun	n	
govllon	gåvlun	n	
álon	álun	n	
dálon	dálun	n	
sálon	sálun	n	
njolon	njålun	n	
čolon	tjålun	n	
molon	målun	n	
el-molon	el-målun	n	
solon	sålun	n	
rábmon	rábbmun	n	
sepmon	sebmun	n	
boimmon	båjmun	n	
mammon	mammun	n	
dearbmun	diermmun	n	
gurbmon	gurmmun	n	
mámmon	mámmun	n	
hárpmon	hármun	n	
dumon	dumun	n	
njomon	njåmun	n	
čitnun	tjidnun	n	
vuhpon	vuhpun	n	
rámpon	rámppun	n	
visppon	visppun	n	
el-visppon	el-visppun	n	
čáppon	tjáppun	n	
beron	berun	n	
meeron	meerun	n	
meron	merun	n	
firon	firun	n	
giron	girun	n	
orrun	årrun	n	
sitron	sitrun	n	
báron	bárun	n	
gáron	gárun	n	
máron	márun	n	
doron	dårun	n	
geson	gesun	n	
molsson	målsun	n	
hámsson	hámsun	n	
nisson	nissun	n	
njuozzun	njuodtsun	n	
venzzon	ventsun	n	
gaccon	gattsun	n	
njeccon	njettsun	n	
bircun	birttsun	n	
ozon	åtsun	n	
njozon	njåtsun	n	
báson	básun	n	
boson	båsun	n	
dáhton	dáhtun	n	
plankton	planktun	n	
dustton	dustun	n	
nástton	nástun	n	
ihtton	ihttun	n	
lutton	luttun	n	
lovtton	låvtun	n	
devon	devun	n	
seivvon	sejvun	n	
goivvon	gåjvun	n	
gurvvon	gurvun	n	
čárvvon	tjárvun	n	
šuvon	sjuvun	n	
savvon	savvun	n	
skieivun	skiejvvun	n	
seaivun	siejvvun	n	
doalvun	doalvvun	n	
deađvun	diervvun	n	
meargŋun	mierŋŋun	n	
raban	rabán	n	
urbán	urbbán	n	
čađan	tjadán	n	
lađan	ladán	n	
sirdán	sirddán	n	
njalddán	njaldán	n	
boalddán	boaldán	n	
bulddán	buldán	n	
gealddán	gældán	n	
hárddán	hárdán	n	
duđan	dudán	n	
njuvddán	njuvdán	n	
cagan	tsagán	n	
cagán	tsagán	n	
geaigán	gæjggán	n	
leaggán	læggán	n	
njigan	njigán	n	
njágan	njágán	n	
galján	galjján	n	
dulján	duljján	n	
tulján	tuljján	n	
oarján	oarjján	n	
irján	irjján	n	
durján	durjján	n	
gášan	gásján	n	
bužan	butján	n	
bážan	bátján	n	
skájan	skáján	n	
rájan	ráján	n	
čoakkán	tjoakkán	n	
bieskán	biesskán	n	
falan	falán	n	
čalán	tjalán	n	
skilan	skilán	n	
silan	silán	n	
čálán	tjálán	n	
ealán	ælán	n	
jaman	jamán	n	
njaman	njamán	n	
njiman	njimán	n	
čanan	tjanán	n	
ránan	ránán	n	
haran	harán	n	
širan	sjirán	n	
sŋiran	sŋirán	n	
fearrán	færrán	n	
máran	márán	n	
váran	várán	n	
earán	ærán	n	
fearán	færán	n	
boaisán	boajssán	n	
geasán	gæsán	n	
láittán	lájtán	n	
vintán	vinttán	n	
deattán	dættán	n	
veattán	vættán	n	
váivván	vájván	n	
nuvan	nuván	n	
šávan	sjáván	n	
goban	gåbån	n	
dovdan	dåvddån	n	
gođđan	gåddån	n	
golddán	gåldån	n	
gorddán	gårdån	n	
gođán	gådån	n	
roggan	råggån	n	
božán	båtjån	n	
lojan	låjån	n	
lohkan	låhkån	n	
rokkan	råkkån	n	
cokkan	tsåkkån	n	
omman	åmmån	n	
ommán	åmmån	n	
roman	råmån	n	
loppan	låppån	n	
jorran	jårrån	n	
novrrán	nåvrån	n	
boran	bårån	n	
ohcan	åhtsån	n	
ohccan	åhttsån	n	
bosan	båsån	n	
ovsttán	åvstån	n	
johttán	jåhttån	n	
lovttan	låvtån	n	
gibbu	gibbo	n	
heaibu	hiejbbo	n	
láibu	lájbbo	n	
sáibu	sájbbo	n	
gealbu	gielbbo	n	
rumbu	rumbbo	n	
trumbu	trumbbo	n	
bámbu	bámbbo	n	
šlurbu	slurbbo	n	
dárbu	dárbbo	n	
jorbu	jårbbo	n	
klubbu	klubbo	n	
šlubbu	slubbo	n	
sáibbo	sájbo	n	
addu	addo	n	
fađđu	faddo	n	
šaddu	sjaddo	n	
boađđu	boaddo	n	
skoaddu	skoaddo	n	
spoađđu	spoaddo	n	
vađđu	vaddo	n	
deaddu	dieddo	n	
skieddu	skieddo	n	
šleađđu	slieddo	n	
speađđu	spieddo	n	
biddu	biddo	n	
giđđu	giddo	n	
skiddu	skiddo	n	
riddu	riddo	n	
riđđu	riddo	n	
oaidu	oajddo	n	
loaidu	loajddo	n	
geaidu	giejddo	n	
šleaidu	sliejddo	n	
reaidu	riejddo	n	
reidu	rejddo	n	
diidu	dijddo	n	
skiidu	skijddo	n	
riidu	rijddo	n	
siidu	sijddo	n	
web-siidu	web-sijddo	n	
tiidu	tijddo	n	
muoidu	muojddo	n	
áidu	ájddo	n	
dáidu	dájddo	n	
ráidu	rájddo	n	
oidu	åjddo	n	
hoidu	håjddo	n	
indu	inddo	n	
luondu	luonddo	n	
buođđu	buoddo	n	
fuođđu	fuoddo	n	
guoddu	guoddo	n	
vuođđo	vuoddo	n	
vuođđu	vuoddo	n	
bardu	barddo	n	
goardu	goarddo	n	
geardu	gierddo	n	
gierdu	gierddo	n	
sirdu	sirddo	n	
stirdu	stirddo	n	
snuordu	snuorddo	n	
vuordu	vuorddo	n	
burdu	burddo	n	
murdu	murddo	n	
gárdu	gárddo	n	
hárdu	hárddo	n	
márdu	márddo	n	
várdu	várddo	n	
bordu	bårddo	n	
uddu	uddo	n	
buddu	buddo	n	
muddu	muddo	n	
suddu	suddo	n	
navdu	navddo	n	
oavdu	oavddo	n	
joavdu	joavddo	n	
dievdu	dievddo	n	
reavdu	rievddo	n	
bivdu	bivddo	n	
gäbbälä^bivdu	gäbbälä^bivddo	n	
skuvdu	skuvddo	n	
ruvdu	ruvddo	n	
ávdu	ávddo	n	
skávdu	skávddo	n	
lávdu	lávddo	n	
rávdu	rávddo	n	
ovdu	åvddo	n	
dovdu	dåvddo	n	
gáddu	gáddo	n	
láddu	láddo	n	
máddu	máddo	n	
sáddu	sáddo	n	
sáđđu	sáddo	n	
váddu	váddo	n	
váđđu	váddo	n	
boddu	båddo	n	
goddu	gåddo	n	
gođđu	gåddo	n	
joddu	jåddo	n	
čođđu	tjåddo	n	
loddu	låddo	n	
nođđu	nåddo	n	
beđo	bedo	n	
mieđu	miedo	n	
oaiddu	oajdo	n	
njoaiddu	njoajdo	n	
baldu	balldo	n	
skaldu	skalldo	n	
boaldu	boalldo	n	
skoaldu	skoalldo	n	
bealdu	bielldo	n	
gealdu	gielldo	n	
gieldu	gielldo	n	
ildu	illdo	n	
dildu	dilldo	n	
hildu	hilldo	n	
vildu	villdo	n	
guoldu	guolldo	n	
muoldu	muolldo	n	
uldu	ulldo	n	
buldu	bulldo	n	
áldu	álldo	n	
gáldu	gálldo	n	
háldu	hálldo	n	
jáldu	jálldo	n	
máldu	málldo	n	
snáldu	snálldo	n	
sáldo	sálldo	n	
váldu	válldo	n	
ta^ekwondo	ta^ekwundo	n	
kommando	kåmmåndo	n	
avokádo	avukádo	n	
geaffu	gieffo	n	
riifu	rijffo	n	
spálfu	spálffo	n	
loarfu	loarffo	n	
fárfu	fárffo	n	
járfu	járffo	n	
jáffu	jáffo	n	
stáffu	stáffo	n	
jáfu	jáfo	n	
láfu	láfo	n	
origo	årego	n	
oaggu	oaggo	n	
liggu	liggo	n	
dieigu	diejggo	n	
riigu	rijggo	n	
ruoigu	ruojggo	n	
guigu	gujggo	n	
ruigu	rujggo	n	
dáigu	dájggo	n	
njáigu	njájggo	n	
láigu	lájggo	n	
sáigu	sájggo	n	
čielgu	tjielggo	n	
stielgu	stielggo	n	
duolgu	duolggo	n	
álgu	álggo	n	
bálgu	bálggo	n	
gálgu	gálggo	n	
hálgu	hálggo	n	
čálgu	tjálggo	n	
spálgu	spálggo	n	
olgu	ålggo	n	
golgu	gålggo	n	
šolgu	sjålggo	n	
njuoggu	njuoggo	n	
šnjuoggu	sjnjuoggo	n	
luoggu	luoggo	n	
bargu	barggo	n	
nargu	narggo	n	
goargu	goarggo	n	
loađgu	loarggo	n	
soađgu	soarggo	n	
biergu	bierggo	n	
fiergu	fierggo	n	
viergu	vierggo	n	
duorgu	duorggo	n	
njuorgu	njuorggo	n	
urgu	urggo	n	
gurgu	gurggo	n	
gárgu	gárggo	n	
sárgu	sárggo	n	
duggu	duggo	n	
ruggu	ruggo	n	
cuggu	tsuggo	n	
roavgu	roavggo	n	
rivgu	rivggo	n	
dávgu	dávggo	n	
njaŋgu	njaŋggo	n	
šloaŋgu	sloaŋggo	n	
stoaŋgu	stoaŋggo	n	
heŋgo	heŋggo	n	
šleaŋgu	slieŋggo	n	
biŋgo	biŋggo	n	
šliŋgu	sliŋggo	n	
spuŋgu	spuŋggo	n	
ruŋgu	ruŋggo	n	
háŋgu	háŋggo	n	
njáŋgu	njáŋggo	n	
bággu	bággo	n	
njággu	njággo	n	
lággu	lággo	n	
nággu	nággo	n	
spággu	spággo	n	
rággu	rággo	n	
stággu	stággo	n	
geiggo	gejgo	n	
čuolggu	tjuolgo	n	
buogu	buogo	n	
vuorggu	vuorgo	n	
urggu	urgo	n	
njurggu	njurgo	n	
gárggu	gárgo	n	
sárggu	sárgo	n	
heaŋggu	hieŋgo	n	
čogu	tjågo	n	
logo	lågo	n	
ladju	ladjo	n	
oadju	oadjo	n	
boadju	boadjo	n	
doadju	doadjo	n	
readdju	rieddjo	n	
dáddju	dáddjo	n	
biedju	biedjo	n	
headju	hiedjo	n	
veadju	viedjo	n	
ádju	ádjo	n	
ládju	ládjo	n	
rádju	rádjo	n	
sodju	sådjo	n	
gulju	guljjo	n	
olju	åljjo	n	
solju	såljjo	n	
barju	barjjo	n	
fearju	fierjjo	n	
vearju	vierjjo	n	
girju	girjjo	n	
njuorju	njuorjjo	n	
guđju	gurjjo	n	
fárju	fárjjo	n	
várju	várjjo	n	
ođju	årjjo	n	
ávju	ávjjo	n	
šallju	sjalljo	n	
stoallju	stoalljo	n	
eallju	ielljo	n	
šeallju	sjielljo	n	
šillju	sjilljo	n	
mullju	mulljo	n	
hállju	hálljo	n	
vállju	válljo	n	
spatnju	spadnjo	n	
gudnju	guddnjo	n	
suotnju	suodnjo	n	
livdnju	livnnjo	n	
njuorjju	njuorjo	n	
dikšu	diksjo	n	
ákšu	áksjo	n	
gákšu	gáksjo	n	
boaššu	boassjo	n	
vaššu	vassjo	n	
deaššu	diessjo	n	
feaššu	fiessjo	n	
riššu	rissjo	n	
viššu	vissjo	n	
goalšu	goalssjo	n	
loamšu	loamssjo	n	
rumšu	rumssjo	n	
rámšu	rámssjo	n	
duoršu	duorssjo	n	
njuoršu	njuorssjo	n	
guršu	gurssjo	n	
nuršu	nurssjo	n	
boršu	bårssjo	n	
ruššu	russjo	n	
áššu	ássjo	n	
háššu	hássjo	n	
máššu	mássjo	n	
ráššu	rássjo	n	
hášo	hásjo	n	
steažžu	stiedtjo	n	
gižžu	gidtjo	n	
ružžu	rudtjo	n	
stážžu	stádtjo	n	
gohču	gåhtjo	n	
njiekču	njiektjo	n	
ákču	áktjo	n	
skálžu	skálltjo	n	
spálžu	spálltjo	n	
guoržžu	guortjo	n	
geahčču	giehttjo	n	
fihčču	fihttjo	n	
svihčču	svihttjo	n	
duohčču	duohttjo	n	
vuohčču	vuohttjo	n	
gáhčču	gáhttjo	n	
spáhčču	spáhttjo	n	
spálču	spálttjo	n	
roanžu	roanttjo	n	
oaržu	oarttjo	n	
skurču	skurttjo	n	
čoavžu	tjoavttjo	n	
ruvžu	ruvttjo	n	
ávžu	ávttjo	n	
čoavžžu	tjoavtjo	n	
lávžžu	lávtjo	n	
gožu	gåtjo	n	
risiko	riseko	n	
bahku	bahko	n	
dahku	dahko	n	
hoahku	hoahko	n	
loahku	loahko	n	
šloahku	sloahko	n	
stoahku	stoahko	n	
sahku	sahko	n	
geahku	giehko	n	
šiehku	sjiehko	n	
liehku	liehko	n	
neahku	niehko	n	
niehku	niehko	n	
viehku	viehko	n	
juohku	juohko	n	
luohku	luohko	n	
ruhku	ruhko	n	
háhku	háhko	n	
láhku	láhko	n	
máhku	máhko	n	
ráhku	ráhko	n	
váhku	váhko	n	
lohku	låhko	n	
limšku	limssjko	n	
rámšku	rámssjko	n	
máršku	márssjko	n	
bušku	bussjko	n	
njášku	njássjko	n	
njuikku	njujko	n	
bakku	bakko	n	
boahkku	boahkko	n	
čoahkku	tjoahkko	n	
sahkku	sahkko	n	
stahkku	stahkko	n	
vahkku	vahkko	n	
jiehkku	jiehkko	n	
leahkku	liehkko	n	
liehkku	liehkko	n	
seahkku	siehkko	n	
dihkku	dihkko	n	
lihkku	lihkko	n	
rihkku	rihkko	n	
duohkku	duohkko	n	
suohkku	suohkko	n	
vuohkku	vuohkko	n	
uhkku	uhkko	n	
duhkku	duhkko	n	
juhkku	juhkko	n	
ruhkku	ruhkko	n	
áhkku	áhkko	n	
báhkku	báhkko	n	
gáhkku	gáhkko	n	
jáhkku	jáhkko	n	
láhkku	láhkko	n	
smáhkku	smáhkko	n	
ráhkku	ráhkko	n	
sáhkku	sáhkko	n	
liiku	lijkko	n	
ciiku	tsijkko	n	
buiku	bujkko	n	
luiku	lujkko	n	
njáiku	njájkko	n	
ráiku	rájkko	n	
goiku	gåjkko	n	
belko	belkko	n	
bealku	bielkko	n	
dielku	dielkko	n	
stielku	stielkko	n	
bilku	bilkko	n	
čulku	tjulkko	n	
bálku	bálkko	n	
gálku	gálkko	n	
nálku	nálkko	n	
bolku	bålkko	n	
skierku	skierkko	n	
spierku	spierkko	n	
girku	girkko	n	
kirku	kirkko	n	
mirko	mirkko	n	
mirku	mirkko	n	
gurku	gurkko	n	
hurku	hurkko	n	
murku	murkko	n	
bárku	bárkko	n	
dárku	dárkko	n	
márku	márkko	n	
guotkku	guotkko	n	
goavku	goavkko	n	
joavku	joavkko	n	
pop-joavku	påp-joavkko	n	
loavku	loavkko	n	
roavku	roavkko	n	
buvku	buvkko	n	
čuvku	tjuvkko	n	
jávku	jávkko	n	
goaŋku	goaŋkko	n	
reŋko	reŋkko	n	
liŋku	liŋkko	n	
ruŋku	ruŋkko	n	
báŋku	báŋkko	n	
pláŋku	pláŋkko	n	
mirkko	mirko	n	
hilsku	hilsko	n	
vuoskku	vuosko	n	
besko	bessko	n	
feasku	fiessko	n	
geasku	giessko	n	
veasku	viessko	n	
fisku	fissko	n	
risku	rissko	n	
roaisku	roajssko	n	
beaisku	biejssko	n	
liisku	lijssko	n	
duisku	dujssko	n	
tuisku	tujssko	n	
ráisku	rájssko	n	
limsku	limssko	n	
luosku	luossko	n	
ruosku	ruossko	n	
boarsku	boarssko	n	
hersko	herssko	n	
mársku	márssko	n	
loavsku	loavssko	n	
livsku	livssko	n	
nuvsku	nuvssko	n	
jávsku	jávssko	n	
dásku	dássko	n	
fiásko	fiássko	n	
flásku	flássko	n	
tásku	tássko	n	
osku	åssko	n	
mosku	måssko	n	
itku	itko	n	
vitku	vitko	n	
guotku	guotko	n	
ruotku	ruotko	n	
gátku	gátko	n	
sátku	sátko	n	
gielu	gielo	n	
jealu	jielo	n	
gilu	gilo	n	
kilu	kilo	n	
geailu	giejlo	n	
keailu	kiejlo	n	
fiilu	fijlo	n	
giilu	gijlo	n	
ballu	ballo	n	
šallu	sjallo	n	
boallu	boallo	n	
doallu	doallo	n	
goallu	goallo	n	
hoallu	hoallo	n	
moallu	moallo	n	
snoallu	snoallo	n	
eallu	iello	n	
biellu	biello	n	
diellu	diello	n	
fiellu	fiello	n	
geallu	giello	n	
heallu	hiello	n	
jiellu	jiello	n	
njiellu	njiello	n	
meallu	miello	n	
speallu	spiello	n	
siellu	siello	n	
nuovhlu	nuovhllo	n	
uvhlu	uvhllo	n	
illu	illo	n	
billu	billo	n	
skillu	skillo	n	
millu	millo	n	
duollu	duollo	n	
čuollu	tjuollo	n	
tuollu	tuollo	n	
stuollu	stuollo	n	
ullu	ullo	n	
gullu	gullo	n	
levlo	levllo	n	
givlo	givllo	n	
sivlu	sivllo	n	
guovlu	guovllo	n	
uvlu	uvllo	n	
huvlu	huvllo	n	
gávlo	gávllo	n	
lávlu	lávllo	n	
vávlu	vávllo	n	
állu	állo	n	
bállu	bállo	n	
dállu	dállo	n	
fállu	fállo	n	
gállu	gállo	n	
hállu	hállo	n	
šállo	sjállo	n	
šállu	sjállo	n	
čállu	tjállo	n	
skállu	skállo	n	
nállu	nállo	n	
stállu	stállo	n	
bollu	bållo	n	
kava-bollu	kava-bållo	n	
gollu	gållo	n	
lollu	lållo	n	
suolu	suolo	n	
gapmu	gabmo	n	
hapmu	habmo	n	
loapmu	loabmo	n	
sapmu	sabmo	n	
biebmu	biebbmo	n	
hipmu	hibmo	n	
duopmu	duobmo	n	
juopmu	juobmo	n	
luopmu	luobmo	n	
suopmu	suobmo	n	
hupmu	hubmo	n	
lupmu	lubmo	n	
dápmu	dábmo	n	
fápmu	fábmo	n	
el-fápmu	el-fábmo	n	
hápmu	hábmo	n	
jápmu	jábmo	n	
skápmu	skábmo	n	
opmu	åbmo	n	
ropmu	råbmo	n	
sopmu	såbmo	n	
seamu	siemo	n	
liehmu	liehmo	n	
njoammu	njoammo	n	
heaibmu	hiejmmo	n	
rieibmu	riejmmo	n	
diibmo	dijmmo	n	
diibmu	dijmmo	n	
tiibmu	tijmmo	n	
áibmu	ájmmo	n	
váibmu	vájmmo	n	
helbmo	helmmo	n	
goarbmu	goarmmo	n	
herbmo	hermmo	n	
skurbmu	skurmmo	n	
árbmu	ármmo	n	
bárbmu	bármmo	n	
dárbmu	dármmo	n	
hummu	hummo	n	
guomu	guomo	n	
muomu	muomo	n	
gomu	gåmo	n	
atnu	adno	n	
didnu	diddno	n	
fidnu	fiddno	n	
lidnu	liddno	n	
ridnu	riddno	n	
ruodnu	ruoddno	n	
udnu	uddno	n	
dudnu	duddno	n	
ádnu	áddno	n	
fádnu	fáddno	n	
gádno	gáddno	n	
gádnu	gáddno	n	
rádnu	ráddno	n	
eatnu	iedno	n	
deatnu	diedno	n	
sitnu	sidno	n	
fuotnu	fuodno	n	
rátnu	rádno	n	
rotnu	rådno	n	
eanu	ieno	n	
lievhnu	lievhno	n	
ainu	ajno	n	
kiino	kijno	n	
mannu	manno	n	
meannu	mienno	n	
oaidnu	oajnno	n	
geaidnu	giejnno	n	
reaidnu	riejnno	n	
biidnu	bijnno	n	
fiidnu	fijnno	n	
báidnu	bájnno	n	
gáidnu	gájnno	n	
máidnu	májnno	n	
váidnu	vájnno	n	
girdno	girnno	n	
girdnu	girnno	n	
kirdno	kirnno	n	
dordnu	dårnno	n	
bunnu	bunno	n	
rievdnu	rievnno	n	
uvdnu	uvnno	n	
ruvdno	ruvnno	n	
ruvdnu	ruvnno	n	
kruvdno	kruvnno	n	
kruvdnu	kruvnno	n	
truvdnu	truvnno	n	
vávdno	vávnno	n	
mánnu	mánno	n	
girtno	girno	n	
kirtno	kirno	n	
porno	pårno	n	
oregáno	åregáno	n	
sopráno	såpråno	n	
shampoo	shamppoo	n	
heahpu	hiehpo	n	
leahpu	liehpo	n	
riehpu	riehpo	n	
gihpu	gihpo	n	
áhpu	áhpo	n	
báhpu	báhpo	n	
náhpu	náhpo	n	
stohpu	ståhpo	n	
šámppu	sjámpo	n	
deappu	dieppo	n	
leappu	lieppo	n	
lahppu	lahppo	n	
oahppu	oahppo	n	
hoahppu	hoahppo	n	
skeahppu	skiehppo	n	
steahppu	stiehppo	n	
gihppu	gihppo	n	
lihppu	lihppo	n	
strihppu	strihppo	n	
skuohppu	skuohppo	n	
luhppu	luhppo	n	
skáhppu	skáhppo	n	
láhppu	láhppo	n	
gohppu	gåhppo	n	
lippu	lippo	n	
leaipu	liejppo	n	
biipu	bijppo	n	
riipu	rijppo	n	
doalpu	doalppo	n	
stoalpu	stoalppo	n	
vuolpu	vuolppo	n	
gulpu	gulppo	n	
nulpu	nulppo	n	
válpu	válppo	n	
gimpu	gimppo	n	
limpu	limppo	n	
šumpu	sjumppo	n	
sumpu	sumppo	n	
stumpu	stumppo	n	
gámpu	gámppo	n	
šámpu	sjámppo	n	
lámpu	lámppo	n	
cuoppu	tsuoppo	n	
goarpu	goarppo	n	
árpu	árppo	n	
boaru	boaro	n	
biru	biro	n	
soairu	soajro	n	
liiru	lijro	n	
guiru	gujro	n	
áiru	ájro	n	
gáiru	gájro	n	
guoru	guoro	n	
garru	garro	n	
doarru	doarro	n	
goarru	goarro	n	
njoarru	njoarro	n	
skoarru	skoarro	n	
sparru	sparro	n	
earru	ierro	n	
gearru	gierro	n	
jearru	jierro	n	
čearru	tjierro	n	
skearru	skierro	n	
skierru	skierro	n	
spierru	spierro	n	
vearru	vierro	n	
vierru	vierro	n	
njirru	njirro	n	
guorru	guorro	n	
juorru	juorro	n	
vuorru	vuorro	n	
burru	burro	n	
šurru	sjurro	n	
surru	surro	n	
roavru	roavrro	n	
evro	evrro	n	
hevro	hevrro	n	
eavru	ievrro	n	
fievru	fievrro	n	
čievru	tjievrro	n	
vuovru	vuovrro	n	
buvru	buvrro	n	
dávru	dávrro	n	
fávru	fávrro	n	
stávru	stávrro	n	
árru	árro	n	
bárru	bárro	n	
dárru	dárro	n	
fárru	fárro	n	
skárru	skárro	n	
orru	årro	n	
jorru	jårro	n	
čorru	tjårro	n	
čuru	tjuro	n	
nisu	niso	n	
haksu	hakso	n	
bieksu	biekso	n	
geaksu	giekso	n	
leaksu	liekso	n	
diksu	dikso	n	
uksu	ukso	n	
huksu	hukso	n	
juksu	jukso	n	
máksu	mákso	n	
roassu	roasso	n	
geassu	giesso	n	
meassu	miesso	n	
seassu	siesso	n	
viessu	viesso	n	
bissu	bisso	n	
missu	misso	n	
nissu	nisso	n	
reaisu	riejsso	n	
giisu	gijsso	n	
healsu	hielsso	n	
rimsu	rimsso	n	
gámsu	gámsso	n	
rámsu	rámsso	n	
ánsu	ánsso	n	
dánsu	dánsso	n	
ránsu	ránsso	n	
vuossu	vuosso	n	
vearsu	viersso	n	
vuorsu	vuorsso	n	
mársu	mársso	n	
korsu	kårsso	n	
ruvsu	ruvsso	n	
ássu	ásso	n	
dássu	dásso	n	
vássu	vásso	n	
bossu	båsso	n	
boazu	boatso	n	
roahcu	roahtso	n	
buohcu	buohtso	n	
njuohcu	njuohtso	n	
muohcu	muohtso	n	
báhcu	báhtso	n	
njáhcu	njáhtso	n	
sáhcu	sáhtso	n	
cáhcu	tsáhtso	n	
ohcu	åhtso	n	
gohcu	gåhtso	n	
njohcu	njåhtso	n	
flamenco	flamentso	n	
suozu	suotso	n	
áicu	ájttso	n	
cáicu	tsájttso	n	
hilcu	hilttso	n	
cincu	tsinttso	n	
bircu	birttso	n	
gárcu	gárttso	n	
guovssu	guovso	n	
geŧo	geto	n	
boahtu	boahto	n	
goahtu	goahto	n	
beahtu	biehto	n	
diehtu	diehto	n	
seahtu	siehto	n	
veahtu	viehto	n	
ihtu	ihto	n	
rihtu	rihto	n	
luohtu	luohto	n	
muohtu	muohto	n	
ruohtu	ruohto	n	
šluhtu	sluhto	n	
áhtu	áhto	n	
gáhtu	gáhto	n	
láhtu	láhto	n	
máhtu	máhto	n	
ráhtu	ráhto	n	
johtu	jåhto	n	
lohtu	låhto	n	
rohtu	råhto	n	
loaktu	loakto	n	
eaktu	iekto	n	
beaktu	biekto	n	
geaktu	giekto	n	
leaktu	liekto	n	
liktu	likto	n	
šliktu	slikto	n	
duoktu	duokto	n	
luoktu	luokto	n	
ruoktu	ruokto	n	
buktu	bukto	n	
ruktu	rukto	n	
ráktu	rákto	n	
boaltu	boallto	n	
čoaltu	tjoallto	n	
salto	sallto	n	
skieltu	skiellto	n	
biltu	billto	n	
buoltu	buollto	n	
duoltu	duollto	n	
sultu	sullto	n	
álto	állto	n	
áltu	állto	n	
vuosttu	vuosto	n	
astu	assto	n	
oastu	oassto	n	
goastu	goassto	n	
giestu	giessto	n	
leastu	liessto	n	
meastu	miessto	n	
seastu	siessto	n	
bistu	bissto	n	
gistu	gissto	n	
listu	lissto	n	
narko-listu	narkko-lissto	n	
hiistu	hijssto	n	
máistu	májssto	n	
suostu	suossto	n	
boarstu	boarssto	n	
bustu	bussto	n	
lustu	lussto	n	
návstu	návssto	n	
fástu	fássto	n	
vástu	vássto	n	
ostu	åssto	n	
goaŧŧu	goatto	n	
geaŧŧu	gietto	n	
lahttu	lahtto	n	
oahttu	oahtto	n	
doahttu	doahtto	n	
roahttu	roahtto	n	
soahttu	soahtto	n	
beahttu	biehtto	n	
fiehttu	fiehtto	n	
geahttu	giehtto	n	
leahttu	liehtto	n	
fihttu	fihtto	n	
lihttu	lihtto	n	
mihttu	mihtto	n	
vihttu	vihtto	n	
suhttu	suhtto	n	
dáhttu	dáhtto	n	
gáhttu	gáhtto	n	
skáhttu	skáhtto	n	
láhttu	láhtto	n	
máhttu	máhtto	n	
sáhttu	sáhtto	n	
váhttu	váhtto	n	
bohttu	båhtto	n	
pohttu	påhtto	n	
rohttu	råhtto	n	
giitu	gijtto	n	
liitu	lijtto	n	
niitu	nijtto	n	
luoitu	luojtto	n	
vuoitu	vuojtto	n	
uitu	ujtto	n	
huitu	hujtto	n	
skuitu	skujtto	n	
muitu	mujtto	n	
ruitu	rujtto	n	
snáitu	snájtto	n	
spáitu	spájtto	n	
reantu	rientto	n	
spintu	spintto	n	
lánto	lántto	n	
šlántu	slántto	n	
konto	kåntto	n	
kontu	kåntto	n	
guottu	guotto	n	
goartu	goartto	n	
fiertu	fiertto	n	
viertu	viertto	n	
muortu	muortto	n	
smuortu	smuortto	n	
nuortu	nuortto	n	
murtu	murtto	n	
smurtu	smurtto	n	
snurtu	snurtto	n	
spártu	spártto	n	
mortu	mårtto	n	
porto	pårtto	n	
láttu	látto	n	
sáttu	sátto	n	
lotto	låtto	n	
ruvtto	ruvto	n	
savu	savo	n	
gáivvo	gájvo	n	
njuovu	njuovo	n	
soavvu	soavvo	n	
heavvu	hievvo	n	
neavvu	nievvo	n	
el-neavvu	el-nievvo	n	
rievvu	rievvo	n	
bivvu	bivvo	n	
sivvu	sivvo	n	
doaivu	doajvvo	n	
goaivu	goajvvo	n	
deaivu	diejvvo	n	
siivu	sijvvo	n	
viivu	vijvvo	n	
gáivo	gájvvo	n	
doalvu	doalvvo	n	
gilvu	gilvvo	n	
álvu	álvvo	n	
gálvu	gálvvo	n	
sálvu	sálvvo	n	
njuovvu	njuovvo	n	
čuovvu	tjuovvo	n	
ruovvu	ruovvo	n	
arvu	arvvo	n	
nuorvu	nuorvvo	n	
lurvu	lurvvo	n	
árvu	árvvo	n	
gárvu	gárvvo	n	
dorvu	dårvvo	n	
ávvu	ávvo	n	
lávvu	lávvo	n	
rávvu	rávvo	n	
vávvu	vávvo	n	
fakŋu	fagŋo	n	
soakŋu	soagŋo	n	
soagŋu	soaggŋo	n	
ákŋu	ágŋo	n	
cuoŋu	tsuoŋo	n	
átŋu	átŋo	n	
maŋŋu	maŋŋo	n	
goargŋu	goarŋŋo	n	
cup	tsup	n	
hip-hop	hip-håp	n	
pop	påp	n	
dimbbar	dimbar	n	
šlimbbar	slimbar	n	
šlámbbar	slámbar	n	
sylinddar	sylenddar	n	
forminddar	fårmenddar	n	
flundar	flunddar	n	
snow^boardar	snåw^boarddar	n	
kurdar	kurddar	n	
spáiddar	spájdar	n	
álddar	áldar	n	
finddar	findar	n	
unddar	undar	n	
kunddar	kundar	n	
fuođar	fuodar	n	
fálffar	fálfar	n	
čiegar	tjiegar	n	
boargar	boarggar	n	
sáiggar	sájgar	n	
spiŋggar	spiŋgar	n	
uŋggar	uŋgar	n	
speajar	spiejar	n	
guotnjar	guodnjar	n	
komihkar	kåmehkar	n	
teknihkar	teknehkar	n	
klassihkar	klassehkar	n	
musihkar	musehkar	n	
fysihkar	fysehkar	n	
kritihkar	kritehkar	n	
optihkar	åptehkar	n	
akademihkar	akádemihkar	n	
mekanihkar	mekánihkar	n	
botanihkar	båtånihkar	n	
historihkar	hissturihkar	n	
politihkar	påletihkar	n	
estetihkar	esstetihkar	n	
kiikkar	kijkar	n	
politihkkar	påletihkkar	n	
giikar	gijkkar	n	
čuokkar	tjuokkar	n	
dieskkar	dieskar	n	
áŋkkar	áŋkar	n	
tráilar	trájlar	n	
semi-tráilar	semi-trájlar	n	
kuntepillar	kunttepillar	n	
bismmar	bismar	n	
dudnar	duddnar	n	
dutnar	dudnar	n	
medisiinnar	medesijnar	n	
šloahpar	sloahpar	n	
šluppar	sluppar	n	
programmerar	prågråmmerar	n	
bunzzar	buntsar	n	
gufihtar	gufehtar	n	
gilomehtar	gilumehtar	n	
baromehtar	barumehtar	n	
desilihtar	deselihtar	n	
skielttar	skieltar	n	
filttar	filtar	n	
skilttar	skiltar	n	
orkeastar	årkkeastar	n	
orkeasttar	årkkeastar	n	
loasttar	loastar	n	
kloasttar	kloastar	n	
magisttar	magestar	n	
registtar	regestar	n	
viesttar	viestar	n	
ministtar	minestar	n	
minsttar	minstar	n	
gunsttar	gunstar	n	
plásttar	plástar	n	
šláttar	sláttar	n	
bulvvar	bulvar	n	
pulvvar	pulvar	n	
cy^ber	tsy^ber	n	
fiiber	fijbber	n	
gálbir	gálbber	n	
skibir	skiber	n	
guobir	guober	n	
bábir	báber	n	
koriánder	kåriánder	n	
máđir	máder	n	
váđir	váder	n	
kefir	kefer	n	
luffir	luffer	n	
nagir	nager	n	
giegir	gieger	n	
tiiger	tijgger	n	
háigir	hájgger	n	
skuoggir	skuogger	n	
šaŋger	sjaŋgger	n	
šáŋger	sjáŋgger	n	
dággir	dágger	n	
spigir	spiger	n	
muogir	muoger	n	
hamburger	hambburger	n	
gágir	gáger	n	
manager	manáger	n	
ságir	ságer	n	
suonjir	suonjer	n	
maššir	massjer	n	
veažir	vietjer	n	
veahčir	viehtjer	n	
šáhčir	sjáhtjer	n	
skáhčir	skáhtjer	n	
čealčir	tjielttjer	n	
skážir	skátjer	n	
rocker	råcker	n	
báhkir	báhker	n	
lohkir	låhker	n	
lohkkir	låhkker	n	
feaskkir	fiesker	n	
svisker	svissker	n	
fáskir	fássker	n	
ávskkir	ávsker	n	
fáskkir	fásker	n	
váskkir	vásker	n	
wobbler	wåbbler	n	
trailer	trajler	n	
geallir	gieller	n	
keallir	kieller	n	
kullir	kuller	n	
goapmir	goabmer	n	
hoapmir	hoabmer	n	
ápmir	ábmer	n	
opmir	åbmer	n	
hopmir	håbmer	n	
sopmir	såbmer	n	
šimir	sjimer	n	
šlimir	slimer	n	
nummir	nummer	n	
gámmir	gámmer	n	
kámmir	kámmer	n	
romer	råmer	n	
designer	desegner	n	
stáinnir	stájner	n	
soinnir	såjner	n	
kontainer	kånttåjner	n	
gahpir	gahper	n	
foahpir	foahper	n	
goahpir	goahper	n	
eappir	iepper	n	
top^scorer	tåp^scårer	n	
geaissir	giejser	n	
keaissir	kiejser	n	
viissir	vijser	n	
vissir	visser	n	
gazir	gatser	n	
bihcir	bihtser	n	
gaccir	gattser	n	
busir	buser	n	
teahter	tiehter	n	
gilomehter	gilumehter	n	
baromehter	barumehter	n	
gáhtir	gáhter	n	
ohter	åhter	n	
skohter	skåhter	n	
meašttir	miesjter	n	
helikopter	helekopter	n	
register	regester	n	
measttir	miester	n	
minister	minester	n	
master	masster	n	
jester	jesster	n	
sester	sesster	n	
klyster	klysster	n	
kloster	klåsster	n	
desilihtter	deselihtter	n	
charter	chartter	n	
doavttir	doavter	n	
boalvvir	boalver	n	
revolver	revulver	n	
ávvir	ávver	n	
dávvir	dávver	n	
suoŋir	suoŋer	n	
šaŋŋer	sjaŋŋer	n	
gaigŋir	gajŋŋer	n	
šáŋŋer	sjáŋŋer	n	
professor	professor	n	
prosessor	prosessor	n	
kalkulator	kalkulator	n	
konservator	konservator	n	
administrahtor	administrahtor	n	
indikáhtor	indikáhtor	n	
predikáhtor	predikáhtor	n	
modifikáhtor	modefikáhtor	n	
kvantifikáhtor	kvantifikáhtor	n	
kompiláhtor	kompiláhtor	n	
kalkuláhtor	kalkuláhtor	n	
estimáhtor	estimáhtor	n	
transformáhtor	transformáhtor	n	
sub^ordináhtor	sub^ordenáhtor	n	
ko^ordináhtor	ko^orddenáhtor	n	
aktuáhtor	aktoáhtor	n	
operáhtor	operáhtor	n	
kondensáhtor	kondensáhtor	n	
fokusáhtor	fokusáhtor	n	
analysáhtor	análysáhtor	n	
katalysáhtor	katálysáhtor	n	
agitáhtor	agitáhtor	n	
konserváhtor	konserváhtor	n	
projektor	projektor	n	
prorektor	prorektor	n	
sosiálsektor	sosiálsektor	n	
transistor	transistor	n	
investor	investor	n	
predator	predátor	n	
leibor	lejbbur	n	
skuibor	skujbbur	n	
válbor	válbbur	n	
šlámbor	slámbbur	n	
burbor	burbbur	n	
nábor	nábur	n	
endor	enddur	n	
dándor	dánddur	n	
jándor	jánddur	n	
bondur	bånddur	n	
snuđđor	snuddur	n	
veđor	vedur	n	
liđor	lidur	n	
linddor	lindur	n	
málgor	málggur	n	
gudjor	gudjur	n	
guččor	guttjur	n	
guovžur	guovttjur	n	
goččor	gåttjur	n	
ávjjur	ávjur	n	
májor	májur	n	
sihkor	sihkur	n	
sekkor	sekkur	n	
gáhkkor	gáhkkur	n	
gilkor	gilkkur	n	
bulkor	bulkkur	n	
sálkor	sálkkur	n	
bevkor	bevkkur	n	
bovkor	båvkkur	n	
juŋkor	juŋkkur	n	
áŋkor	áŋkkur	n	
boŋkor	båŋkkur	n	
bulkkur	bulkur	n	
ba^chelor	ba^chelur	n	
jallor	jallur	n	
márbmor	mármmur	n	
lummor	lummur	n	
humor	humur	n	
bihppor	bihppur	n	
burpur	burppur	n	
purpur	purppur	n	
terror	terrur	n	
gisor	gisur	n	
gissor	gissur	n	
sensor	senssur	n	
sponsor	spånssur	n	
gássor	gássur	n	
gásor	gásur	n	
stahtor	stahtur	n	
dihtor	dihtur	n	
lihtor	lihtur	n	
muhtor	muhtur	n	
šlohtor	slåhtur	n	
mohtor	måhtur	n	
rohtor	råhtur	n	
beštor	bessjtur	n	
traktor	traktur	n	
lektor	lektur	n	
rektor	rektur	n	
sektor	sektur	n	
vektor	vektur	n	
áktor	áktur	n	
re^áktor	re^áktur	n	
fáktor	fáktur	n	
láktor	láktur	n	
tráktor	tráktur	n	
konttor	kåntur	n	
dekstor	dekstur	n	
huitor	hujttur	n	
gántor	gánttur	n	
kántor	kánttur	n	
lántor	lánttur	n	
gontor	gånttur	n	
kontor	kånttur	n	
gottur	gåttur	n	
viivvur	vijvur	n	
libar	libár	n	
duolbbár	duolbár	n	
gubar	gubár	n	
dáidár	dájddár	n	
suvdár	suvddár	n	
skreaddár	skræddár	n	
tetra^edar	tetra^edár	n	
heksa^edar	heksa^edár	n	
okta^edar	åktå^edár	n	
hoaiddár	hoajdár	n	
dáiddár	dájdár	n	
finddár	findár	n	
kunddár	kundár	n	
bivddár	bivdár	n	
suvddár	suvdár	n	
eavddár	ævdár	n	
báđar	bádár	n	
čagar	tjagár	n	
boargár	boarggár	n	
márgár	márggár	n	
sáŋgár	sáŋggár	n	
sniiggár	snijgár	n	
snuolggár	snuolgár	n	
nealggár	nælgár	n	
sáŋggár	sáŋgár	n	
speadjár	spædjár	n	
skeijár	skejjár	n	
duljár	duljjár	n	
tuljár	tuljjár	n	
smirjár	smirjjár	n	
buijár	bujjár	n	
dikšár	diksjár	n	
divššár	divsjár	n	
čiekčár	tjiektjár	n	
guččár	guttjár	n	
apotehkár	apotehkár	n	
politihkár	politihkár	n	
giikkár	gijkár	n	
kiikkár	kijkár	n	
sniikkár	snijkár	n	
spiikkár	spijkár	n	
buikkár	bujkár	n	
čoahkkár	tjoahkkár	n	
komihkkár	komihkkár	n	
teknihkkár	teknihkkár	n	
klassihkkár	klassehkkár	n	
musihkkár	musehkkár	n	
fysihkkár	fysehkkár	n	
mekanihkkár	mekánihkkár	n	
historihkkár	hissturihkkár	n	
politihkkár	påletihkkár	n	
veahkkár	væhkkár	n	
gaikár	gajkkár	n	
buikár	bujkkár	n	
bilkár	bilkkár	n	
skeaŋkár	skæŋkkár	n	
bilkkár	bilkár	n	
iskkár	iskár	n	
fiskár	fisskár	n	
buoskár	buosskár	n	
ávskár	ávsskár	n	
hávskár	hávsskár	n	
báskár	básskár	n	
livkkár	livkár	n	
spivkkár	spivkár	n	
duvhllár	duvhlár	n	
guvhllár	guvhlár	n	
silar	silár	n	
hávlár	hávllár	n	
keallár	kællár	n	
guvllár	guvlár	n	
dálar	dálár	n	
gamar	gamár	n	
duopmár	duobmár	n	
šimar	sjimár	n	
doaimmár	doajmár	n	
gulbmár	gulmmár	n	
fidnár	fiddnár	n	
reainnár	ræjnár	n	
stáidnár	stájnnár	n	
reaidnár	ræjnnár	n	
hánar	hánár	n	
giippár	gijpár	n	
kiippár	kijpár	n	
šliippár	slijpár	n	
prográmmerár	prågråmmerár	n	
stivrrár	stivrár	n	
kliissár	klijsár	n	
viissár	vijsár	n	
dálssár	dálsár	n	
viisár	vijssár	n	
geaisár	gæjssár	n	
keaisár	kæjssár	n	
meassár	mæssár	n	
vizar	vitsár	n	
duvssár	duvsár	n	
biihtár	bijhtár	n	
meaštár	mæssjtár	n	
láittár	lájtár	n	
áltár	álltár	n	
reportár	repurtár	n	
reantár	rænttár	n	
skievttár	skievtár	n	
rivttár	rivtár	n	
skuvttár	skuvtár	n	
neavttár	nævtár	n	
duolvvár	duolvár	n	
revolvár	revulvár	n	
várvvár	várvár	n	
veivár	vejvvár	n	
geastegiivvár	giesstegijvvár	n	
boalvár	boalvvár	n	
eavvár	ævvár	n	
jobbár	jåbbår	n	
šombbár	sjåmbår	n	
goidár	gåjddår	n	
mordár	mårddår	n	
morddár	mårdår	n	
koffar	kåffår	n	
borgár	bårggår	n	
goččár	gåttjår	n	
rockár	råckår	n	
sohkar	såhkår	n	
dollar	dållår	n	
dollár	dållår	n	
golár	gålår	n	
šolár	sjålår	n	
trolar	trålår	n	
trolár	trålår	n	
soidnár	såjnnår	n	
lovpár	låvppår	n	
lovppár	låvpår	n	
bolsttar	bålsttår	n	
roho-bolsttar	råho-bålsttår	n	
moivvár	måjvår	n	
messi^as	messe^as	n	
heaibbas	hiejbas	n	
váibbas	vájbas	n	
albbas	albas	n	
leabbadas	liebbadas	n	
duolbadas	duolbbadas	n	
njárbadas	njárbbadas	n	
njárbbadas	njárbadas	n	
seagadas	siegadas	n	
jalgadas	jalggadas	n	
vielgadas	vielggadas	n	
gurgadas	gurggadas	n	
gárgadas	gárggadas	n	
čuovgadas	tjuovggadas	n	
ruvgadas	ruvggadas	n	
ávgadas	ávggadas	n	
lávgadas	lávggadas	n	
vielggadas	vielgadas	n	
starggadas	stargadas	n	
čuovggadas	tjuovgadas	n	
seavdnjadas	sievnnjadas	n	
ruškadas	russjkadas	n	
čoaskkadas	tjoaskadas	n	
njuoskkadas	njuoskadas	n	
fiskadas	fisskadas	n	
jávkkadas	jávkadas	n	
skáimmadas	skájmadas	n	
goalmmadas	goalmadas	n	
miljovnnadas	miljjuvnadas	n	
čáhpadas	tjáhpadas	n	
čáhppadas	tjáhppadas	n	
gearradas	gierradas	n	
veahtadas	viehtadas	n	
gásttadas	gástadas	n	
sievttadas	sievtadas	n	
lávttadas	lávtadas	n	
dálvadas	dálvvadas	n	
čihččedas	tjihttjedas	n	
vuoiddas	vuojdas	n	
alddas	aldas	n	
bajildas	bajeldas	n	
siskkildas	siskeldas	n	
vuolildas	vuoleldas	n	
olgguldas	ålguldas	n	
urddas	urdas	n	
dugordas	dugurdas	n	
čohkodas	tjåhkudas	n	
nanodas	nanudas	n	
gottodas	gåttudas	n	
vavddas	vavdas	n	
njabadas	njabádas	n	
goađádas	goadádas	n	
viđadas	vidádas	n	
viđádas	vidádas	n	
čuođádas	tjuodádas	n	
guđadas	gudádas	n	
guđádas	gudádas	n	
deavddádas	dævdádas	n	
bagadas	bagádas	n	
seagádas	sægádas	n	
njealjádas	njæljjádas	n	
baskkádas	baskádas	n	
goalmmádas	goalmádas	n	
nanadas	nanádas	n	
uradas	urádas	n	
čáradas	tjárádas	n	
gávccádas	gávttsádas	n	
jorbadas	jårbbådas	n	
jođadas	jådådas	n	
logádas	lågådas	n	
skoađas	skådas	n	
lossadas	låssådas	n	
ovccádas	åvttsådas	n	
govadas	gåvådas	n	
ávdagas	ávddagas	n	
gealdagas	gielldagas	n	
gieldagas	gielldagas	n	
bulddagas	buldagas	n	
álddagas	áldagas	n	
ruovddagas	ruovdagas	n	
seahčagas	siehtjagas	n	
čásmagas	tjássmagas	n	
čatnagas	tjadnagas	n	
gárdnagas	gárnnagas	n	
álttagas	áltagas	n	
reagas	riegas	n	
veaiggas	viejgas	n	
dáiggas	dájgas	n	
šáiggas	sjájgas	n	
skáiggas	skájgas	n	
spáiggas	spájgas	n	
váiggas	vájgas	n	
mielggas	mielgas	n	
garggas	gargas	n	
sparggas	spargas	n	
bierggas	biergas	n	
čearggas	tjiergas	n	
smierggas	smiergas	n	
šnjirggas	sjnjirgas	n	
cirggas	tsirgas	n	
njurggas	njurgas	n	
bárggas	bárgas	n	
ávdugas	ávddugas	n	
buldugas	bulldugas	n	
bulddogas	buldugas	n	
bulddugas	buldugas	n	
gonogas	gånugas	n	
šnjivggas	sjnjivgas	n	
šlivggas	slivgas	n	
čuovggas	tjuovgas	n	
ruovggas	ruovgas	n	
šuvggas	sjuvgas	n	
gávggas	gávgas	n	
njávggas	njávgas	n	
skiŋggas	skiŋgas	n	
máŋggas	máŋgas	n	
gonagas	gånågas	n	
boragas	bårågas	n	
oktagas	åktågas	n	
gieđahas	giedahas	n	
rievddahas	rievdahas	n	
spaiggahas	spajgahas	n	
vuolggahas	vuolgahas	n	
čuogahas	tjuogahas	n	
njárggahas	njárgahas	n	
ruvggahas	ruvgahas	n	
skoavhllahas	skoavhlahas	n	
skuvllahas	skuvlahas	n	
biepmahas	biebmahas	n	
čuohpahas	tjuohpahas	n	
fearahas	fierahas	n	
jurssahas	jursahas	n	
njiehcahas	njiehtsahas	n	
heasttahas	hiestahas	n	
risttahas	ristahas	n	
goađehas	goadehas	n	
meađđehas	mieddehas	n	
meađehas	miedehas	n	
vuovddehas	vuovdehas	n	
virgehas	virggehas	n	
njealjehas	njieljjehas	n	
áššehas	ássjehas	n	
geažehas	gietjehas	n	
njiččehas	njittjehas	n	
cahkkehas	tsahkkehas	n	
sokkehas	såkkehas	n	
nanihas	nanehas	n	
njiehcehas	njiehtsehas	n	
meahcehas	miehtsehas	n	
gávttehas	gávtehas	n	
stobuhas	ståbuhas	n	
ráiddohas	rájduhas	n	
segohas	seguhas	n	
bigohas	biguhas	n	
hilggohas	hilguhas	n	
ogohas	åguhas	n	
šiljohas	sjiljjuhas	n	
boaššohas	boassjuhas	n	
divššohas	divsjuhas	n	
oaččohas	oattjuhas	n	
rikkohas	rikkuhas	n	
čulkkohas	tjulkuhas	n	
biellohas	bielluhas	n	
suolohas	suoluhas	n	
čoamohas	tjoamuhas	n	
biepmohas	biebmuhas	n	
čoanohas	tjoanuhas	n	
lonohas	lånuhas	n	
lonuhas	lånuhas	n	
goasohas	goasuhas	n	
evttohas	evtuhas	n	
eavttohas	ievtuhas	n	
ruvttohas	ruvtuhas	n	
avohas	avuhas	n	
cábahas	tsábáhas	n	
silddáhas	sildáhas	n	
čuolddáhas	tjuoldáhas	n	
guđahas	gudáhas	n	
bivddáhas	bivdáhas	n	
vajahas	vajáhas	n	
bijahas	bijáhas	n	
spanjahas	spanjáhas	n	
čoakkáhas	tjoakkáhas	n	
bázahas	bátsáhas	n	
seasttáhas	sæstáhas	n	
sobahas	såbåhas	n	
govddahas	gåvdåhas	n	
jođahas	jådåhas	n	
njođahas	njådåhas	n	
dolahas	dålåhas	n	
borahas	båråhas	n	
čorahas	tjåråhas	n	
čuopmajas	tjuobmajas	n	
gávpejas	gávppejas	n	
bealjas	bieljjas	n	
giljas	giljjas	n	
šlienjas	slienjas	n	
bearjjas	bierjas	n	
álbbažas	álbatjas	n	
vuoražas	vuoratjas	n	
riežas	rietjas	n	
gáhčas	gáhtjas	n	
skáhčas	skáhtjas	n	
bulččas	bultjas	n	
speaččas	spiettjas	n	
bávččas	bávtjas	n	
šloahkas	sloahkas	n	
coahkas	tsoahkas	n	
šuohkas	sjuohkas	n	
fuoikkas	fuojkas	n	
luoikkas	luojkas	n	
aškkas	asjkas	n	
loaškkas	loasjkas	n	
roaškkas	roasjkas	n	
beaškkas	biesjkas	n	
deaškkas	diesjkas	n	
gieškkas	giesjkas	n	
lieškkas	liesjkas	n	
reaškkas	riesjkas	n	
biškkas	bisjkas	n	
diškkas	disjkas	n	
fiškkas	fisjkas	n	
riškkas	risjkas	n	
ruoškkas	ruosjkas	n	
fáškkas	fásjkas	n	
huikkas	hujkas	n	
háikkas	hájkas	n	
šáikkas	sjájkas	n	
spáikkas	spájkas	n	
šikkas	sjikkas	n	
šuokkas	sjuokkas	n	
čuokkas	tjuokkas	n	
jalkkas	jalkas	n	
goalkkas	goalkas	n	
čoalkkas	tjoalkas	n	
skoalkkas	skoalkas	n	
gilkkas	gilkas	n	
skilkkas	skilkas	n	
julkkas	julkas	n	
dálkkas	dálkas	n	
sparkkas	sparkas	n	
skurkkas	skurkas	n	
snurkkas	snurkas	n	
gaskkas	gaskas	n	
njaskkas	njaskas	n	
časkkas	tjaskas	n	
mielkkaskas	mielkaskas	n	
seamaskas	siemaskas	n	
buoskkas	buoskas	n	
roavskas	roavsskas	n	
cuskkas	tsuskas	n	
roavskkas	roavskas	n	
fáskkas	fáskas	n	
skoavkkas	skoavkas	n	
stoavkkas	stoavkas	n	
ravkkas	ravkas	n	
savkkas	savkas	n	
beavkkas	bievkas	n	
livkkas	livkas	n	
civkkas	tsivkas	n	
cuvkkas	tsuvkas	n	
bávkkas	bávkas	n	
šloaŋkkas	sloaŋkas	n	
hiŋkkas	hiŋkas	n	
ruŋkkas	ruŋkas	n	
ráidalas	rájddalas	n	
veaiddalas	viejdalas	n	
seahkalas	siehkalas	n	
čihkalas	tjihkalas	n	
stearkalas	stierkkalas	n	
reastalas	riesstalas	n	
riestalas	riesstalas	n	
áitalas	ájttalas	n	
čiekŋalas	tjiegŋalas	n	
váhkolas	váhkulas	n	
guovllas	guovlas	n	
boaldálas	boalldálas	n	
seahkálas	sæhkálas	n	
ceahkkálas	tsæhkkálas	n	
gáskálas	gásskálas	n	
bupmálas	bubmálas	n	
jorbálas	jårbbålas	n	
čoalas	tjålas	n	
gohpalas	gåhpålas	n	
skohpalas	skåhpålas	n	
čuožžamas	tjuodtjamas	n	
čiktamas	tjiktamas	n	
čuožžemas	tjuodtjemas	n	
beallemas	biellemas	n	
čaimmas	tjajmas	n	
buoimmas	buojmas	n	
luoimmas	luojmas	n	
rušmmas	rusjmas	n	
gulddalmas	guldalmas	n	
rievddalmas	rievdalmas	n	
galmmas	galmas	n	
čalmmas	tjalmas	n	
čoakkalmas	tjoakkalmas	n	
buozalmas	buotsalmas	n	
šattalmas	sjattalmas	n	
guolmmas	guolmas	n	
šattolmas	sjattulmas	n	
álmmas	álmas	n	
gažalmas	gatjálmas	n	
čájálmas	tjájálmas	n	
čoakkálmas	tjoakkálmas	n	
manalmas	manálmas	n	
jođálmas	jådålmas	n	
joralmas	jårålmas	n	
čuomas	tjuomas	n	
čuorpmas	tjuormas	n	
suorpmas	suormas	n	
guosmmas	guosmas	n	
guoggomas	guoggumas	n	
čuožžomas	tjuodtjumas	n	
eaidanas	iejddanas	n	
áidanas	ájddanas	n	
vuoiddanas	vuojdanas	n	
mulgganas	mulganas	n	
čeargganas	tjierganas	n	
leađgganas	lierganas	n	
šleađgganas	slierganas	n	
cirgganas	tsirganas	n	
njurgganas	njurganas	n	
bárgganas	bárganas	n	
šloavgganas	sloavganas	n	
reavgganas	rievganas	n	
njávgganas	njávganas	n	
veajanas	viejanas	n	
giljanas	giljjanas	n	
čuojanas	tjuojanas	n	
njivžžanas	njivtjanas	n	
šuohkanas	sjuohkanas	n	
goaikkanas	goajkanas	n	
biškkanas	bisjkanas	n	
diškkanas	disjkanas	n	
riškkanas	risjkanas	n	
huikkanas	hujkanas	n	
šikkanas	sjikkanas	n	
goalkkanas	goalkanas	n	
skoalkkanas	skoalkanas	n	
gilkkanas	gilkanas	n	
skilkkanas	skilkanas	n	
julkkanas	julkanas	n	
faskkanas	faskanas	n	
cuskkanas	tsuskanas	n	
skoavkkanas	skoavkanas	n	
bávkkanas	bávkanas	n	
luoimmanas	luojmanas	n	
sainnanas	sajnanas	n	
vuovssanas	vuovsanas	n	
measttanas	miestanas	n	
suoivvanas	suojvanas	n	
vuoiŋŋanas	vuojŋanas	n	
láinnas	lájnas	n	
máinnas	májnas	n	
balddonas	baldunas	n	
njulggonas	njulgunas	n	
njurggonas	njurgunas	n	
čujonas	tjujunas	n	
njalonas	njalunas	n	
rievnnas	rievnas	n	
ávnnas	ávnas	n	
rufanas	rufánas	n	
njiganas	njigánas	n	
bižanas	bitjánas	n	
stužanas	stutjánas	n	
ájanas	ájánas	n	
gájanas	gájánas	n	
čájánas	tjájánas	n	
skájanas	skájánas	n	
skilanas	skilánas	n	
njimanas	njimánas	n	
gáranas	gáránas	n	
rokkanas	råkkånas	n	
dohranas	dåhrånas	n	
boranas	bårånas	n	
bosanas	båsånas	n	
gosanas	gåsånas	n	
čiehpas	tjiehpas	n	
fáippas	fájpas	n	
váippas	vájpas	n	
gurppas	gurpas	n	
ráidaras	rájddaras	n	
njaŋgaras	njaŋggaras	n	
njáŋgaras	njáŋggaras	n	
šláŋgaras	sláŋggaras	n	
stáiparas	stájpparas	n	
vuobiras	vuoberas	n	
čieras	tjieras	n	
čahras	tjahras	n	
cihras	tsihras	n	
áirras	ájrras	n	
duhkoras	duhkuras	n	
čehporas	tjehpuras	n	
čuomáras	tjuomáras	n	
duntáras	dunttáras	n	
goigáras	gåjggåras	n	
láppezas	láppetsas	n	
smirezas	smiretsas	n	
ruohcas	ruohtsas	n	
stirccas	stirtsas	n	
suvccas	suvttsas	n	
cuvccas	tsuvttsas	n	
lihpázas	lihpátsas	n	
lippázas	lippátsas	n	
urttas	urtas	n	
časttas	tjastas	n	
goaistas	goajsstas	n	
sievttas	sievtas	n	
bivttas	bivtas	n	
lávttas	lávtas	n	
geavas	gievas	n	
seaivvas	siejvas	n	
vuoivvas	vuojvas	n	
buozalvas	buotsalvas	n	
jiervvas	jiervas	n	
čuorvvas	tjuorvas	n	
vuoi-čuorvvas	vuoj-tjuorvas	n	
duokŋas	duogŋas	n	
aids	ajds	n	
seaibbis	siejbes	n	
holbbis	hålbes	n	
vuobis	vuobes	n	
oarbbis	oarbes	n	
gárbbis	gárbes	n	
stábis	stábes	n	
njađis	njades	n	
soađis	soades	n	
čendis	tjenddes	n	
áiddis	ájdes	n	
álddis	áldes	n	
bálddis	báldes	n	
málddis	máldes	n	
vánddis	vándes	n	
čuođis	tjuodes	n	
urddis	urdes	n	
buđis	budes	n	
goavddis	goavdes	n	
luovddis	luovdes	n	
goagis	goages	n	
jiegis	jieges	n	
bálges	bálgges	n	
solgis	sålgges	n	
bálggis	bálges	n	
fálggis	fálges	n	
njálggis	njálges	n	
čarggis	tjarges	n	
čierggis	tjierges	n	
njuorggis	njuorges	n	
suorggis	suorges	n	
sárggis	sárges	n	
jorggis	jårges	n	
givggis	givges	n	
bealjis	bieljjes	n	
ánjis	ánjes	n	
bonjis	bånjes	n	
girjjis	girjes	n	
vuorččis	vuortjes	n	
morččis	mårtjes	n	
bužis	butjes	n	
čoavččis	tjoavtjes	n	
jiehkis	jiehkes	n	
ceahkes	tsiehkes	n	
ceahkis	tsiehkes	n	
goikkis	gåjkes	n	
deaččalakkis	diettjalakkes	n	
čáhkalakkis	tjáhkalakkes	n	
bulljarakkis	bulljarakkes	n	
gávdnjarakkis	gávnnjarakkes	n	
gaidnarakkis	gajnnarakkes	n	
buncarakkis	bunttsarakkes	n	
sakkis	sakkes	n	
giekkis	giekkes	n	
riekkis	riekkes	n	
rock-riekkis	råck-riekkes	n	
seakkis	siekkes	n	
siekkis	siekkes	n	
rikkis	rikkes	n	
čuokkis	tjuokkes	n	
cáhcu-čuokkis	tsáhtso-tjuokkes	n	
ákkis	ákkes	n	
gákkis	gákkes	n	
čielkkis	tjielkes	n	
časkkis	tjaskes	n	
niskkis	niskes	n	
gáskkis	gáskes	n	
lávkkis	lávkes	n	
oalis	oales	n	
syfilis	syfeles	n	
bealis	bieles	n	
gielis	gieles	n	
gallis	galles	n	
amaryllis	amárylles	n	
gállis	gálles	n	
čeavllis	tjievles	n	
návllis	návles	n	
fális	fáles	n	
mális	máles	n	
boles	båles	n	
golis	gåles	n	
poles	påles	n	
gimis	gimes	n	
čuoimmis	tjuojmes	n	
fielmmis	fielmes	n	
vielmmis	vielmes	n	
vuosmmis	vuosmes	n	
gátnis	gádnes	n	
geanis	gienes	n	
dáinnis	dájnes	n	
tennis	tennes	n	
vuortnis	vuornes	n	
bortnis	bårnes	n	
njunis	njunes	n	
bánis	bánes	n	
gánis	gánes	n	
lonis	lånes	n	
lahpis	lahpes	n	
oahpis	oahpes	n	
geahpis	giehpes	n	
buohpis	buohpes	n	
tuohpis	tuohpes	n	
ráhpis	ráhpes	n	
vielppis	vielpes	n	
láppis	láppes	n	
doppis	dåppes	n	
jaspis	jasspes	n	
doaris	doares	n	
varis	vares	n	
dearis	dieres	n	
varris	varres	n	
gáirris	gájrres	n	
čeavrris	tjievres	n	
hávrris	hávres	n	
salaris	saláres	n	
gasis	gases	n	
geasis	gieses	n	
praksis	prakses	n	
skepsis	skepses	n	
lássis	lásses	n	
oazis	oatses	n	
fanccis	fantses	n	
vuonccis	vuontses	n	
bovccis	båvttses	n	
vievssis	vievses	n	
ávssis	ávses	n	
x-ávssis	x-ávses	n	
y-ávssis	y-ávses	n	
lásis	láses	n	
riehtis	riehtes	n	
ráhtis	ráhtes	n	
basttes	bastes	n	
rásttis	rástes	n	
moattis	moattes	n	
guovttis	guovtes	n	
goaivvis	goajves	n	
beaivvis	biejves	n	
sarvvis	sarves	n	
alŋŋis	alŋes	n	
jalŋŋis	jalŋes	n	
beađŋŋis	bierŋes	n	
geavŋŋis	gievŋŋes	n	
suovŋŋis	suovŋŋes	n	
timotemos	timutemos	n	
gáhtegismmos	gáhtegismos	n	
káhtekismmos	káhtekismos	n	
bohtehtos	båhtehtos	n	
pohtehtos	påhtehtos	n	
botehtos	båtehtos	n	
vuobirs	vuobers	n	
jazz	jadts	n	
radi^us	rade^us	n	
justiti^ari^us	jusstete^are^us	n	
justitiári^us	jusstetiáre^us	n	
duolbbus	duolbus	n	
cábus	tsábus	n	
globus	glåbus	n	
sobus	såbus	n	
soabahus	såbadus	n	
rievdadus	rievddadus	n	
vuoiddadus	vuojdadus	n	
hálddahus	háldadus	n	
válddahus	váldadus	n	
gurgadus	gurggadus	n	
čielggadus	tjielgadus	n	
njuolggadus	njuolgadus	n	
vuolggahus	vuolgadus	n	
álggahus	álgadus	n	
barggahus	bargadus	n	
duljahus	duljjadus	n	
lihkahus	lihkadus	n	
šuohkahus	sjuohkadus	n	
vikkahus	vikkadus	n	
mearkkahus	mierkadus	n	
guoskkahus	guoskadus	n	
njuoskkadus	njuoskadus	n	
vealahus	vieladus	n	
fuolahus	fuoladus	n	
doaimmahus	doajmadus	n	
soaimmadus	soajmadus	n	
nađus	nadus	n	
gávnnahus	gávnadus	n	
boađus	boadus	n	
oahpahus	oahpadus	n	
loahpahus	loahpadus	n	
čuohpadus	tjuohpadus	n	
čuohpahus	tjuohpadus	n	
suohpahus	suohpadus	n	
giessahus	giessadus	n	
čuozahus	tjuotsadus	n	
šiehtadus	sjiehtadus	n	
eastadus	iesstadus	n	
buvttadus	buvtadus	n	
geavahus	gievadus	n	
heavahus	hievadus	n	
oaivvadus	oajvadus	n	
oaivadus	oajvvadus	n	
arvadus	arvvadus	n	
vuoiŋŋadus	vuojŋadus	n	
hálbbidus	hálbedus	n	
jeđđehus	jeddedus	n	
ovdehus	åvddedus	n	
bovdehus	båvddedus	n	
ráđđehus	ráddedus	n	
sáddehus	sáddedus	n	
ovddidus	åvdedus	n	
cuigehus	tsujggedus	n	
čilgehus	tjilggedus	n	
gárgedus	gárggedus	n	
čuvgehus	tjuvggedus	n	
lieđus	liedus	n	
ráddjehus	ráddjedus	n	
hárjehus	hárjjedus	n	
gavjehus	gavjjedus	n	
gáržžidus	gártjedus	n	
cahkkehus	tsahkkedus	n	
dohkkehus	dåhkkedus	n	
čohkkehus	tjåhkkedus	n	
bávkkehus	bávkedus	n	
alidus	aledus	n	
gallehus	galledus	n	
fillehus	filledus	n	
hállehus	hálledus	n	
vuolidus	vuoledus	n	
hálidus	háledus	n	
dubmehus	dubbmedus	n	
gummehus	gummedus	n	
geahpedus	giehpedus	n	
erehus	eredus	n	
sirrehus	sirredus	n	
járrehus	járredus	n	
várrehus	várredus	n	
járehus	járedus	n	
huksehus	huksedus	n	
vásihus	vásedus	n	
fáhtehus	fáhtedus	n	
hehttehus	hehttedus	n	
rentehus	renttedus	n	
prentehus	prenttedus	n	
guottihus	guottedus	n	
heivehus	hejvvedus	n	
suivehus	sujvvedus	n	
rávvehus	rávvedus	n	
govvidus	gåvvedus	n	
ráŋihus	ráŋedus	n	
iđus	idus	n	
biđus	bidus	n	
dovddiidus	dåvdijdus	n	
golggiidus	gålgijdus	n	
čohkiidus	tjåhkijdus	n	
háliidus	hálijdus	n	
moriidus	mårijdus	n	
viiddus	vijdus	n	
balddus	baldus	n	
gielddus	gieldus	n	
mielddus	mieldus	n	
bajildus	bajeldus	n	
čuolddus	tjuoldus	n	
buđaldus	budáldus	n	
siskkáldus	siskáldus	n	
buođus	buodus	n	
duođus	duodus	n	
vuođus	vuodus	n	
gierddus	gierdus	n	
vearddus	vierdus	n	
jurddus	jurdus	n	
ipmárdus	ibmárdus	n	
vuođđudus	vuoddudus	n	
gáđohus	gádudus	n	
seaguhus	siegudus	n	
segohus	segudus	n	
cuiggodus	tsujgudus	n	
oalgguhus	oalgudus	n	
juđus	judus	n	
njuđus	njudus	n	
vašuhus	vasjudus	n	
čuoččuhus	tjuottjudus	n	
ávžžuhus	ávtjudus	n	
čujuhus	tjujudus	n	
váikkuhus	vájkudus	n	
beakkohus	biekkudus	n	
roahkkohus	roahkkudus	n	
mirkkohus	mirkudus	n	
dárkkuhus	dárkudus	n	
fápmudus	fábmudus	n	
almmuhus	almudus	n	
čoanohus	tjoanudus	n	
meannudus	miennudus	n	
lonuhus	lånudus	n	
garuhus	garudus	n	
erohus	erudus	n	
earuhus	ierudus	n	
vearuhus	vierudus	n	
gievrudus	gievrrudus	n	
váruhus	várudus	n	
muittuhus	mujtudus	n	
deattuhus	diettudus	n	
evttohus	evtudus	n	
eavttuhus	ievtudus	n	
divodus	divudus	n	
čoavddus	tjoavdus	n	
bivddus	bivdus	n	
duvddus	duvdus	n	
njuvddus	njuvdus	n	
suvddus	suvdus	n	
gáibádus	gájbbádus	n	
vuorbádus	vuorbbádus	n	
hálbbádus	hálbádus	n	
goađádus	goadádus	n	
veardádus	værddádus	n	
hávdádus	hávddádus	n	
meaddádus	mæddádus	n	
dieđáhus	diedádus	n	
mieđáhus	miedádus	n	
balddáhus	baldádus	n	
hálddáhus	háldádus	n	
bagadus	bagádus	n	
sagahus	sagádus	n	
gárgádus	gárggádus	n	
suorggádus	suorgádus	n	
jugahus	jugádus	n	
vihahus	vihádus	n	
dajahus	dajádus	n	
čádjádus	tjádjádus	n	
gearjádus	gærjjádus	n	
spažáhus	spatjádus	n	
iežáhus	ietjádus	n	
gáržžádus	gártjádus	n	
ájáhus	ájádus	n	
čájáhus	tjájádus	n	
čoahkádus	tjoahkádus	n	
čoakkádus	tjoakkádus	n	
čoakkáhus	tjoakkádus	n	
čoahkkádus	tjoahkkádus	n	
bilkádus	bilkkádus	n	
gulahus	guládus	n	
ealáhus	æládus	n	
jamáhus	jamádus	n	
namahus	namádus	n	
manahus	manádus	n	
oainnáhus	oajnádus	n	
sivdnádus	sivnnádus	n	
suohpáhus	suohpádus	n	
dáhpáhus	dáhpádus	n	
háhpáhus	háhpádus	n	
eahpádus	æhpádus	n	
geahpádus	gæhpádus	n	
mearrádus	mærrádus	n	
earáhus	ærádus	n	
lasáhus	lasádus	n	
muosáhus	muosádus	n	
bázahus	bátsádus	n	
bázáhus	bátsádus	n	
bio^bázahus	bio^bátsádus	n	
givssádus	givsádus	n	
ásahus	ásádus	n	
vásahus	vásádus	n	
vásáhus	vásádus	n	
heahtádus	hæhtádus	n	
goasttádus	goastádus	n	
fástádus	fásstádus	n	
vástádus	vásstádus	n	
meattáhus	mættádus	n	
váivvádus	vájvádus	n	
oaivádus	oajvvádus	n	
árvádus	árvvádus	n	
goakŋádus	goagŋádus	n	
bođus	bådus	n	
lobádus	låbådus	n	
ovddádus	åvdådus	n	
gođus	gådus	n	
golggahus	gålgådus	n	
sojahus	såjådus	n	
hohkahus	håhkådus	n	
rohkadus	råhkådus	n	
olahus	ålådus	n	
golahus	gålådus	n	
modus	mådus	n	
gomáhus	gåmådus	n	
lohpádus	låhpådus	n	
joráhus	jårådus	n	
gozáhus	gåtsådus	n	
losádus	låsådus	n	
lovttahus	låvtådus	n	
govvadus	gåvvådus	n	
govvádus	gåvvådus	n	
seagus	siegus	n	
aspárggus	asspárggus	n	
ávgos	ávggus	n	
laiggus	lajgus	n	
guoiggus	guojgus	n	
juoiggus	juojgus	n	
čuoiggus	tjuojgus	n	
čielggus	tjielgus	n	
njuolggus	njuolgus	n	
bálggus	bálgus	n	
njálggus	njálgus	n	
golggus	gålgus	n	
čuogus	tjuogus	n	
suorggus	suorgus	n	
sárggus	sárgus	n	
doavggus	doavgus	n	
ávggos	ávgus	n	
máŋggus	máŋgus	n	
čogus	tjågus	n	
logus	lågus	n	
valjus	valjjus	n	
bealjus	bieljjus	n	
čuojus	tjuojus	n	
vuoššus	vuossjus	n	
geažus	gietjus	n	
gohčus	gåhtjus	n	
bižus	bitjus	n	
spižus	spitjus	n	
vuožus	vuotjus	n	
bážus	bátjus	n	
vážus	vátjus	n	
čájus	tjájus	n	
ruhkos	ruhkus	n	
rohkos	råhkus	n	
cakkus	tsakkus	n	
ceakkus	tsiekkus	n	
sirkus	sirkkus	n	
botkkus	båtkkus	n	
cealkkus	tsielkus	n	
čarkkus	tjarkus	n	
hibiskus	hibeskus	n	
iskkus	iskus	n	
suoskkus	suoskus	n	
gáskkus	gáskus	n	
savkkus	savkus	n	
bávkkus	bávkus	n	
jávkkus	jávkus	n	
boŋkkus	båŋkus	n	
fokus	fåkus	n	
váidalus	vájddalus	n	
doarjalus	doarjjalus	n	
várjalus	várjjalus	n	
geahččalus	giehttjalus	n	
čoalus	tjoalus	n	
hástalus	hásstalus	n	
giitalus	gijttalus	n	
muitalus	mujttalus	n	
bálvalus	bálvvalus	n	
árvalus	árvvalus	n	
cielus	tsielus	n	
seaillus	siejllus	n	
čuolus	tjuolus	n	
vádjolus	vádjulus	n	
čálus	tjálus	n	
bálválus	bálvválus	n	
olus	ålus	n	
goddalus	gåddålus	n	
jorgalus	jårggålus	n	
botnjalus	bådnjålus	n	
jorralus	jårrålus	n	
johtalus	jåhtålus	n	
uskimus	usskemus	n	
boaimmus	boajmus	n	
reašmmus	riesjmus	n	
váimmus	vájmus	n	
galmmus	galmus	n	
čalmmus	tjalmus	n	
čuolmmus	tjuolmus	n	
boaššumus	boassjumus	n	
čanus	tjanus	n	
botnus	bådnus	n	
kosinus	kåsenus	n	
cosinus	tsåsenus	n	
hypotenus	hyputenus	n	
činus	tjinus	n	
oainnus	oajnus	n	
geainnus	giejnus	n	
máinnus	májnus	n	
feartnus	fiernus	n	
vuortnus	vuornus	n	
gávnnus	gávnus	n	
viidánus	vijddánus	n	
vearránus	værránus	n	
bonus	bånus	n	
epos	epus	n	
čuohpus	tjuohpus	n	
gumppus	gumpus	n	
kumppus	kumpus	n	
tempus	temppus	n	
korpus	kårppus	n	
čierus	tjierus	n	
mearus	mierus	n	
čivrrus	tjivrus	n	
uvrrus	uvrus	n	
suvrrus	suvrus	n	
borus	bårus	n	
jorus	jårus	n	
genitiiva-instruktiiva-kasus	genetijva-instruktijva-kasus	n	
geasus	giesus	n	
ránsos	ránssus	n	
fránsos	fránssus	n	
gaccus	gattsus	n	
váccus	váttsus	n	
leavssus	lievsus	n	
juvssus	juvsus	n	
jovssus	jåvsus	n	
surggiidahtus	surgijdahtus	n	
beahtus	biehtus	n	
giittos	gijtus	n	
giittus	gijtus	n	
duođaštus	duodasjtus	n	
julggaštus	julgasjtus	n	
ávaštus	ávasjtus	n	
heađuštus	hiedusjtus	n	
mieđuštus	miedusjtus	n	
vuođuštus	vuodusjtus	n	
duoguštus	duogusjtus	n	
mátkkoštus	mátkkusjtus	n	
beloštus	belusjtus	n	
bealuštus	bielusjtus	n	
beroštus	berusjtus	n	
árvvoštus	árvusjtus	n	
ráŋggáštus	ráŋgásjtus	n	
jolggaštus	jålgåsjtus	n	
láittus	lájtus	n	
náittus	nájtus	n	
preanttus	prientus	n	
sárggastus	sárgastus	n	
oamastus	åmastus	n	
oasttus	oastus	n	
vuoiŋŋastus	vuojŋastus	n	
dárkkistus	dárkestus	n	
vearistus	vierestus	n	
áŧestus	átestus	n	
vuođustus	vuodustus	n	
almmustus	almustus	n	
nanostus	nanustus	n	
einnostus	ejnustus	n	
fásttus	fástus	n	
doarggástus	doargástus	n	
dárkkástus	dárkástus	n	
heammástus	hæmmástus	n	
birastus	birástus	n	
deahtástus	dæhtástus	n	
vásttus	vástus	n	
osttus	åstus	n	
ovddastus	åvdåstus	n	
dovddastus	dåvdåstus	n	
ođastus	ådåstus	n	
lonástus	lånåstus	n	
ovttastus	åvtåstus	n	
šattus	sjattus	n	
roavttus	roavtus	n	
guovttos	guovtus	n	
buvttus	buvtus	n	
bálvvus	bálvus	n	
čuovus	tjuovus	n	
čuorvvus	tjuorvus	n	
govus	gåvus	n	
skabas	skabás	n	
duolbbás	duolbás	n	
lađas	ladás	n	
nađas	nadás	n	
uđas	udás	n	
ráđas	rádás	n	
váđas	vádás	n	
lagas	lagás	n	
spagas	spagás	n	
givgás	givggás	n	
njigas	njigás	n	
rágas	rágás	n	
paradiás	parádiás	n	
paradiijás	parádijjás	n	
lánjas	lánjás	n	
lužas	lutjás	n	
skážas	skátjás	n	
alas	alás	n	
valas	valás	n	
nálas	nálás	n	
ramas	ramás	n	
gámas	gámás	n	
rámas	rámás	n	
fanas	fanás	n	
čanas	tjanás	n	
vanas	vanás	n	
spánas	spánás	n	
maras	marás	n	
biras	birás	n	
sáras	sárás	n	
gávas	gávás	n	
daŋas	daŋás	n	
doiddas	dåjdås	n	
ovddas	åvdås	n	
ođas	ådås	n	
bođas	bådås	n	
jođas	jådås	n	
lođas	lådås	n	
šolggas	sjålgås	n	
šogas	sjågås	n	
borjjas	bårjås	n	
govččas	gåvtjås	n	
dorkkas	dårkås	n	
boŋkkas	båŋkås	n	
bolas	bålås	n	
jolas	jålås	n	
oppas	åppås	n	
goppás	gåppås	n	
dohras	dåhrås	n	
norras	nårrås	n	
boras	bårås	n	
noras	nårås	n	
soiccas	såjtsås	n	
coiccas	tsåjtsås	n	
bohtás	båhtås	n	
skohtas	skåhtås	n	
gottas	gåttås	n	
holvvas	hålvås	n	
provás	pråvås	n	
ciebat	tsiebat	n	
gaibbat	gajbat	n	
seaibbat	siejbat	n	
váibbat	vájbat	n	
guorbbat	guorbat	n	
soabat	såbat	n	
ráđđadat	ráddadat	n	
ravddadat	ravdadat	n	
veagadat	viegadat	n	
bearjadat	bierjjadat	n	
veahkadat	viehkadat	n	
gaskkadat	gaskadat	n	
njuoskkadat	njuoskadat	n	
sealadat	sieladat	n	
sievlladat	sievladat	n	
njálbmadat	njálmmadat	n	
eatnadat	iednadat	n	
jietnadat	jiednadat	n	
eanadat	ienadat	n	
njiezadat	njietsadat	n	
čáhcadat	tjáhtsadat	n	
gáicadat	gájttsadat	n	
viercadat	vierttsadat	n	
sávzadat	sávttsadat	n	
uvssadat	uvsadat	n	
nuorttadat	nuortadat	n	
gárttadat	gártadat	n	
gásttadat	gástadat	n	
lávttadat	lávtadat	n	
beaivvadat	biejvadat	n	
buolvadat	buolvvadat	n	
čiekŋadat	tjiegŋadat	n	
rándat	ránddat	n	
bealledat	bielledat	n	
buoiddat	buojdat	n	
bárggaldat	bárgaldat	n	
sárggaldat	sárgaldat	n	
ávnnjaldat	ávnjaldat	n	
dárjjaldat	dárjaldat	n	
geahčaldat	giehtjaldat	n	
gealaldat	gielaldat	n	
soaimmaldat	soajmaldat	n	
meinnaldat	mejnaldat	n	
ávnnaldat	ávnaldat	n	
jearaldat	jieraldat	n	
rávrraldat	rávraldat	n	
geazaldat	gietsaldat	n	
ávttaldat	ávtaldat	n	
rasttildat	rasteldat	n	
muolddat	muoldat	n	
oskkoldat	åskuldat	n	
dinoldat	dinuldat	n	
goroldat	gåruldat	n	
bađaldat	badáldat	n	
boađáldat	boadáldat	n	
barddáldat	bardáldat	n	
bárddáldat	bárdáldat	n	
gálddat	gáldat	n	
bagaldat	bagáldat	n	
dagaldat	dagáldat	n	
bárggáldat	bárgáldat	n	
ruvggáldat	ruvgáldat	n	
dajaldat	dajáldat	n	
rávnnjáldat	rávnjáldat	n	
gažaldat	gatjáldat	n	
gižaldat	gitjáldat	n	
gávččáldat	gávtjáldat	n	
čoakkáldat	tjoakkáldat	n	
fálaldat	fáláldat	n	
njámaldat	njámáldat	n	
gáraldat	gáráldat	n	
basaldat	basáldat	n	
deattáldat	dættáldat	n	
sávaldat	sáváldat	n	
áŋaldat	áŋáldat	n	
dovddaldat	dåvdåldat	n	
gođaldat	gådåldat	n	
jođaldat	jådåldat	n	
jorggáldat	jårgåldat	n	
čogaldat	tjågåldat	n	
logaldat	lågåldat	n	
bonjaldat	bånjåldat	n	
notkkaldat	nåtkkåldat	n	
cokkaldat	tsåkkåldat	n	
snoraldat	snåråldat	n	
gottáldat	gåttåldat	n	
eanandat	ienandat	n	
sánddat	sándat	n	
ruođat	ruodat	n	
lávvordat	lávvurdat	n	
hilbodat	hilbbudat	n	
dulbodat	dulbbudat	n	
čurbodat	tjurbbudat	n	
jorbodat	jårbbudat	n	
čábbodat	tjábbudat	n	
šaddodat	sjaddudat	n	
giddodat	giddudat	n	
viidodat	vijddudat	n	
buidodat	bujddudat	n	
noidodat	nåjddudat	n	
govdodat	gåvddudat	n	
máddodat	máddudat	n	
áldodat	álldudat	n	
gefodat	gefudat	n	
geffodat	geffudat	n	
seggodat	seggudat	n	
riggodat	riggudat	n	
áigodat	ájggudat	n	
dáigodat	dájggudat	n	
njálgodat	njálggudat	n	
stargodat	starggudat	n	
árgodat	árggudat	n	
deŋggodat	deŋgudat	n	
bahodat	bahudat	n	
hedjodat	hedjudat	n	
lodjodat	lådjudat	n	
dávjodat	dávjjudat	n	
galljodat	galljudat	n	
valljodat	valljudat	n	
seavdnjodat	sievnnjudat	n	
romšodat	råmssjudat	n	
buššodat	bussjudat	n	
jahkodat	jahkudat	n	
suhkodat	suhkudat	n	
cohkodat	tsåhkudat	n	
guhkkodat	guhkkudat	n	
láikodat	lájkkudat	n	
dovkodat	dåvkkudat	n	
nuskodat	nusskudat	n	
hávskodat	hávsskudat	n	
allodat	alludat	n	
fallodat	falludat	n	
jallodat	jalludat	n	
vallodat	valludat	n	
bellodat	belludat	n	
jállodat	jálludat	n	
vupmodat	vubmudat	n	
opmodat	åbmudat	n	
ropmodat	råbmudat	n	
fitnodat	fidnudat	n	
hátnodat	hádnudat	n	
rotnodat	rådnudat	n	
geinnodat	gejnudat	n	
nannodat	nannudat	n	
unnodat	unnudat	n	
mánnodat	mánnudat	n	
čehppodat	tjehppudat	n	
garrodat	garrudat	n	
serrodat	serrudat	n	
verrodat	verrudat	n	
smirrodat	smirrudat	n	
burrodat	burrudat	n	
furrodat	furrudat	n	
nurrodat	nurrudat	n	
sturrodat	sturrudat	n	
givrodat	givrrudat	n	
kivrodat	kivrrudat	n	
suvrodat	suvrrudat	n	
sávrodat	sávrrudat	n	
nárrodat	nárrudat	n	
assodat	assudat	n	
gassodat	gassudat	n	
bessodat	bessudat	n	
viisodat	vijssudat	n	
dássodat	dássudat	n	
ossodat	åssudat	n	
lossodat	låssudat	n	
uhccodat	uhttsudat	n	
ásodat	ásudat	n	
mahtodat	mahtudat	n	
duhtodat	duhtudat	n	
fastodat	fasstudat	n	
šattodat	sjattudat	n	
máttodat	máttudat	n	
ruvttodat	ruvtudat	n	
servvodat	servudat	n	
hivvodat	hivvudat	n	
servodat	servvudat	n	
čikŋodat	tjigŋudat	n	
ravddat	ravdat	n	
luovddat	luovdat	n	
čabadat	tjabádat	n	
oađđádat	oaddádat	n	
gárdádat	gárddádat	n	
boalddádat	boaldádat	n	
durddádat	durdádat	n	
gearddádat	gærdádat	n	
nealgádat	nælggádat	n	
heargádat	hærggádat	n	
čielggádat	tjielgádat	n	
bálggádat	bálgádat	n	
njeađggádat	njærgádat	n	
čuovggádat	tjuovgádat	n	
veahádat	væhádat	n	
lanjadat	lanjádat	n	
seavnnjádat	sævnjádat	n	
oarjjádat	oarjádat	n	
báhčádat	báhtjádat	n	
ceahkádat	tsæhkádat	n	
dálkádat	dálkkádat	n	
dálkkádat	dálkádat	n	
askkádat	askádat	n	
baskkádat	baskádat	n	
njuoskkádat	njuoskádat	n	
uskkádat	uskádat	n	
roavskkádat	roavskádat	n	
bealládat	bælládat	n	
stealládat	stælládat	n	
čuoládat	tjuoládat	n	
sievlládat	sievládat	n	
ealádat	æládat	n	
sealádat	sæládat	n	
galmmádat	galmádat	n	
njálmmádat	njálmádat	n	
galbmádat	galmmádat	n	
fierbmádat	fiermmádat	n	
fierpmádat	fiermádat	n	
deamádat	dæmádat	n	
geamádat	gæmádat	n	
oainnádat	oajnádat	n	
áinnádat	ájnádat	n	
eanádat	ænádat	n	
šearádat	sjærádat	n	
beassádat	bæssádat	n	
vazadat	vatsádat	n	
vazádat	vatsádat	n	
njiezádat	njietsádat	n	
čáhcádat	tjáhtsádat	n	
čázadat	tjátsádat	n	
čázádat	tjátsádat	n	
cázádat	tsátsádat	n	
geasádat	gæsádat	n	
luoitádat	luojttádat	n	
gurtádat	gurttádat	n	
čavadat	tjavádat	n	
divadat	divádat	n	
beaivvádat	bæjvádat	n	
balvvádat	balvádat	n	
dálvvádat	dálvádat	n	
oaivádat	oajvvádat	n	
sarvádat	sarvvádat	n	
searvádat	særvvádat	n	
lávadat	lávádat	n	
dobadat	dåbådat	n	
dobádat	dåbådat	n	
gobádat	gåbådat	n	
goddádat	gåddådat	n	
jođádat	jådådat	n	
golgadat	gålggådat	n	
borjadat	bårjjådat	n	
borjjádat	bårjådat	n	
goikkádat	gåjkådat	n	
rokkádat	råkkådat	n	
olládat	ållådat	n	
bohccádat	båhttsådat	n	
losádat	låsådat	n	
ovttadat	åvtådat	n	
govadat	gåvådat	n	
skovádat	skåvådat	n	
oađđadagat	oaddadagat	n	
čuoldagat	tjuolldagat	n	
hellodagat	helludagat	n	
vieljažagat	vieljjatjagat	n	
verddežagat	verdetjagat	n	
egežagat	egetjagat	n	
manježagat	manjetjagat	n	
áhčežagat	áhtjetjagat	n	
fulkkežagat	fulketjagat	n	
goskkežagat	gåsketjagat	n	
spiležagat	spiletjagat	n	
guimmežagat	gujmetjagat	n	
gáimmežagat	gájmetjagat	n	
jumežagat	jumetjagat	n	
etnežagat	ednetjagat	n	
gálojenežagat	gálujenetjagat	n	
ránnežagat	ránnetjagat	n	
lávežagat	lávetjagat	n	
mágažagat	mágátjagat	n	
kránnjážagat	kránnjátjagat	n	
ránnážagat	ránnátjagat	n	
oappážagat	oappátjagat	n	
olbmážagat	ålmmåtjagat	n	
ceakcagat	tsiektsagat	n	
gearregat	gierregat	n	
čálggat	tjálgat	n	
čuorggat	tjuorgat	n	
doaŋggat	doaŋgat	n	
táŋggat	táŋgat	n	
reađahat	riedahat	n	
veađahat	viedahat	n	
gealddahat	gieldahat	n	
válddahat	váldahat	n	
njuođahat	njuodahat	n	
rievddahat	rievdahat	n	
laiggahat	lajgahat	n	
spaiggahat	spajgahat	n	
mieiggahat	miejgahat	n	
bálggahat	bálgahat	n	
njeađggahat	njiergahat	n	
searggahat	siergahat	n	
joavggahat	joavgahat	n	
vuoššahat	vuossjahat	n	
gahčahat	gahtjahat	n	
vieččahat	viettjahat	n	
luoikkahat	luojkahat	n	
ciekkahat	tsiekkahat	n	
guoskkahat	guoskahat	n	
suoskkahat	suoskahat	n	
njáskkahat	njáskahat	n	
návhllahat	návhlahat	n	
čuolahat	tjuolahat	n	
muovllahat	muovlahat	n	
doaimmahat	doajmahat	n	
duolmmahat	duolmahat	n	
málmmahat	málmahat	n	
čearpmahat	tjiermahat	n	
suorpmahat	suormahat	n	
sainnahat	sajnahat	n	
čuohpahat	tjuohpahat	n	
fearahat	fierahat	n	
gearahat	gierahat	n	
rávrrahat	rávrahat	n	
skoarahat	skårahat	n	
moarahat	mårahat	n	
vuoissahat	vuojsahat	n	
guorssahat	guorsahat	n	
gárssahat	gársahat	n	
báhcahat	báhtsahat	n	
máhcahat	máhtsahat	n	
váccahat	váttsahat	n	
veattahat	viettahat	n	
čivttahat	tjivtahat	n	
ávttahat	ávtahat	n	
oaivvahat	oajvahat	n	
vuoiŋŋahat	vuojŋahat	n	
skoldehat	skålldehat	n	
geđgehat	gerggehat	n	
čuggehat	tjuggehat	n	
lávgehat	lávggehat	n	
heŋgehat	heŋggehat	n	
geažehat	gietjehat	n	
stoahčehat	stoahtjehat	n	
cahkkehat	tsahkkehat	n	
čohkkehat	tjåhkkehat	n	
njuikehat	njujkkehat	n	
boskehat	båsskehat	n	
mollehat	mållehat	n	
dohppehat	dåhppehat	n	
lohppehat	låhppehat	n	
gorrehat	gårrehat	n	
fálttehat	fáltehat	n	
rastehat	rasstehat	n	
dustehat	dusstehat	n	
rentehat	renttehat	n	
skirvehat	skirvvehat	n	
čurvehat	tjurvvehat	n	
gorgŋehat	gårŋŋehat	n	
láibbohat	lájbuhat	n	
rábohat	rábuhat	n	
ovdohat	åvdduhat	n	
buđohat	buduhat	n	
guđohat	guduhat	n	
snuđohat	snuduhat	n	
govddohat	gåvduhat	n	
láigohat	lájgguhat	n	
láiggohat	lájguhat	n	
cirggohat	tsirguhat	n	
heŋggohat	heŋguhat	n	
ogohat	åguhat	n	
njejohat	njejuhat	n	
dorjjohat	dårjuhat	n	
boššohat	båssjuhat	n	
divššohat	divsjuhat	n	
vuhččohat	vuhttjuhat	n	
čuččohat	tjuttjuhat	n	
lužohat	lutjuhat	n	
rožohat	råtjuhat	n	
vujohat	vujuhat	n	
gaikkohat	gajkuhat	n	
njuikkohat	njujkuhat	n	
čukkohat	tjukkuhat	n	
lokkohat	låkkuhat	n	
vurkkohat	vurkuhat	n	
faskkohat	faskuhat	n	
njaskkohat	njaskuhat	n	
cuvkkohat	tsuvkuhat	n	
bolohat	båluhat	n	
boimmohat	båjmuhat	n	
dulmmohat	dulmuhat	n	
gorpmohat	gårmuhat	n	
čidnohat	tjiddnuhat	n	
orohat	åruhat	n	
uvssohat	uvsuhat	n	
báittohat	bájtuhat	n	
lehttohat	lehttuhat	n	
luottohat	luottuhat	n	
luttohat	luttuhat	n	
divohat	divuhat	n	
goivvohat	gåjvuhat	n	
čárvvohat	tjárvuhat	n	
nevvohat	nevvuhat	n	
gorkŋohat	gårŋuhat	n	
cábahat	tsábáhat	n	
boađáhat	boadáhat	n	
iđáhat	idáhat	n	
boalddáhat	boaldáhat	n	
válddáhat	váldáhat	n	
gealddáhat	gældáhat	n	
guođáhat	guodáhat	n	
girddáhat	girdáhat	n	
dagahat	dagáhat	n	
jugahat	jugáhat	n	
vajahat	vajáhat	n	
cross-vuojáhat	cråss-vuojáhat	n	
bážáhat	bátjáhat	n	
čájáhat	tjájáhat	n	
časkkáhat	tjaskáhat	n	
falahat	faláhat	n	
šoaláhat	sjoaláhat	n	
valahat	valáhat	n	
ulahat	uláhat	n	
nálahat	náláhat	n	
sálahat	sáláhat	n	
ealáhat	æláhat	n	
galmmáhat	galmáhat	n	
njámahat	njámáhat	n	
manahat	manáhat	n	
arahat	aráhat	n	
márahat	máráhat	n	
sárahat	sáráhat	n	
čuozáhat	tjuotsáhat	n	
váccáhat	váttsáhat	n	
geasáhat	gæsáhat	n	
soaittáhat	soajtáhat	n	
asttáhat	astáhat	n	
gasttáhat	gastáhat	n	
veattáhat	vættáhat	n	
šávahat	sjáváhat	n	
doiddáhat	dåjdåhat	n	
govddáhat	gåvdåhat	n	
jođáhat	jådåhat	n	
logahat	lågåhat	n	
rokkahat	råkkåhat	n	
bovnnahat	båvnåhat	n	
sonahat	sånåhat	n	
oppahat	åppåhat	n	
borahat	båråhat	n	
norahat	nåråhat	n	
gosahat	gåsåhat	n	
heajat	hiejat	n	
galjat	galjjat	n	
šinnjat	sjinnjat	n	
seavdnjat	sievnnjat	n	
buovnnjat	buovnjat	n	
vuorjjat	vuorjat	n	
álššat	álsjat	n	
vieljažat	vieljjatjat	n	
oahppásažžat	oahppásadtjat	n	
verddežat	verdetjat	n	
egežat	egetjat	n	
manježat	manjetjat	n	
áhčežat	áhtjetjat	n	
fulkkežat	fulketjat	n	
goskkežat	gåsketjat	n	
beležat	beletjat	n	
spiležat	spiletjat	n	
guimmežat	gujmetjat	n	
gáimmežat	gájmetjat	n	
etnežat	ednetjat	n	
gálojenežat	gálujenetjat	n	
ránnežat	ránnetjat	n	
burežat	buretjat	n	
lávežat	lávetjat	n	
stoahčat	stoahtjat	n	
bearahaččat	bierahattjat	n	
bearrahaččat	bierrahattjat	n	
dánsejaččat	dánssejattjat	n	
ristejaččat	risstejattjat	n	
rávvejaččat	rávvejattjat	n	
krávvejaččat	krávvejattjat	n	
láhčamaččat	láhtjamattjat	n	
vuoiŋŋamaččat	vuojŋamattjat	n	
oarbinaččat	oarbbenattjat	n	
dovdosaččat	dåvddusattjat	n	
gierrásaččat	gierrásattjat	n	
manemuččat	manemuttjat	n	
monemuččat	månemuttjat	n	
čavččat	tjavtjat	n	
mágažat	mágátjat	n	
kránnjážat	kránnjátjat	n	
ránnážat	ránnátjat	n	
oappážat	oappátjat	n	
loahppážat	loahppátjat	n	
olbmážat	ålmmåtjat	n	
cakkat	tsakkat	n	
sarvváskat	sarváskat	n	
gimbalat	gimbbalat	n	
beargalat	bierggalat	n	
gáiraváillat	gájravájllat	n	
jorbolat	jårbbulat	n	
čođđolat	tjåddulat	n	
vaššolat	vassjulat	n	
bohkolat	båhkulat	n	
cohkolat	tsåhkulat	n	
mannolat	mannulat	n	
oidnolat	åjnnulat	n	
mihtolat	mihtulat	n	
johtolat	jåhtulat	n	
vustolat	vusstulat	n	
juovllat	juovlat	n	
dávllat	dávlat	n	
earbmálat	ærmmálat	n	
vuostálat	vuosstálat	n	
čođđálat	tjåddålat	n	
mohkkálat	måhkkålat	n	
alimat	alemat	n	
čearpmat	tjiermat	n	
guorpmat	guormat	n	
suorpmat	suormat	n	
gurpmat	gurmat	n	
uđámat	udámat	n	
kárvenat	kárvvenat	n	
ruoinnat	ruojnat	n	
stáinnat	stájnat	n	
heahpat	hiehpat	n	
lánuorat	lánoorat	n	
guoirrat	guojrrat	n	
lámborat	lámbburat	n	
mihcamárat	mihtsamárat	n	
goarat	gårat	n	
mieskkahasat	mieskahasat	n	
guovssahasat	guovsahasat	n	
jugalmasat	jugálmasat	n	
boralmasat	bårålmasat	n	
gávdnasat	gávnnasat	n	
kárduvssat	kárdduvssat	n	
njiezat	njietsat	n	
smirezat	smiretsat	n	
báhcat	báhtsat	n	
bihcabáhcat	bihtsabáhtsat	n	
njuozat	njuotsat	n	
gaccat	gattsat	n	
guoccat	guottsat	n	
badjosat	badjusat	n	
lahkosat	lahkusat	n	
rievssat	rievsat	n	
nivssat	nivsat	n	
guovssat	guovsat	n	
juvssat	juvsat	n	
láibbastat	lájbastat	n	
fasttat	fastat	n	
mieiggastat	miejgastat	n	
liđggastat	lirgastat	n	
cirggastat	tsirgastat	n	
njurggastat	njurgastat	n	
njárggastat	njárgastat	n	
sárggastat	sárgastat	n	
lávggastat	lávgastat	n	
heaŋggastat	hieŋgastat	n	
gavnnjastat	gavnjastat	n	
geahčastat	giehtjastat	n	
gahččastat	gahttjastat	n	
čuoččastat	tjuottjastat	n	
čievččastat	tjievtjastat	n	
leahkastat	liehkastat	n	
ceahkastat	tsiehkastat	n	
huškkastat	husjkastat	n	
fáškkastat	fásjkastat	n	
ciekkastat	tsiekkastat	n	
čuokkastat	tjuokkastat	n	
bálkkastat	bálkastat	n	
mearkkastat	mierkastat	n	
faskkastat	faskastat	n	
lasttat	lastat	n	
čuolastat	tjuolastat	n	
buoimmastat	buojmastat	n	
duolmmastat	duolmastat	n	
čuohpastat	tjuohpastat	n	
gurppastat	gurpastat	n	
fearastat	fierastat	n	
báhcastat	báhtsastat	n	
máhcastat	máhtsastat	n	
garccastat	gartsastat	n	
gaccastat	gattsastat	n	
njirttastat	njirtastat	n	
duokŋastat	duogŋastat	n	
vuoiŋŋastat	vuojŋastat	n	
besttat	bestat	n	
čuggestat	tjuggestat	n	
el-čuggestat	el-tjuggestat	n	
keasttat	kiestat	n	
čohkkestat	tjåhkkestat	n	
njuikestat	njujkkestat	n	
čellestat	tjellestat	n	
čurvestat	tjurvvestat	n	
čárvestat	tjárvvestat	n	
disttat	distat	n	
luosttat	luostat	n	
distat	disstat	n	
buddostat	buddustat	n	
muđostat	mudustat	n	
bogostat	bågustat	n	
bunjostat	bunjustat	n	
gohčostat	gåhtjustat	n	
luskkostat	luskustat	n	
njalostat	njalustat	n	
dinostat	dinustat	n	
einnostat	ejnustat	n	
gárostat	gárustat	n	
gorostat	gårustat	n	
njorostat	njårustat	n	
rabastat	rabástat	n	
gurggástat	gurgástat	n	
leagástat	lægástat	n	
meagástat	mægástat	n	
vajastat	vajástat	n	
livjjástat	livjástat	n	
ájastat	ájástat	n	
meahkástat	mæhkástat	n	
guškkástat	gusjkástat	n	
časkkástat	tjaskástat	n	
gáskkástat	gáskástat	n	
steallástat	stællástat	n	
čálastat	tjálástat	n	
njámastat	njámástat	n	
čanastat	tjanástat	n	
marastat	marástat	n	
gárastat	gárástat	n	
sázastat	sátsástat	n	
bivastat	bivástat	n	
gobastat	gåbåstat	n	
gobástat	gåbåstat	n	
čogastat	tjågåstat	n	
bonjastat	bånjåstat	n	
rokkastat	råkkåstat	n	
rokkástat	råkkåstat	n	
snorastat	snåråstat	n	
ovttastat	åvtåstat	n	
govastat	gåvåstat	n	
veattat	viettat	n	
báitat	bájttat	n	
nuvttat	nuvtat	n	
kruvttat	kruvtat	n	
ávttat	ávtat	n	
dávttat	dávtat	n	
geavat	gievat	n	
čuoivvat	tjuojvat	n	
sabit	sabet	n	
čeabet	tjiebet	n	
šibit	sjibet	n	
skibit	skibet	n	
nirbbet	nirbet	n	
gurbbet	gurbet	n	
skurbbet	skurbet	n	
rábit	rábet	n	
iđit	idet	n	
gorddet	gårdet	n	
buđet	budet	n	
vuovddit	vuovdet	n	
dirgget	dirget	n	
čuget	tjuget	n	
gádjit	gádjet	n	
mádjit	mádjet	n	
vádjit	vádjet	n	
veajet	viejet	n	
njealjit	njieljjet	n	
viljjit	viljet	n	
bulžžet	bultjet	n	
hárččet	hártjet	n	
skávžžet	skávtjet	n	
čoavjjet	tjoavjet	n	
ahkit	ahket	n	
eahket	iehket	n	
eahkit	iehket	n	
goikket	gåjket	n	
snárket	snárkket	n	
gáiskkit	gájsket	n	
goaskit	goassket	n	
gáskkit	gásket	n	
ealet	ielet	n	
ealit	ielet	n	
sallit	sallet	n	
neillet	nejllet	n	
spáillit	spájllet	n	
rullit	rullet	n	
geavllet	gievlet	n	
čeavllit	tjievlet	n	
dávllet	dávlet	n	
ipmet	ibmet	n	
ipmit	ibmet	n	
eamit	iemet	n	
gulmmet	gulmet	n	
gulmmit	gulmet	n	
golmmet	gålmet	n	
hommet	håmmet	n	
juomit	juomet	n	
luomit	luomet	n	
bearpmet	biermet	n	
jámit	jámet	n	
roatnet	roadnet	n	
fitnet	fidnet	n	
litnet	lidnet	n	
botnit	bådnet	n	
drotnet	drådnet	n	
roahnit	roahnet	n	
ráhnit	ráhnet	n	
meinnet	mejnet	n	
ordnet	årnnet	n	
honnet	hånnet	n	
ronnet	rånnet	n	
dronnet	drånnet	n	
hertnet	hernet	n	
č.ortnet	tj.ornet	n	
gártnit	gárnet	n	
ortnet	årnet	n	
devnnet	devnet	n	
tevnnet	tevnet	n	
stevnnet	stevnet	n	
livnnet	livnet	n	
honet	hånet	n	
sáhpit	sáhpet	n	
varit	varet	n	
femberet	fembberet	n	
rosgeret	råsgeret	n	
jierit	jieret	n	
gáhrit	gáhret	n	
suorit	suoret	n	
sarrit	sarret	n	
čearret	tjierret	n	
čearrit	tjierret	n	
vearret	vierret	n	
orrit	årret	n	
gávrret	gávret	n	
kávrret	kávret	n	
skoret	skåret	n	
geaset	gieset	n	
isit	iset	n	
meisset	mejset	n	
speisset	spejset	n	
hárset	hársset	n	
hársit	hársset	n	
beahcet	biehtset	n	
njeahcet	njiehtset	n	
čeahcet	tjiehtset	n	
čeahcit	tjiehtset	n	
meahcet	miehtset	n	
meahcit	miehtset	n	
rihcit	rihtset	n	
gaccet	gattset	n	
muzet	mutset	n	
čázet	tjátset	n	
čázit	tjátset	n	
hivsset	hivset	n	
petit	petet	n	
suittet	sujtet	n	
bilttet	biltet	n	
erttet	ertet	n	
skerttet	skertet	n	
skirttet	skirtet	n	
sasttet	sastet	n	
sisttet	sistet	n	
ustit	usstet	n	
rusttet	rustet	n	
alpin-rusttet	alppen-rustet	n	
gosttet	gåstet	n	
kosttet	kåstet	n	
rántet	ránttet	n	
rottet	råttet	n	
ovttet	åvtet	n	
skoavit	skoavet	n	
dálvvet	dálvet	n	
goarvvet	goarvet	n	
helvet	helvvet	n	
Ohcejot	Åhtsejot	n	
colitt	tsålett	n	
hilbbot	hilbut	n	
stámbbut	stámbut	n	
jorbbot	jårbut	n	
šođbbut	sjårbut	n	
nábot	nábut	n	
mieđut	miedut	n	
iđut	idut	n	
biđut	bidut	n	
láiddot	lájdut	n	
oiddot	åjdut	n	
njuorddut	njuordut	n	
guovddut	guovdut	n	
stáđut	stádut	n	
váđot	vádut	n	
ođut	ådut	n	
šealggut	sjielgut	n	
vielggut	vielgut	n	
njuolggut	njuolgut	n	
njulggot	njulgut	n	
golggot	gålgut	n	
čuorggut	tjuorgut	n	
čorggut	tjårgut	n	
snávggut	snávgut	n	
áddjot	áddjut	n	
bejot	bejut	n	
galjot	galjjut	n	
njuorjjot	njuorjut	n	
bivššut	bivsjut	n	
spažut	spatjut	n	
buošut	buotjut	n	
čužot	tjutjut	n	
sivjjot	sivjut	n	
gájot	gájut	n	
seahkot	siehkut	n	
rohkot	råhkut	n	
márškkut	mársjkut	n	
ruškkut	rusjkut	n	
guikkut	gujkut	n	
gálkkot	gálkut	n	
baskkot	baskut	n	
čeaskkut	tjieskut	n	
šoavkkut	sjoavkut	n	
gealut	gielut	n	
njelot	njelut	n	
nelot	nelut	n	
dilot	dilut	n	
lullot	lullut	n	
skovlot	skåvllut	n	
gállot	gállut	n	
olut	ålut	n	
bolot	bålut	n	
skupmot	skubmut	n	
dápmot	dábmut	n	
lášmmut	lásjmut	n	
bulmmot	bulmut	n	
álbmot	álmmut	n	
san-álbmot	san-álmmut	n	
skumot	skumut	n	
rutnot	rudnut	n	
áinnut	ájnut	n	
lánnot	lánnut	n	
ártnot	árnut	n	
rávnnut	rávnut	n	
rahpot	rahput	n	
gehpot	gehput	n	
čáhpot	tjáhput	n	
čáhput	tjáhput	n	
snáhpot	snáhput	n	
šluppot	slupput	n	
gávpot	gávpput	n	
gáhrot	gáhrut	n	
sirot	sirut	n	
čurrot	tjurrut	n	
čurot	tjurut	n	
orut	årut	n	
gorut	gårut	n	
iissot	ijsut	n	
gálssot	gálsut	n	
olssot	ålsut	n	
jonssot	jånsut	n	
cizot	tsitsut	n	
ivssut	ivsut	n	
ruovssut	ruovsut	n	
uvssot	uvsut	n	
nuhtot	nuhtut	n	
heittot	hejtut	n	
herttot	hertut	n	
nuorttut	nuortut	n	
vuosttut	vuostut	n	
rosttot	råstut	n	
ruovttot	ruovtut	n	
nuvttot	nuvtut	n	
deavut	dievut	n	
rivot	rivut	n	
viivvut	vijvut	n	
lávot	lávut	n	
ribat	ribát	n	
hubat	hubát	n	
čeabát	tjæbát	n	
iđat	idát	n	
soalddát	soaldát	n	
gálddát	gáldát	n	
spagat	spagát	n	
ragat	ragát	n	
stigat	stigát	n	
siiggát	sijgát	n	
eaiggát	æjgát	n	
rugat	rugát	n	
vihat	vihát	n	
bijat	biját	n	
dulját	duljját	n	
tulját	tuljját	n	
seavnnját	sævnját	n	
guššát	gussját	n	
kuššát	kussját	n	
buošát	buotját	n	
gáskkát	gáskát	n	
hoavkkát	hoavkát	n	
falat	falát	n	
valat	valát	n	
čálat	tjálát	n	
ealát	ælát	n	
njamat	njamát	n	
sivnnát	sivnát	n	
hánat	hánát	n	
ránat	ránát	n	
neahpát	næhpát	n	
dearppát	dærpát	n	
vearrát	værrát	n	
guzat	gutsát	n	
ásat	ását	n	
gáittát	gájtát	n	
divat	divát	n	
livat	livát	n	
hálvvát	hálvát	n	
skurvvát	skurvát	n	
ruoivát	ruojvvát	n	
durvát	durvvát	n	
návat	návát	n	
ođat	ådåt	n	
čogat	tjågåt	n	
borjat	bårjjåt	n	
lojat	låjåt	n	
romat	råmåt	n	
goppát	gåppåt	n	
gohrat	gåhråt	n	
dorrát	dårråt	n	
shortsat	shårtsåt	n	
mosat	måsåt	n	
kommandu	kåmmåndu	n	
ámadadju	ámádadju	n	
ámadeadju	ámádeadju	n	
sávarihkku	sávárihkku	n	
šovv	sjåvv	n	
tv-šovv	tv-sjåvv	n	
show	shåw	n	
sis-bandy	sis-banddy	n	
trendy	trenddy	n	
hockey	håckey	n	
beach^party	biech^partty	n	
komite^á	kåmete^á	n	
bumbá	bumbbá	n	
šleambá	slæmbbá	n	
guorbá	guorbbá	n	
čuorbá	tjuorbbá	n	
šlubbá	slubbá	n	
reabbá	ræbbá	n	
čieđđá	tjieddá	n	
šlieddá	slieddá	n	
sieidá	siejddá	n	
gáidá	gájddá	n	
ráidá	rájddá	n	
pandá	panddá	n	
gendá	genddá	n	
roho-guoddá	råho-guoddá	n	
buđđá	buddá	n	
luvdá	luvddá	n	
suvdá	suvddá	n	
dávdá	dávddá	n	
skáđđá	skáddá	n	
spáđđá	spáddá	n	
feaddá	fæddá	n	
dieldá	dielldá	n	
suvddá	suvdá	n	
biigá	bijggá	n	
riigá	rijggá	n	
viigá	vijggá	n	
gáigá	gájggá	n	
skielgá	skielggá	n	
bilgá	bilggá	n	
snuolgá	snuolggá	n	
šuđgá	sjurggá	n	
šlivgá	slivggá	n	
dávgá	dávggá	n	
skiŋgá	skiŋggá	n	
duŋgá	duŋggá	n	
juŋgá	juŋggá	n	
láŋgá	láŋggá	n	
sáŋgá	sáŋggá	n	
steaŋgá	stæŋggá	n	
siiggá	sijgá	n	
marggá	margá	n	
sárggá	sárgá	n	
šuodjá	sjuodjá	n	
mei^eriijá	mej^erijjá	n	
politiijá	påletijjá	n	
liljá	liljjá	n	
garjá	garjjá	n	
sárjá	sárjjá	n	
jearjá	jærjjá	n	
jeađjá	jærjjá	n	
rávjá	rávjjá	n	
geriljá	gereljá	n	
šilljá	sjilljá	n	
dealljá	dælljá	n	
boadnjá	boaddnjá	n	
látnjá	ládnjá	n	
čuonjá	tjuonjá	n	
historjá	hissturjá	n	
liššá	lissjá	n	
stižžá	stidtjá	n	
spihčá	spihtjá	n	
čiekčá	tjiektjá	n	
čukčá	tjuktjá	n	
leakšá	læktjá	n	
reakčá	ræktjá	n	
spálžá	spálltjá	n	
šinčá	sjintjá	n	
spálčá	spálttjá	n	
čuonžá	tjuonttjá	n	
steanžá	stænttjá	n	
njárčá	njárttjá	n	
guvžá	guvttjá	n	
skávžá	skávttjá	n	
lávžá	lávttjá	n	
čeavžá	tjævttjá	n	
bážá	bátjá	n	
čiehká	tjiehká	n	
doašká	doassjká	n	
liešká	liessjká	n	
šišká	sjissjká	n	
čišká	tjissjká	n	
muošká	muossjká	n	
cuohkká	tsuohkká	n	
reahkká	ræhkká	n	
láiká	lájkká	n	
gielká	gielkká	n	
gilká	gilkká	n	
skuolká	skuolkká	n	
bálká	bálkká	n	
fálká	fálkká	n	
válká	válkká	n	
mierká	mierkká	n	
sirká	sirkká	n	
fuorká	fuorkká	n	
guorká	guorkká	n	
vuorká	vuorkká	n	
urká	urkká	n	
gurká	gurkká	n	
šávká	sjávkká	n	
liŋká	liŋkká	n	
kliŋká	kliŋkká	n	
juŋká	juŋkká	n	
luŋká	luŋkká	n	
beaŋká	bæŋkká	n	
sedolká	sedulká	n	
niská	nisská	n	
roaiská	roajsská	n	
nuoská	nuosská	n	
reaská	ræsská	n	
jeatká	jætká	n	
reatká	rætká	n	
luoilá	luojlá	n	
rišlá	risjlá	n	
šillá	sjillá	n	
kamomillá	kamumillá	n	
sivlá	sivllá	n	
suvlá	suvllá	n	
feallá	fællá	n	
heallá	hællá	n	
vealá	vælá	n	
rábmá	rábbmá	n	
čuoibmá	tjuojmmá	n	
fielbmá	fielmmá	n	
šielbmá	sjielmmá	n	
skierbmá	skiermmá	n	
lieđbmá	liermmá	n	
firbmá	firmmá	n	
gurbmá	gurmmá	n	
kardemummá	karddemummá	n	
cummá	tsummá	n	
bismá	bissmá	n	
ásmá	ássmá	n	
básmá	bássmá	n	
rádná	ráddná	n	
hátná	hádná	n	
čátná	tjádná	n	
skátná	skádná	n	
cinná	tsinná	n	
ruoidná	ruojnná	n	
skuordná	skuornná	n	
beanná	bænná	n	
peanná	pænná	n	
liippá	lijpá	n	
šliipá	slijppá	n	
háipá	hájppá	n	
doalpá	doalppá	n	
skoalpá	skoalppá	n	
šlimpá	slimppá	n	
lumpá	lumppá	n	
lámpá	lámppá	n	
sámpá	sámppá	n	
hárpá	hárppá	n	
várpá	várppá	n	
váravárpá	várávárpá	n	
guoirá	guojrá	n	
gáirá	gájrá	n	
láirá	lájrá	n	
endoforá	endduforá	n	
logoforá	låguforá	n	
eksoforá	eksuforá	n	
anaforá	anáforá	n	
kataforá	katáforá	n	
šnjierrá	sjnjierrá	n	
čierrá	tjierrá	n	
širrá	sjirrá	n	
čivrá	tjivrrá	n	
stávrá	stávrrá	n	
hearrá	hærrá	n	
heaksá	hæksá	n	
čeaksá	tjæksá	n	
cissá	tsissá	n	
giisá	gijssá	n	
viisá	vijssá	n	
áisá	ájssá	n	
gáisá	gájssá	n	
máisá	májssá	n	
gánsá	gánssá	n	
suorsá	suorssá	n	
vársá	várssá	n	
čezá	tjetsá	n	
vuoncá	vuonttsá	n	
šleancá	slænttsá	n	
livzá	livttsá	n	
šlihtá	slihtá	n	
skeittá	skejtá	n	
tieltá	tielltá	n	
dealtá	dælltá	n	
tealtá	tælltá	n	
testamentá	tesstamentá	n	
deastámentá	dæsstámentá	n	
listá	lisstá	n	
vuostá	vuosstá	n	
verstá	versstá	n	
vearstá	værsstá	n	
gávstá	gávsstá	n	
nástá	násstá	n	
beantá	bænttá	n	
muoŧŧá	muottá	n	
smartá	smarttá	n	
šiertá	sjierttá	n	
gártá	gárttá	n	
kártá	kárttá	n	
iivá	ijvvá	n	
njuolvá	njuolvvá	n	
bálvá	bálvvá	n	
málvá	málvvá	n	
fiervá	fiervvá	n	
viervá	viervvá	n	
kurvá	kurvvá	n	
čárvá	tjárvvá	n	
šuvvá	sjuvvá	n	
bomba	båmbbå	n	
jorbá	jårbbå	n	
gobba	gåbbå	n	
gobbá	gåbbå	n	
sroba	sråbå	n	
orda	årddå	n	
bodda	båddå	n	
lodda	låddå	n	
rodda	råddå	n	
oldá	ålldå	n	
goldda	gåldå	n	
dovdda	dåvdå	n	
gođa	gådå	n	
koda	kådå	n	
lođá	lådå	n	
golfa	gålffå	n	
morfa	mårffå	n	
soffá	såffå	n	
stoffa	ståffå	n	
romfa	råmfå	n	
strofa	stråfå	n	
kata^strofa	kata^stråfå	n	
apo^strofa	apo^stråfå	n	
boigá	båjggå	n	
holga	hålggå	n	
čolga	tjålggå	n	
borga	bårggå	n	
norga	nårggå	n	
dánska-norga	dánsska-nårggå	n	
pin^joŋga	pin^jåŋggå	n	
monof^toŋga	månuf^tåŋggå	n	
blogga	blåggå	n	
boiggá	båjgå	n	
dia^loga	dia^lågå	n	
ploga	plågå	n	
toga	tågå	n	
boija	båjjå	n	
soija	såjjå	n	
toija	tåjjå	n	
bolljá	bålljå	n	
bronša	brånsjå	n	
morša	mårssjå	n	
moršá	mårssjå	n	
brošša	bråssjå	n	
drošša	dråssjå	n	
gožža	gådtjå	n	
šokčá	sjåktjå	n	
sokčá	såktjå	n	
šolža	sjålltjå	n	
solža	sålltjå	n	
morčá	mårttjå	n	
bojá	båjå	n	
johka	jåhkå	n	
rohka	råhkå	n	
sohka	såhkå	n	
bohkká	båhkkå	n	
dohkká	dåhkkå	n	
hohkka	håhkkå	n	
hohkká	håhkkå	n	
šohkka	sjåhkkå	n	
čohkka	tjåhkkå	n	
lohkka	låhkkå	n	
blohkka	blåhkkå	n	
stohkka	ståhkkå	n	
roiká	råjkkå	n	
golka	gålkkå	n	
snolká	snålkkå	n	
dorka	dårkkå	n	
gorka	gårkkå	n	
plokka	plåkkå	n	
boska	båsskå	n	
boská	båsskå	n	
doska	dåsskå	n	
čoska	tjåsskå	n	
toska	tåsskå	n	
gotka	gåtkå	n	
jovla	jåvllå	n	
skovlá	skåvllå	n	
povla	påvllå	n	
stovla	ståvllå	n	
dolla	dållå	n	
jolla	jållå	n	
molla	mållå	n	
nolla	nållå	n	
nollá	nållå	n	
rolla	rållå	n	
jolá	jålå	n	
njolá	njålå	n	
mola	målå	n	
pola	pålå	n	
gopma	gåbmå	n	
čopma	tjåbmå	n	
forbma	fårmmå	n	
horbmá	hårmmå	n	
čorbma	tjårmmå	n	
norbma	nårmmå	n	
homma	håmmå	n	
hommá	håmmå	n	
ana^droma	ana^dråmå	n	
palin^droma	palen^dråmå	n	
syn^droma	syn^dråmå	n	
religi^ovdna	relege^åvnnå	n	
regi^ovdna	rege^åvnnå	n	
opini^ovdna	åpene^åvnnå	n	
uni^ovdna	une^åvnnå	n	
opponi^ovdna	åppune^åvnnå	n	
skorpi^ovdna	skårppe^åvnnå	n	
spi^ovdna	spi^åvnnå	n	
bovdna	båvnnå	n	
dovdna	dåvnnå	n	
klovdna	klåvnnå	n	
povdna	påvnnå	n	
vovdna	våvnnå	n	
nonná	nånnå	n	
tonna	tånnå	n	
dia^kona	dia^kånå	n	
sona	sånå	n	
tele^skohpa	tele^skåhpå	n	
mikro^skohpa	mikro^skåhpå	n	
steto^skohpa	steto^skåhpå	n	
knohpa	knåhpå	n	
dohppa	dåhppå	n	
gohppa	gåhppå	n	
kohppa	kåhppå	n	
epi^skohppa	epe^skåhppå	n	
oscillo^skohppa	åscello^skåhppå	n	
steto^skohppa	steto^skåhppå	n	
rohppa	råhppå	n	
krohppa	kråhppå	n	
tohppa	tåhppå	n	
sovppá	såvpå	n	
bohrra	båhrrå	n	
bovra	båvrrå	n	
movra	måvrrå	n	
borra	bårrå	n	
bovrra	båvrå	n	
bora	bårå	n	
fora	fårå	n	
čora	tjårå	n	
klora	klårå	n	
mora	mårå	n	
boksa	båkså	n	
goksa	gåkså	n	
koksa	kåkså	n	
loksa	låkså	n	
roksa	råkså	n	
molssa	målså	n	
korpsa	kårpså	n	
homsa	håmsså	n	
momsa	måmsså	n	
bronsa	brånsså	n	
gorsa	gårsså	n	
korsa	kårsså	n	
govsa	gåvsså	n	
sovsa	såvsså	n	
crossa	cråsså	n	
grossa	gråsså	n	
bozza	bådtså	n	
ohca	åhtså	n	
bokcá	båktså	n	
soica	såjttså	n	
coica	tsåjttså	n	
jocca	jåttså	n	
lovssa	låvså	n	
dia^gnosa	dia^gnåså	n	
prosa	pråså	n	
nohta	nåhtå	n	
kvohta	kvåhtå	n	
boršta	bårssjtå	n	
dokta	dåktå	n	
lokta	låktå	n	
mokta	måktå	n	
sokta	såktå	n	
goltá	gålltå	n	
skoltá	skålltå	n	
volta	vålltå	n	
tomta	tåmtå	n	
jortta	jårtå	n	
borsta	bårsstå	n	
horsta	hårsstå	n	
ovsta	åvsstå	n	
bostta	båstå	n	
gohttá	gåhttå	n	
skohtta	skåhttå	n	
bonta	bånttå	n	
fonta	fånttå	n	
sponta	spånttå	n	
bortá	bårttå	n	
gorta	gårttå	n	
korta	kårttå	n	
im^porta	im^pårttå	n	
sorta	sårttå	n	
čotta	tjåttå	n	
dovtta	dåvtå	n	
govva	gåvvå	n	
bitmap-govva	bitmap-gåvvå	n	
šovva	sjåvvå	n	
plova	plåvå	n	
moxa	måxå	n	
