várdudit	várddodit
abastit	abástit
addalit	addalit
addilit	addelit
addjohit	addjudit
adnostit	addnustit
ahcilit	ahtselit
aiihit	ajjdit
albmadit	almmadit
albmanit	almmanit
albmodit	almmudit
albmudit	almmodit
alddastit	aldastit
alfabehtadit	alffabehtadit
alidit	aledit
alistit	alestit
alludit	allodit
allánit	allánit
almmuhit	almodit
almmáskit	almáskit
amasmit	amásmit
amastit	amástit
amašit	amatjit
amiidit	amijdit
anašit	anatjit
anihit	anedit
anildit	aneldit
anistit	anestit
arggodit	argudit
arvilit	arvvelit
arvohit	arvvudit
arvvašit	arvatjit
arvve7stit	arvestit
arvvistit	arvestit
arvvohastalit	arvuhastalit
arvvosmit	arvusmit
arvváskit	arváskit
assudit	assodit
astadit	asstadit
asttahit	astadit
asásmit	asásmit
asášit	asátjit
attašit	attatjit
atte7stit	attestit
attihit	attedit
attildit	atteldit
attistit	attestit
avastit	avástit
azihit	atsedit
azistit	atsestit
aškkastit	asjkastit
badjánit	badjánit
bagadit	bagádit
bagenit	baginit
bagohit	bagudit
bahkkedit	bahkkidit
bahkkehit	bahkkidit
bahkkestit	bahkkistit
bahonit	bahunit
bahraidit	bahrajdit
bahtadit	bahtadit
bahudit	bahodit
bahánit	bahánit
bahčagit	bahtjagit
bahčašit	bahtjatjit
bahčiidit	bahtjijdit
bahčilit	bahtjelit
bahčistit	bahtjestit
bahčásit	bahtjásit
bahččostit	bahttjustit
baikkašit	bajkatjit
baikkihit	bajkedit
baiidit	bajjdit
baiás#boktalit	bajásbåktålit
baiás#dásidit	bajásdásedit
baiás#čuožžilit	bajástjuodtjelit
baiás#šaddadit	bajássjaddadit
bakkagit	bakkagit
baladit	baládit
balahit	baládit
baldalit	balldalit
balddihit	baldedit
balddáskit	baldáskit
balkkidit	balkedit
baláskit	baláskit
banašit	banatjit
banihit	banedit
banistit	banestit
barddašit	bardatjit
bardde7stit	bardestit
bardilit	barddelit
barffagit	barfagit
barffuhit	barfodit
barggadit	bargadit
barggahit	bargadit
barggastit	bargastit
barggildit	bargeldit
barjidit	barjjedit
bassodit	bassudit
basadit	basádit
basahit	basádit
basastit	basástit
basašit	basatjit
base7stit	basestit
basihit	basedit
basistit	basestit
baskkidit	baskedit
baskkášit	baskátjit
baskudit	basskodit
bassalit	bassalit
bastasit	basstasit
basttastit	bastastit
basttihit	bastedit
bastásit	basstásit
basuhit	basodit
basášit	basátjit
bažašit	batjatjit
baže7stit	batjestit
bažihit	batjedit
bažirdit	batjerdit
bažistit	batjestit
beafihit	biefedit
beagašit	biegatjit
beaggalit	bieggalit
beahkilit	biehkelit
beahte7stit	biehtestit
beahttalit	biehttalit
beaidadit	biejddadit
beaitalit	biejttalit
beaivádit	bæjvvádit
beakke7hit	biekkedit
beakkihit	biekkedit
beakko7hit	biekkodit
beakkuhit	biekkodit
bealaštit	bielasjtit
bealistitit	bielestitit
bealkilit	bielkkelit
bealkkašit	bielkatjit
bealkke7hit	bielkedit
bealkkihit	bielkedit
bealkkildit	bielkeldit
bealkkáskit	bælkáskit
bealkáhit	bælkkádit
beallidit	bielledit
bealljadit	bielljadit
bealuštit	bielosjtit
bearbbildit	bierbeldit
bearjjastit	bierjastit
beasadit	biesadit
beasahit	biesadit
beasihit	biesedit
beaskidit	biesskedit
beassadit	biessadit
beastalit	biesstalit
beavkalit	bievkkalit
beavkkuhit	bievkodit
beavkkádit	bævkádit
beavrruhit	bievrodit
beavránit	bævrránit
beavskalit	bievsskalit
beavskkuhit	bievskodit
beađadit	biedadit
beađahit	biedadit
beađđanit	bieddanit
beađđasit	bieddasit
beaškalit	biessjkalit
beaškke7hit	biesjkedit
beaškkihit	biesjkedit
beaškkuhit	biesjkodit
behtostit	behtustit
berehit	beridit
berostit	berustit
beroštit	berusjtit
bidjalit	bidjalit
bieggalit	bieggalit
bieggasit	bieggasit
bieguhit	biegodit
biegádit	biegádit
biehkanit	biehkanit
biehkulit	biehkolit
biehtadit	biehtadit
biehttalit	biehttalit
biekkadit	biekkadit
biekkahit	biekkadit
biekkastit	biekkastit
biepmadit	biebmadit
biepmastit	biebmastit
bierffagit	bierfagit
bierffuhit	bierfodit
bierfáhit	bierffádit
bierggastit	biergastit
biertnástit	biernástit
biestalit	biesstalit
bievladit	bievlladit
bievlladit	bievladit
bievssastit	bievsastit
bieđganit	biergganit
bieđáskit	biedáskit
bieđđalit	bieddalit
biggohit	biggudit
biggostit	biggustit
bihcudit	bihtsodit
bihkkadit	bihkkadit
bihtalit	bihtalit
biigostit	bijggustit
biinnidit	bijnedit
biiadit	bijádit
biiahit	bijádit
biiastit	bijástit
biktalit	biktalit
bikšulit	biksjolit
bilaidit	bilájdit
bildadit	billdadit
bilgádit	bilggádit
bilidit	biledit
bilistit	bilestit
biljagit	biljjagit
bilkidit	bilkkedit
billidit	billedit
billistit	billestit
billánit	billánit
bilppahit	bilpadit
bilttagit	biltagit
biltudit	billtodit
binddastit	bindastit
bindulit	binddolit
binjaidit	binjájdit
binnudit	binnodit
birastit	birástit
birccastit	birtsastit
birccostit	birtsustit
birgehit	birggidit
birgestit	birggistit
birihit	biredit
birostit	birustit
biršalit	birssjalit
bissehit	bissidit
bisihit	bisedit
biskkihit	biskedit
bissostit	bissustit
bissánit	bissánit
bisttašit	bistatjit
bistte7stit	bistestit
bisuhit	bisodit
bisánit	bisánit
bivaldit	biváldit
bivdalit	bivddalit
bivddašit	bivdatjit
bivdde7stit	bivdestit
bivddihit	bivdedit
bivddildit	bivdeldit
bivdduhit	bivdodit
bivdilit	bivddelit
bivssastit	bivsastit
bivttastit	bivtastit
bivtte7stit	bivtestit
bivššagit	bivsjagit
bivššihit	bivsjedit
bivššuhit	bivsjodit
bivššádit	bivsjádit
biđgedit	birggidit
biđgehit	birggidit
biđgestit	birggistit
biđggiidit	birgijdit
biđihit	bidedit
biđistit	bidestit
biđuhit	bidodit
biškkihit	bisjkedit
biškkodit	bisjkudit
biškkuhit	bisjkodit
biškkádit	bisjkádit
bloggestit	blåggistit
bláđedit	bládidit
boaccastit	boattsastit
boaggulit	boaggolit
boagustit	boagostit
boahkkudit	boahkkodit
boahkkulit	boahkkolit
boahko7hit	boahkodit
boahko7stit	boahkostit
boahkuhit	boahkodit
boahtalit	boahtalit
boaibmulit	boajmmolit
boaimmastit	boajmastit
boaimmo7stit	boajmostit
boaimmuhit	boajmodit
boaimmádit	boajmádit
boakkagit	boakkagit
boakkastit	boakkastit
boakko7stit	boakkostit
boakkuhit	boakkodit
boakčánit	boaktjánit
boalbasit	boalbbasit
boalbbastit	boalbastit
boalddašit	boaldatjit
boaldde7stit	boaldestit
boalddihit	boaldedit
boalggahit	boalgadit
boaluhit	boalodit
boalčasit	boalttjasit
boalččihit	boaltjedit
boalččuhit	boaltjodit
boarkkasmit	boarkasmit
boarskudit	boarsskodit
boarásmit	boarásmit
boarášit	boarátjit
boatkanit	boatkanit
boađadit	bådadit
boađe7stit	boadestit
boađihit	boadedit
boađistit	boadestit
boccihit	båttsedit
bocciidit	båttsijdit
bodnjasit	båddnjåsit
bogahit	bågådit
boggalit	båggålit
boggádit	båggådit
boggáhit	båggådit
bohciidit	båhtsijdit
bohkasit	båhkåsit
bohkastit	båhkåstit
bohkosit	båhkusit
bohraidit	båhråjdit
bohrihit	båhredit
bohruhit	båhrodit
bohtanit	båhtånit
bohttehit	båhttidit
bohčilit	båhtjelit
bohčásit	båhtjåsit
boimmodit	båjmudit
bokkihit	båkkedit
bokkuhit	båkkodit
boktalit	båktålit
boktilit	båktelit
bolastit	bålåstit
bolffagit	bålfågit
bolffuhit	bålfodit
bolohastit	båluhastit
boltasit	bålltåsit
bolttastit	båltåstit
bolttodit	båltudit
bolttuhit	båltodit
bommehit	båmmidit
bonašit	bånåtjit
bonihit	bånedit
bonistit	bånestit
bonjadit	bånjådit
bonjagit	bånjågit
bonjahit	bånjådit
bonjastit	bånjåstit
bontahit	bånttådit
boradit	bårådit
borahit	bårådit
borastit	båråstit
borddašit	bårdåtjit
bordde7stit	bårdestit
bordilit	bårddelit
borgalit	bårggålit
borggadit	bårgådit
borggahit	bårgådit
borggastit	bårgåstit
borggihit	bårgedit
borggiidit	bårgijdit
borggistit	bårgestit
borgguhit	bårgodit
borgohit	bårggudit
borgostit	bårggustit
borgádit	bårggådit
borgáhit	bårggådit
borjjastit	bårjåstit
borjánit	bårjjånit
borralit	bårrålit
borvedit	bårvvidit
boršalit	bårssjålit
borššihit	bårsjedit
borššodit	bårsjudit
borššuhit	bårsjodit
borššádit	bårsjådit
bosastit	båsåstit
bosihit	båsedit
bosihastit	båsehastit
bosistit	båsestit
bosodit	båsudit
boso7stit	båsostit
bossulit	båssolit
bostalit	båsstålit
bosttahit	båstådit
bosuhit	båsodit
bosádit	båsådit
botkalit	båtkålit
botkehit	båtkidit
botkestit	båtkistit
botkkiidit	båtkkijdit
botkkistit	båtkkestit
botkkodit	båtkkudit
botkkuhit	båtkkodit
botnjalit	bådnjålit
botnjasit	bådnjåsit
bottiidit	båttijdit
bovdehit	båvddidit
bovdestit	båvddistit
bovnnjistit	båvnjestit
bovskkihit	båvskedit
bovttašit	båvtåtjit
bovttihit	båvtedit
bođastit	bådåstit
bođaštit	bådåsjtit
bođđanit	båddånit
boŋkalit	båŋkkålit
boŋkkihit	båŋkedit
boŋkkuhit	båŋkodit
bože7stit	båtjestit
božihit	båtjedit
božistit	båtjestit
buggasit	buggasit
buggánit	buggánit
buhtadit	buhtadit
buhtistit	buhtestit
buhtásmit	buhtásmit
buhtášit	buhtátjit
buhčásit	buhtjásit
buiccuhit	bujtsodit
buiddodit	bujdudit
buikkihit	bujkedit
buimmadit	bujmadit
buippihit	bujpedit
buktalit	buktalit
buktilit	buktelit
bullehit	bullidit
bulddagit	buldagit
buljagit	buljjagit
buljardit	buljjardit
buljihit	buljjedit
bulljasit	bulljasit
bulčulit	bulttjolit
bulččihit	bultjedit
bulžudit	bulltjodit
bumppistit	bumpestit
bunccagit	buntsagit
bunccardit	buntsardit
bunccastit	buntsastit
bunccistit	buntsestit
bunculit	bunttsolit
bunjadit	bunjádit
bunjaidit	bunjájdit
bunjodit	bunjudit
bunjádit	bunjádit
bunzzardit	buntsardit
bunčalit	buntjalit
bunččihit	bunttjedit
bunžalit	bunttjalit
bunžáhit	bunttjádit
bunžžuhit	buntjodit
buoccihit	buottsedit
buohccin#dieđihit	buohttsendiededit
buohccádit	buohttsádit
buohccáhit	buohttsádit
buohccástit	buohttsástit
buohtastahttalit	buohtastahttalit
buoiddášit	buojdátjit
buoidudit	buojddodit
buoidulit	buojddolit
buoimmastit	buojmastit
buokčalit	buoktjalit
buollahit	buolladit
buolláhit	buolládit
buolašit	buolatjit
buolaštit	buolasjtit
buole7stit	buolestit
buollilit	buollelit
buolvvastit	buolvastit
buoláskit	buoláskit
buonjo7stit	buonjostit
buonjuhit	buonjodit
buonjustit	buonjostit
buorahit	buoradit
buoredit	buoridit
buoridit	buoredit
buorren#dohkkehit	buorrindåhkkidit
buorre7stit	buorrestit
buorrin#dohkkehit	buorrendåhkkidit
buorránit	buorránit
buoruštit	buorosjtit
buorástahttalit	buorástahttalit
buorášit	buorátjit
buotnjulit	buodnjolit
buovadit	buovadit
buovnnjagit	buovnjagit
buovnnjistit	buovnjestit
buovttahit	buovtadit
buovvalit	buovvalit
buovččadit	buovtjadit
buovččahit	buovtjadit
buozadit	buotsadit
buozahit	buotsadit
buozastit	buotsastit
buođuhit	buododit
buođđudit	buoddodit
buođđulit	buoddolit
buošášit	buotjátjit
buoššo7dit	buossjodit
buoššudit	buossjodit
buoššulit	buossjolit
bures#sivdnidit	burissivnnedit
burggihit	burgedit
burgilit	burggelit
burgásit	burggásit
burskkihit	burskedit
burtanit	burttanit
busidit	busedit
busildit	buseldit
buskkihit	buskedit
buskáhit	busskádit
buvvodit	buvvudit
buvgadit	buvggadit
buvihit	buvedit
buvttadit	buvtadit
buvttašit	buvtatjit
buvtte7hit	buvtedit
buvtte7stit	buvtestit
buvttihit	buvtedit
buvvánit	buvvánit
buđaldit	budáldit
buđodit	bududit
buđđosit	buddusit
buškalit	bussjkalit
buškke7hit	busjkedit
buškkihit	busjkedit
bušttašit	busjtatjit
bužistit	butjestit
bábirdit	báberdit
báddadit	báddadit
báddasit	báddasit
báfaidit	báfájdit
báfidit	báfedit
bággehit	bággidit
bággo#lonistit	bággolånestit
bágirdit	bágerdit
báhcadit	báhtsadit
báhcahit	báhtsadit
báhcilit	báhtselit
báhkadit	báhkadit
báhkašit	báhkatjit
báhkistit	báhkestit
báhkkanit	báhkkanit
báhkkodit	báhkkudit
báhraidit	báhrajdit
báhtarit	báhtarit
báhčalit	báhtjalit
báhčilit	báhtjelit
báinnagit	bájnagit
báinnašit	bájnatjit
báinne7stit	bájnestit
báinnihit	bájnedit
báisadit	bájssadit
báiskásit	bájsskásit
báitalit	bájttalit
báitilit	bájttelit
báito7hit	bájttodit
báitostit	bájttustit
báittašit	bájtatjit
báitte7stit	bájtestit
báittihit	bájtedit
báiadit	bájádit
báiuhit	bájodit
bákko7hit	bákkodit
bákkuhit	bákkodit
bállehit	bállidit
bálašit	bálatjit
bálgalit	bálggalit
bálggadit	bálgadit
bálggahit	bálgadit
báljagit	báljjagit
báljildit	báljjeldit
bálkestahttalit	bálkkistahttalit
bálkestit	bálkkistit
bálkkastit	bálkastit
bálkkašit	bálkatjit
bálkkodit	bálkudit
bálkulit	bálkkolit
bálkádit	bálkkádit
bálkáhit	bálkkádit
bálkásit	bálkkásit
bállahastalit	bállahastalit
báltudit	bálltodit
bálvalit	bálvvalit
bálvvuštit	bálvosjtit
báládit	báládit
bánccardit	bántsardit
bánžadit	bánttjadit
bánžžagit	bántjagit
bánžžistit	bántjestit
bárddašit	bárdatjit
bárdde7stit	bárdestit
bárdilit	bárddelit
bárgguhit	bárgodit
bárggádit	bárgádit
bárgidit	bárggedit
bárjidit	bárjjedit
bárrudit	bárrodit
bártidit	bárttedit
bártiidit	bárttijdit
bárttáskit	bártáskit
bárustit	bárostit
bátnádit	bádnádit
báttastit	báttastit
báttástit	báttástit
bávkalit	bávkkalit
bávkke7hit	bávkedit
bávkkihit	bávkedit
bávkkuhit	bávkodit
bávččagahttalit	bávtjagahttalit
bávččagit	bávtjagit
bávččastit	bávtjastit
bázadit	bátsádit
bázahit	bátsádit
báze7stit	bátsestit
bázihit	bátsedit
bázistit	bátsestit
báŋadit	báŋádit
báŋahit	báŋádit
báŋádit	báŋádit
bážašit	bátjatjit
báže7stit	bátjestit
bážihit	bátjedit
bážistit	bátjestit
caddjodit	tsaddjudit
cadjasit	tsadjasit
cadjásit	tsadjásit
cagahit	tsagádit
caggasit	tsaggasit
cahkiidit	tsahkijdit
cahkkanit	tsahkkanit
cahkkehit	tsahkkidit
caiašit	tsajatjit
cakkadit	tsakkadit
cakkastit	tsakkastit
canccastit	tsantsastit
canccodit	tsantsudit
cavgge7stit	tsavgestit
cavgguhit	tsavgodit
cavgilit	tsavggelit
cavihit	tsavedit
cavkkihit	tsavkedit
ceaggadit	tsieggadit
ceaggahit	tsieggadit
ceagganit	tsiegganit
ceaggasit	tsieggasit
ceaggádit	tsæggádit
ceaggáhit	tsæggádit
ceahkastit	tsiehkastit
ceahkuhit	tsiehkodit
ceakkagit	tsiekkagit
ceakkastit	tsiekkastit
ceakkildit	tsiekkeldit
ceakkuhit	tsiekkodit
cealkalit	tsielkkalit
cealkilit	tsielkkelit
cealkkašit	tsielkatjit
cealkke7stit	tsielkestit
cealkkihit	tsielkedit
ceggestit	tseggistit
cehkodit	tsehkudit
cekkiidit	tsekkijdit
cekkosmit	tsekkusmit
cibmalit	tsibbmalit
ciebahit	tsiebadit
ciebastit	tsiebastit
cieggadit	tsieggadit
ciekkadit	tsiekkadit
ciekkahit	tsiekkadit
ciekkastit	tsiekkastit
ciekke7hit	tsiekkedit
cieladit	tsieladit
cielahit	tsieladit
cielihit	tsieledit
cielkkistit	tsielkestit
cieládit	tsieládit
cihlaidit	tsihlajdit
cihppošit	tsihpputjit
cihradit	tsihradit
cihraidit	tsihrajdit
cihrádit	tsihrádit
cikcasit	tsiktsasit
cilahit	tsiládit
cilaidit	tsilájdit
cilihit	tsiledit
cilkkiidit	tsilkijdit
cimirdit	tsimerdit
cinnuhit	tsinnodit
cipmastit	tsibmastit
cirbmasit	tsirmmasit
cirgalit	tsirggalit
cirgge7hit	tsirgedit
cirgguhit	tsirgodit
cirkkuhit	tsirkodit
cirpmastit	tsirmastit
ciskkihit	tsiskedit
cissadit	tsissadit
cissahit	tsissadit
cissastit	tsissastit
cissuhit	tsissodit
civccastit	tsivttsastit
civccodit	tsivttsudit
civccuhit	tsivttsodit
civkalit	tsivkkalit
civkkašit	tsivkatjit
civkkistit	tsivkestit
civkkuhit	tsivkodit
civkkádit	tsivkádit
civnnagit	tsivnagit
civnniidit	tsivnijdit
civzzagit	tsivtsagit
civzziidit	tsivtsijdit
cizašit	tsitsatjit
cizihit	tsitsedit
coabmasit	tsoabbmasit
coago7stit	tsoagostit
coaguhit	tsoagodit
coagášit	tsoagátjit
coahkašit	tsoahkatjit
coahke7hit	tsoahkedit
coahkkalit	tsoahkkalit
coahkudit	tsoahkodit
coahkuhit	tsoahkodit
coahkulit	tsoahkolit
coakcudit	tsoaktsodit
coggalit	tsåggålit
cohcagit	tsåhtsågit
cohkkodit	tsåhkkudit
cohkkohit	tsåhkkudit
coicalit	tsåjttsålit
coiccistit	tsåjtsestit
coiccuhit	tsåjtsodit
coiccáskit	tsåjtsåskit
cokkadit	tsåkkådit
cubadit	tsubádit
cubistit	tsubestit
cuhcásit	tsuhtsásit
cuhladit	tsuhladit
cuhlaidit	tsuhlajdit
cuhlihit	tsuhledit
cuiggodit	tsujgudit
cuilalit	tsujlalit
cuiláhit	tsujládit
cuippihit	tsujpedit
culláhit	tsulládit
cummestit	tsummistit
cummistit	tsummestit
cuoccagit	tsuottsagit
cuovkanit	tsuovkkanit
cuovkkuhit	tsuovkodit
cuoŋudit	tsuoŋodit
cussalit	tsussalit
cuskilit	tsusskelit
cuskkašit	tsuskatjit
cuskke7stit	tsuskestit
cuskkihit	tsuskedit
cussuhit	tsussodit
cuvccastit	tsuvttsastit
cuvistit	tsuvestit
cuvkalit	tsuvkkalit
cuvkehit	tsuvkkidit
cuvkkihit	tsuvkedit
cuvkkodit	tsuvkudit
cuvkkuhit	tsuvkodit
cuvkkádit	tsuvkádit
cuŋkalit	tsuŋkkalit
cábadit	tsábádit
cábahit	tsábádit
cábastit	tsábástit
cábmilit	tsábbmelit
cáhcasit	tsáhtsasit
cáhkastit	tsáhkastit
cáhpalit	tsáhpalit
cáiccagit	tsájtsagit
cáiccistit	tsájtsestit
cáiccáskit	tsájtsáskit
cáicudit	tsájttsodit
cákcasit	tsáktsasit
cápmašit	tsábmatjit
cázastit	tsátsástit
dadjalit	dadjalit
dagadit	dagádit
dagahit	dagádit
daguhit	dagodit
dahkalit	dahkalit
dahppasit	dahppasit
dahraidit	dahrajdit
daiadit	dajádit
daiahaladit	dajáhaladit
daiahastalit	dajáhastalit
dallodit	dalludit
dalggodit	dalgudit
dalkkihit	dalkedit
daraidit	darájdit
darihit	daredit
darvalit	darvvalit
darvehit	darvvidit
darvvihit	darvedit
darvviidit	darvijdit
darvánit	darvvánit
dasadit	dasádit
dasašit	dasatjit
dassalit	dassalit
davidit	davedit
davkadit	davkkadit
davkasit	davkkasit
davkkadit	davkadit
davkkastit	davkastit
davkkildit	davkeldit
davrragit	davragit
davvánit	davvánit
daŋastit	daŋástit
daškanit	dassjkanit
daškkodit	dasjkudit
deabardit	diebardit
deabirdit	dieberdit
deadde7lit	dieddelit
deaddilit	dieddelit
deadduhit	dieddodit
deaddásit	dæddásit
deadnjasit	dieddnjasit
deahpanit	diehpanit
deahpánit	dæhpánit
deahtistit	diehtestit
deaimmáskit	dæjmáskit
deaividit	diejvvedit
deaivvadit	diejvadit
deaivvahit	diejvadit
deaiihit	diejjdit
deakčasit	diektjasit
deallardit	diellardit
deamaidit	diemajdit
deamihit	diemedit
deamppuhit	diempodit
deampulit	diemppolit
deamssuhit	diemsodit
deanjálgit	dænjálgit
dearahit	dieradit
dearbbadit	dierbadit
dearistit	dierestit
dearpalit	dierppalit
dearppahit	dierpadit
dearppastit	dierpastit
dearridit	dierredit
dearvvahit	diervadit
dearvvašit	diervatjit
deattastit	diettastit
deattašit	diettatjit
deattihit	diettedit
deattuhit	diettodit
deavdalit	dievddalit
deavddašit	dievdatjit
deavddihit	dievdedit
deavdilit	dievddelit
deavirdit	dieverdit
deavččastit	dievtjastit
deađvasit	diervvasit
deaŋggaštit	dieŋgasjtit
deaškalit	diessjkalit
deaškanit	diessjkanit
deaškasit	diessjkasit
deaškkastit	diesjkastit
deaškke7hit	diesjkedit
deaškkihit	diesjkedit
deaškkuhit	diesjkodit
deašášit	dætjátjit
deaššastit	diessjastit
delodit	deludit
devdnedit	devnnidit
devkkodit	devkudit
devččodit	devtjudit
deškkodit	desjkudit
diebbánit	diebbánit
diehpagit	diehpagit
diehtalit	diehtalit
dielladit	dielladit
dielvvásmit	dielvásmit
dienidit	dienedit
dieppidit	dieppedit
dierdidit	dierddedit
dieskkardit	dieskardit
dievihit	dievedit
dieđihit	diededit
dieđuštit	diedosjtit
digaštit	digasjtit
diggedit	diggidit
dihkkadit	dihkkadit
dihkkedit	dihkkidit
dihkkádit	dihkkádit
dihkádit	dihkádit
dihraidit	dihrajdit
dihtoštit	dihtusjtit
diiddastit	dijdastit
dikkáskit	dikkáskit
dilddiidit	dildijdit
dilddistit	dildestit
dildduhit	dildodit
dilssášit	dilsátjit
diládit	diládit
dimihit	dimedit
dimiidit	dimijdit
dimistit	dimestit
dimášit	dimátjit
dinodit	dinudit
dipmadit	dibmadit
diraidit	dirájdit
dirbbodit	dirbudit
dirkke7hit	dirkedit
dirrulit	dirrolit
dirččuhit	dirtjodit
divodit	divudit
divrrašit	divratjit
divrudit	divrrodit
divskkodit	divskudit
divskkádit	divskádit
divttistit	divtestit
divttásmit	divtásmit
divttášit	divtátjit
divuhit	divodit
divustit	divostit
divvulit	divvolit
divššodit	divsjudit
divššuhit	divsjodit
diđoštit	didusjtit
diškalit	dissjkalit
diškasit	dissjkasit
diškkastit	disjkastit
diškkodit	disjkudit
diškkuhit	disjkodit
diškkádit	disjkádit
diškulit	dissjkolit
doabastit	dåbastit
doadjalit	doadjalit
doadjasit	doadjasit
doadjilit	doadjelit
doadjásit	doadjásit
doahkkudit	doahkkodit
doahppádit	doahppádit
doahpulit	doahpolit
doahttalit	doahttalit
doaibmidit	doajmmedit
doaimmahit	doajmadit
doaivvuhit	doajvodit
doaivváskit	doajváskit
doaiašit	dåjatjit
doaie7stit	doajestit
doaiihit	doajjdit
doaladit	dåladit
doalahit	dåladit
doallánit	doallánit
doalvalit	doalvvalit
doalvulit	doalvvolit
doalvvuhit	doalvodit
doalvvástit	doalvástit
doamahit	dåmadit
doamihit	doamedit
doapmalit	doabmalit
doapmidit	doabmedit
doarggistit	doargestit
doaristit	doarestit
doarjalit	doarjjalit
doarjjuhit	doarjodit
doaro7stit	doarostit
doarre7dit	doarredit
doarridit	doarredit
doarssuhit	doarsodit
doaruhit	doarodit
doaráskit	doaráskit
doarškalit	doarssjkalit
doarškkihit	doarsjkedit
doavkkášit	doavkátjit
doavskalit	doavsskalit
doavskkašit	doavskatjit
doavskkuhit	doavskodit
doaččihit	doattjedit
doaŋgudit	doaŋggodit
doaškalit	doassjkalit
doaškkihit	doasjkedit
doažžudit	doadtjodit
dobadit	dåbådit
dobbánit	dåbbånit
dobodit	dåbudit
doddjohit	dåddjudit
dodjalit	dådjålit
dohkasmit	dåhkåsmit
dohkkehit	dåhkkidit
dohppehit	dåhppidit
dohppestit	dåhppistit
dohraidit	dåhråjdit
doiddašit	dåjdåtjit
doidde7stit	dåjdestit
doidilit	dåjddelit
doidásit	dåjddåsit
doivvodit	dåjvudit
doiadit	dåjådit
dokŋadit	dågŋådit
dollehit	dållidit
dollestit	dållistit
dolastit	dålåstit
doldudit	dålldodit
dolkadit	dålkkådit
dolkalit	dålkkålit
dolkkihit	dålkedit
dolvviidit	dålvijdit
dolvvodit	dålvudit
doppidit	dåppedit
dorrehit	dårridit
dorránit	dårrånit
dorggiidit	dårgijdit
dorjestit	dårjjistit
dorjjodit	dårjudit
dorodit	dårudit
dorranit	dårrånit
dorvvastit	dårvåstit
dorvádit	dårvvådit
dossádit	dåssådit
dovadit	dåvådit
dovddadit	dåvdådit
dovddahit	dåvdådit
dovddastit	dåvdåstit
dovddiidit	dåvdijdit
dovdáhit	dåvddådit
dovkošit	dåvkkutjit
dovskkihit	dåvskedit
dovskkodit	dåvskudit
dovssihit	dåvsedit
doškestit	dåssjkistit
doškkodit	dåsjkudit
dudjohit	dudjudit
duhastit	duhástit
duhaštit	duhasjtit
duhkuštit	duhkosjtit
duhppestit	duhppistit
duhppádit	duhppádit
duhrahit	duhradit
duhraidit	duhrajdit
duhrihit	duhredit
duhtadit	duhtadit
duihmudit	dujhmmodit
duikudit	dujkkodit
duippidit	dujpedit
duivvidit	dujvedit
duksanit	duksanit
dulbestit	dulbbistit
duldehit	dulldidit
dulmmodit	dulmudit
dulppagit	dulpagit
dulvadit	dulvvadit
dulvalit	dulvvalit
dulvvastit	dulvastit
dulvvášit	dulvátjit
dumssagit	dumsagit
dunttardit	duntardit
duobadit	duobadit
duobbánit	duobbánit
duoddudit	duoddodit
duodjidit	duodjedit
duoggudit	duoggodit
duogurdit	duogordit
duoguštit	duogosjtit
duohoštit	duohusjtit
duohpalit	duohpalit
duohpanit	duohpanit
duohtadit	duohtadit
duoittardit	duojtardit
duokŋadit	duogŋadit
duolbbagit	duolbagit
duolbbasin#jorahit	duolbasinjårådit
duolbbasmit	duolbasmit
duolbbihit	duolbedit
duolbmalit	duolmmalit
duoldalit	duolldalit
duolddadit	duoldadit
duolddahit	duoldadit
duolddašit	duoldatjit
duolddihit	duoldedit
duolmmadit	duolmadit
duolmmahit	duolmadit
duolmmastit	duolmastit
duolvadit	duolvvadit
duolvvašit	duolvatjit
duolvvidit	duolvedit
duoppidit	duoppedit
duoradit	duoradit
duorbalit	duorbbalit
duorgadit	duorggadit
duorggastit	duorgastit
duorralit	duorralit
duorššagit	duorsjagit
duovgudit	duovggodit
duođaldit	duodaldit
duođastit	duodastit
duođaštit	duodasjtit
duppardit	duppardit
durahit	durádit
durbbodit	durbudit
durddidit	durdedit
durdudit	durddodit
durskkuhit	durskodit
duskidit	dusskedit
dusttodit	dustudit
dutkkadit	dutkkadit
dutkkahit	dutkkadit
duvddašit	duvdatjit
duvdelit	duvddilit
duvdilit	duvddelit
duvhllidit	duvhledit
duvkkiidit	duvkijdit
duvkkistit	duvkestit
duđahit	dudádit
duđaidit	dudájdit
duđgalit	durggalit
duđihit	dudedit
duššadit	dussjadit
duškalit	dussjkalit
duškidit	dussjkedit
duššášit	dussjátjit
dábbánit	dábbánit
dábildit	dábeldit
dábistit	dábestit
dábuhit	dábodit
dábástit	dábástit
dádjadit	dádjadit
dággudit	dággodit
dáguhit	dágodit
dáhkadit	dáhkadit
dáhkidit	dáhkedit
dáhpádit	dáhpádit
dáhtodit	dáhtudit
dáidnádit	dájnnádit
dáiggášit	dájgátjit
dáigudit	dájggodit
dáikkihit	dájkedit
dáikkáskit	dájkáskit
dáistalit	dájsstalit
dáiodit	dájudit
dáiuhit	dájodit
dáiáskit	dájáskit
dáktadit	dáktadit
dálledit	dállidit
dálkkastit	dálkastit
dálkkodit	dálkudit
dállastit	dállastit
dálludit	dállodit
dálvvadit	dálvadit
dálvádit	dálvvádit
dáláštit	dálásjtit
dámadit	dámádit
dámahit	dámádit
dánccadit	dántsadit
dánccastit	dántsastit
dánirdit	dánerdit
dánsestit	dánssistit
dápmasit	dábmasit
dáppidit	dáppedit
dáraidit	dárájdit
dárbbahit	dárbadit
dárbbašit	dárbatjit
dárihit	dáredit
dárjjodit	dárjudit
dárjudit	dárjjodit
dárkkistit	dárkestit
dárkkodit	dárkudit
dárkko7hit	dárkodit
dárkkuhit	dárkodit
dárkostit	dárkkustit
dáro7stit	dárostit
dárránit	dárránit
dárustit	dárostit
dáráskit	dáráskit
dássidit	dássedit
dássánit	dássánit
dásásmit	dásásmit
dávggasmit	dávgasmit
dávggastit	dávgastit
dávgudit	dávggodit
dávistit	dávestit
dávjjidit	dávjedit
dávjudit	dávjjodit
dávjánit	dávjjánit
dávžžadit	dávtjadit
dáđđudit	dáddodit
dáškkidit	dásjkedit
eaddudit	ieddodit
eadjalit	iedjalit
eahpe7basuhit	iehpebasudit
eahpidit	iehpedit
eaibmidit	iejmmedit
eaibmudit	iejmmodit
eaidadit	iejddadit
eaiggádastalit	æjgádastalit
eaiggádit	æjgádit
eaippildit	iejpeldit
eaktudit	iektodit
ealláhit	ælládit
ealašit	ielatjit
ealihit	ieledit
ealjuhit	ieljjodit
eallásit	ællásit
ealáskit	æláskit
eamidastalit	iemedastalit
eane7dit	ienedit
eanne7hit	iennedit
eannáhit	ænnádit
eanášit	ænátjit
eardudit	ierddodit
earránit	ærránit
earuhit	ierodit
eastadit	iesstadit
eastalit	iesstalit
easttadit	iestadit
eatne7hit	iednedit
eatnánit	ædnánit
eatte7hit	iettedit
eattihit	iettedit
eavttuhit	ievtodit
eaškálit	æssjkálit
einnostit	ejnustit
ellohit	elludit
ellosit	ellusit
eloštit	elusjtit
ennostit	ennustit
ettodit	ettudit
evttohit	evtudit
faggasit	faggasit
fakkastit	fakkastit
fakŋalit	fagŋalit
fallehit	fallidit
falášit	falátjit
fanadit	fanádit
fanahit	fanádit
faskasit	fasskasit
faskkastit	faskastit
faskkestit	faskistit
faskkodit	faskudit
faskulit	fasskolit
fastošit	fasstutjit
fasttášit	fastátjit
fastudit	fasstodit
fatnalit	fadnalit
fatnasit	fadnasit
fađastit	fadástit
fađustit	fadostit
faŋkkagit	faŋkagit
faŋuhit	faŋodit
faŋádit	faŋádit
fearkkastit	fierkastit
fearkulit	fierkkolit
feasttašit	fiestatjit
feastásit	fæsstásit
fereštit	ferisjtit
ferkkodit	ferkudit
fidnehit	fiddnidit
fidnošit	fiddnutjit
fielladit	fielladit
fieradit	fieradit
fierahit	fieradit
fiergádit	fierggádit
fierihit	fieredit
fierpmástit	fiermástit
fierradit	fierradit
fierralit	fierralit
fierttudit	fiertodit
fievrasit	fievrrasit
fievrre7dit	fievredit
fievrridit	fievredit
fiidnudit	fijnnodit
fiinnidit	fijnedit
fiinnuhit	fijnodit
fikkahit	fikkadit
fillestit	fillistit
filé^astit	filé^astit
finadit	finádit
finahit	finádit
finihit	finedit
finjagit	finjágit
finjildit	finjeldit
firrestit	firristit
firrohit	firrudit
firodit	firudit
firtestit	firttistit
fiskahit	fisskadit
fiskkihit	fiskedit
fiskkodit	fiskudit
fiskánit	fisskánit
fiŋgasit	fiŋggasit
fiŋggihit	fiŋgedit
fiŋggodit	fiŋgudit
fiškalit	fissjkalit
fiškasit	fissjkasit
fiškkardit	fisjkardit
fiškkihit	fisjkedit
friskkodit	friskudit
fuikkodit	fujkudit
fuoikkahit	fuojkadit
fuoikkádit	fuojkádit
fuoladit	fuoladit
fuolahit	fuoladit
fuomihit	fuomedit
fuomášit	fuomátjit
fuonidit	fuonedit
fuonášit	fuonátjit
fuopmášit	fuobmátjit
fuorjjášit	fuorjátjit
fuorástit	fuorástit
fuotnánit	fuodnánit
fuođardit	fuodardit
furkkodit	furkudit
furrošit	furrutjit
fággádit	fággádit
fáipasit	fájppasit
fáippastit	fájpastit
fáippihit	fájpedit
fáippodit	fájpudit
fáippádit	fájpádit
fákkáskit	fákkáskit
fáktorastit	fákturastit
fáladit	fáládit
fálbme7#bealástit	fálmmebælástit
fállalit	fállalit
fáluhit	fálodit
fápmudit	fábmodit
fárrehit	fárridit
fárrestit	fárristit
fárgehit	fárggidit
fárrudit	fárrodit
fáruhit	fárodit
fástidit	fásstedit
fásttostit	fástustit
fástudit	fásstodit
fátmmastit	fátmmastit
fátmmodit	fátmmudit
fávledit	fávllidit
fávllidit	fávledit
fávlánit	fávllánit
fávrrosmit	fávrusmit
fávrrošit	fávrutjit
fáđahit	fádádit
fáđašit	fádatjit
fáškalit	fássjkalit
fáškasit	fássjkasit
fáškkardit	fásjkardit
fáškkastit	fásjkastit
fáškkihit	fásjkedit
gabihit	gabedit
gaccahit	gattsadit
gaccastit	gattsastit
gaccaštit	gattsasjtit
gacce7stit	gattsestit
gaccirdit	gattserdit
gaccodit	gattsudit
gaccuhit	gattsodit
gahkkudit	gahkkodit
gahpádit	gahpádit
gahridit	gahredit
gahčadit	gahtjadit
gahčahit	gahtjadit
gahčalit	gahtjalit
gaibadit	gajbbadit
gaidnadit	gajnnadit
gaikke7hit	gajkedit
gaikkihit	gajkedit
gaikkistit	gajkestit
gaikkodit	gajkudit
gaikkuhit	gajkodit
gaikkádit	gajkádit
gaikodit	gajkkudit
gaikánit	gajkkánit
gaikásit	gajkkásit
gaivvihit	gajvedit
gakculit	gaktsolit
galledit	gallidit
gallehit	gallidit
gallánit	gallánit
galbbastit	galbastit
galbmodit	galmmudit
galje7dit	galjjedit
galjidit	galjjedit
galkadit	galkkadit
galkkadit	galkadit
galljudit	galljodit
galljánit	galljánit
galmmadit	galmadit
galmmašit	galmatjit
galmme7stit	galmestit
galmmihit	galmedit
galmmiidit	galmijdit
galmmistit	galmestit
gamardit	gamárdit
ganastit	ganástit
ganjaldit	ganjáldit
garadit	garádit
garahit	garádit
garašit	garatjit
garcasit	garttsasit
garccastit	gartsastit
garcestit	garttsistit
gardásit	garddásit
gargalit	garggalit
garggistit	gargestit
gargguhit	gargodit
garihit	garedit
garistit	garestit
garppuhit	garpodit
garradit	garradit
garrudit	garrodit
garuhit	garodit
garvilit	garvvelit
garvvašit	garvatjit
garvve7stit	garvestit
garvvihit	garvedit
garvásit	garvvásit
gassalit	gassalit
gaskkašit	gaskatjit
gaskkustit	gaskostit
gassudit	gassodit
gassuhit	gassodit
gasttihit	gastedit
gasášit	gasátjit
gavašit	gavatjit
gavccodit	gavttsudit
gavccádit	gavttsádit
gavdnjalit	gavnnjalit
gavihit	gavedit
gavistit	gavestit
gavjehit	gavjjidit
gavjjuhit	gavjodit
gavnnjastit	gavnjastit
gavvardit	gavvardit
gavvásit	gavvásit
gavžžahit	gavtjadit
gavžžašit	gavtjatjit
gavžžihit	gavtjedit
gazirdit	gatserdit
gazzasit	gadtsasit
gaŋgguhit	gaŋgodit
gaŋkestit	gaŋkkistit
gaŋkkagit	gaŋkagit
gaškkihit	gasjkedit
gažadit	gatjádit
gažahit	gatjádit
geaccidit	giettsedit
geafášit	gæfátjit
geagadit	giegadit
geagihit	giegedit
geahcalit	giehtsalit
geahpadit	giehpadit
geahpasmit	giehpasmit
geahpašit	giehpatjit
geahpe7dit	giehpedit
geahpe7hit	giehpedit
geahpidit	giehpedit
geahpihit	giehpedit
geahppudit	giehppodit
geahppánit	gæhppánit
geahpášit	gæhpátjit
geahčadit	giehtjadit
geahčahit	giehtjadit
geahčastit	giehtjastit
geahče7stit	giehtjestit
geahččalit	giehttjalit
geaigahit	giejggadit
geaiganit	giejgganit
geaigasit	giejggasit
geaiggagit	giejgagit
geaigguhit	giejgodit
geaivalit	giejvvalit
geaktidit	giektedit
gealašit	gielatjit
gealbidit	gielbbedit
gealbudit	gielbbodit
gealdduhit	gieldodit
geamppašit	giempatjit
geanašit	gienatjit
gearadit	gieradit
gearahit	gieradit
gearddahit	gierdadit
gearddastit	gierdastit
geardduhit	gierdodit
geargadit	gierggadit
gearggadit	giergadit
gearggahit	giergadit
geargge7hit	giergedit
gearggihit	giergedit
gearggusin#meannudit	giergosinmiennodit
gearjidit	gierjjedit
geassastit	giessastit
geasašit	giesatjit
gease7hit	giesedit
geasihit	giesedit
geaskuhit	giesskodit
geassastit	giessastit
geassádit	gæssádit
geassásit	gæssásit
geasuhit	giesodit
geasástit	gæsástit
geavahit	gievadit
geavjadit	gievjjadit
geavlidit	gievlledit
geavránit	gævrránit
geavvadit	gievvadit
geazadit	gietsadit
geađgádit	gærggádit
geađđudit	gieddodit
geažidit	gietjedit
geažuhit	gietjodit
gehpiidit	gehpijdit
geiggiidit	gejgijdit
gemodit	gemudit
gerddodit	gerdudit
gerjjodit	gerjudit
gerpmodit	germudit
getkkoštit	getkkusjtit
geđđohit	geddudit
giddanit	giddanit
giebahit	giebadit
giehtadit	giehtadit
giekcasit	giektsasit
gielbbardit	gielbardit
gielddašit	gieldatjit
gielddihit	gieldedit
gielistit	gielestit
giemardit	giemardit
gierdudit	gierddodit
giesadit	giesadit
giessasit	giessasit
gietkkadit	gietkkadit
gievdadit	gievddadit
gievrudit	gievrrodit
gievttadit	gievtadit
gievvudit	gievvodit
gieváskit	gieváskit
gieškadit	giessjkadit
gihlidit	gihledit
gihládit	gihládit
gihppudit	gihppodit
gihpudit	gihpodit
gihraidit	gihrajdit
gihrihit	gihredit
giibmudit	gijmmodit
giidánit	gijddánit
giimmagit	gijmagit
giinnahit	gijnadit
giitalit	gijttalit
giksadit	giksadit
giktadit	giktadit
giktalit	giktalit
gillásit	gillásit
gillástit	gillástit
gildahit	gilldadit
gilgedit	gilggidit
gilgestit	gilggistit
gilggodit	gilgudit
giljodit	giljjudit
giljádit	giljjádit
gilkkahit	gilkadit
gilkkardit	gilkardit
gilkke7hit	gilkedit
gilkkihit	gilkedit
gilkkuhit	gilkodit
gilkkádit	gilkádit
gilvalit	gilvvalit
gilvvuhit	gilvodit
gilššagit	gilsjagit
gimahit	gimádit
gimbbaldit	gimbaldit
gimssordit	gimsurdit
gimškkardit	gimsjkardit
gincalit	ginttsalit
ginccardit	gintsardit
ginccihit	gintsedit
ginccuhit	gintsodit
ginccádit	gintsádit
ginuhit	ginodit
ginustit	ginostit
girbmidit	girmmedit
girddašit	girdatjit
girddihit	girdedit
girdilit	girddelit
girdodit	girddudit
girjjodit	girjudit
girjjudit	girjodit
girjjuhit	girjodit
girjudit	girjjodit
girkkodit	girkudit
gisaidit	gisájdit
givccodit	givttsudit
givccádit	givttsádit
givdnjahit	givnnjadit
givnnjardit	givnjardit
givnnjihit	givnjedit
givnnjádit	givnjádit
givrragit	givragit
givssidit	givsedit
givttahit	givtadit
givvežit	givvitjit
givšttidit	givsjtedit
givžžastit	givtjastit
gizzulit	gidtsolit
giđđudit	giddodit
giŋgguhit	giŋgodit
giŋggádit	giŋgádit
giŋgodit	giŋggudit
giššalit	gissjalit
gišvvardit	gisjvvardit
gišvvihit	gisjvvedit
giššuhit	gissjodit
gižaidit	gitjájdit
gižihit	gitjedit
gižžidit	gidtjedit
gižžudit	gidtjodit
goabagit	gåbagit
goadnahit	goaddnadit
goadnasit	goaddnasit
goahkádit	goahkádit
goaibbagit	goajbagit
goaikalit	goajkkalit
goaikke7hit	goajkedit
goaikkihit	goajkedit
goaikkuhit	goajkodit
goaippildit	goajpeldit
goaivulit	goajvvolit
goaivvastit	goajvastit
goalkalit	goalkkalit
goalkke7hit	goalkedit
goalkkidit	goalkedit
goalkkihit	goalkedit
goalkkuhit	goalkodit
goalkkášit	goalkátjit
goallo7stit	goallostit
goalludit	goallodit
goaluhit	goalodit
goalvvahit	goalvadit
goalvvuhit	goalvodit
goalŋŋadit	goalŋadit
goamagit	gåmagit
goanjidit	goanjedit
goantulit	goanttolit
goarasmit	gårasmit
goarbmulit	goarmmolit
goarddašit	goardatjit
goardde7stit	goardestit
goardilit	goarddelit
goarggasmit	goargasmit
goargguhit	goargodit
goargŋulit	goarŋŋolit
goaridit	goaredit
goarjadit	goarjjadit
goarjidit	goarjjedit
goarkalit	goarkkalit
goarkŋo7hit	goarŋodit
goarkŋuhit	goarŋodit
goarpmastit	goarmastit
goarpmo7hit	goarmodit
goarpmuhit	goarmodit
goarránit	goarránit
goartudit	goarttodit
goaruhit	goarodit
goarvanit	goarvvanit
goarvvagit	goarvagit
goarvvastit	goarvastit
goarvve7hit	goarvedit
goasihit	goasedit
goassudit	goassodit
goastadit	goasstadit
goastte7dit	goastedit
goasttidit	goastedit
goasttášit	goastátjit
goastudit	goasstodit
goatnahit	goadnadit
goattásmit	goattásmit
goavccuhit	goavttsodit
goavkanit	goavkkanit
goavkkagit	goavkagit
goavkkuhit	goavkodit
goavrragit	goavragit
goavrruhit	goavrodit
goavásmit	goavásmit
goavášit	goavátjit
goazahit	gåtsadit
goazastit	gåtsastit
goaŋidit	goaŋedit
goaŋkkuhit	goaŋkodit
gobadit	gåbådit
gobagit	gåbågit
gobmahit	gåbbmådit
gobmidit	gåbbmedit
goddalit	gåddålit
gohcahit	gåhtsådit
gohcodit	gåhtsudit
gohpasit	gåhpåsit
gohčodit	gåhtjudit
gohčuhit	gåhtjodit
gohččodit	gåhttjudit
goidadit	gåjddådit
goiddildit	gåjdeldit
goidošit	gåjddutjit
goiggardit	gåjgårdit
goikadit	gåjkkådit
goikalit	gåjkkålit
goikkahit	gåjkådit
goikke7hit	gåjkedit
goikkihit	gåjkedit
goikkodit	gåjkudit
goikkášit	gåjkåtjit
goivodit	gåjvvudit
goivvodit	gåjvudit
gokčasit	gåktjåsit
gollehit	gållidit
golahit	gålådit
golbmánit	gålmmånit
goldnadit	gålnnådit
golgadit	gålggådit
golggadit	gålgådit
golggahit	gålgådit
golggihit	gålgedit
golggiidit	gålgijdit
golggirdit	gålgerdit
golggodit	gålgudit
golihit	gåledit
golkehit	gålkkidit
golkestit	gålkkistit
golladit	gållådit
gollodit	gålludit
golludit	gållodit
golluhit	gållodit
golluštit	gållosjtit
golnnihit	gålnedit
gomaidit	gåmåjdit
gomihit	gåmedit
gomuhit	gåmodit
gomuštit	gåmosjtit
gonstošit	gånsstutjit
gonsttošit	gånstutjit
gopmirdit	gåbmerdit
gopmulit	gåbmolit
gopmánit	gåbmånit
gorbmestit	gårmmistit
gorgŋehit	gårŋŋidit
gorgŋestit	gårŋŋistit
gorjjodit	gårjudit
gorkŋodit	gårŋudit
gorodit	gårudit
gorpmodit	gårmudit
gosadit	gåsådit
gosahit	gåsådit
gosihit	gåsedit
goskkiidit	gåskijdit
gosádit	gåsådit
gottašit	gåttåtjit
gottihit	gåttedit
gottildit	gåtteldit
gottáskit	gåttåskit
govastit	gåvåstit
govdadit	gåvddådit
govddadit	gåvdådit
govddidit	gåvdedit
govddihit	gåvdedit
govddiidit	gåvdijdit
govddodit	gåvdudit
govddášit	gåvdåtjit
govdnadit	gåvnnådit
govdodit	gåvddudit
govdánit	gåvddånit
govlládit	gåvlådit
govssašit	gåvsåtjit
govuhit	gåvodit
govvidit	gåvvedit
govádit	gåvådit
govššodit	gåvsjudit
gozašit	gåtsåtjit
gozihit	gåtsedit
gozustit	gåtsostit
gozádit	gåtsådit
goččahit	gåttjådit
goččastit	gåttjåstit
gođahit	gådådit
gođđásit	gåddåsit
goŋggihit	gåŋgedit
goŋkehit	gåŋkkidit
goŋkánit	gåŋkkånit
gožžadit	gådtjådit
gubistit	gubestit
guhciidit	guhtsijdit
guhkedit	guhkidit
guhkidit	guhkedit
guhkkudit	guhkkodit
guhkkánit	guhkkánit
guhkášit	guhkátjit
guhlardit	guhlardit
guhpanit	guhpanit
guhpiidit	guhpijdit
guhpirdit	guhperdit
guhttánit	guhttánit
guippihit	gujpedit
guissádit	gujsádit
guittidit	gujtedit
guiagit	gujágit
gullostit	gullustit
gulahit	guládit
gulastit	gulástit
guldalit	gulldalit
guljodit	guljjudit
gulladit	gulladit
guláskit	guláskit
gumihit	gumedit
gumppo7stit	gumpostit
gumppustit	gumpostit
gunniidit	gunnijdit
guobbalit	guobbalit
guobirdit	guoberdit
guoddalit	guoddalit
guoggahit	guoggadit
guohcagit	guohtsagit
guohce7hit	guohtsedit
guohcildit	guohtseldit
guohcistit	guohtsestit
guohkastit	guohkastit
guohkkárit	guohkkárit
guohpasit	guohpasit
guohppudit	guohppodit
guohuštit	guohosjtit
guoigalit	guojggalit
guoiggadit	guojgadit
guoikkihit	guojkedit
guoikkuhit	guojkodit
guoimmuhit	guojmodit
guoiradit	guojradit
guoirrašit	guojrratjit
guoirruhit	guojrrodit
guoiihit	guojjdit
guokkagit	guokkagit
guokkardit	guokkardit
guokkuhit	guokkodit
guoktánit	guoktánit
guolddustit	guoldostit
guolggidit	guolgedit
guoljastit	guoljjastit
guolmmastit	guolmastit
guolástit	guolástit
guonjardit	guonjardit
guonnagit	guonnagit
guoppuštit	guopposjtit
guoradit	guoradit
guorastit	guorastit
guorbadit	guorbbadit
guorbbašit	guorbatjit
guorbbuhit	guorbodit
guorbmádit	guormmádit
guorkkihit	guorkedit
guorranit	guorranit
guorrasit	guorrasit
guorssadit	guorsadit
guorssádit	guorsádit
guosadit	guosadit
guosahit	guosadit
guoskadit	guosskadit
guoskkahit	guoskadit
guoskke7hit	guoskedit
guosmme7hit	guosmedit
guosmudit	guossmodit
guossalit	guossalit
guosso7hit	guossodit
guosttadit	guostadit
guottadit	guottadit
guottašit	guottatjit
guotte7hit	guottedit
guottihit	guottedit
guottildit	guotteldit
guovdduštit	guovdosjtit
guovdnjudit	guovnnjodit
guovgahit	guovggadit
guovlalit	guovllalit
guovlladit	guovladit
guovllastit	guovlastit
guovnnjagit	guovnjagit
guozahit	guotsadit
guođahit	guodadit
guođihit	guodedit
guođildit	guodeldit
guođo7hit	guododit
guođđelit	guoddilit
guppagit	guppagit
guppihit	guppedit
guppistit	guppestit
guppuštit	gupposjtit
gurrehit	gurridit
gurrestit	gurristit
gurastit	gurástit
gurddašit	gurdatjit
gurehit	guridit
gurgalit	gurggalit
gurgge7hit	gurgedit
gurggihit	gurgedit
gurggiidit	gurgijdit
gurggistit	gurgestit
gurgguhit	gurgodit
gurgánit	gurggánit
gurgásit	gurggásit
gurosmit	gurusmit
gurpahit	gurppadit
gurpalit	gurppalit
gurpasit	gurppasit
gurpmodit	gurmudit
gurppihit	gurpedit
gurradit	gurradit
guskalit	gusskalit
guskkiidit	guskijdit
gussodit	gussudit
gustohit	gusstudit
guvggodit	guvgudit
guvhllagit	guvhlagit
guvnnjádit	guvnjádit
guvnnádit	guvnádit
guvrragit	guvragit
guvrruhit	guvrodit
guvrruštit	guvrosjtit
guččahit	guttjadit
guččastit	guttjastit
guđaidit	gudájdit
guđodit	gududit
guštestit	gussjtistit
gužžadit	gudtjadit
gáddái#skihkidit	gáddájskihkedit
gáddánit	gáddánit
gádjalit	gádjalit
gággasit	gággasit
gágirdit	gágerdit
gáhrostit	gáhrustit
gáhtardit	gáhtardit
gáhčadit	gáhtjadit
gáhčahit	gáhtjadit
gáhččalit	gáhttjalit
gáibidit	gájbbedit
gáidadit	gájddadit
gáidádit	gájddádit
gáiffadit	gájfadit
gáiggiidit	gájgijdit
gáiggistit	gájgestit
gáikkihit	gájkedit
gáimmadit	gájmadit
gáimmástit	gájmástit
gáivvastit	gájvastit
gáivvihit	gájvedit
gáiaidit	gájájdit
gáiihit	gájjdit
gáiodit	gájudit
gáiálgit	gájálgit
gákcánit	gáktsánit
gákkadit	gákkadit
gákkahit	gákkadit
gákkastit	gákkastit
gállehit	gállidit
gálašit	gálatjit
gálbbardit	gálbardit
gáldnadit	gálnnadit
gálgalit	gálggalit
gálganit	gálgganit
gálggadit	gálgadit
gálihit	gáledit
gálladit	gálladit
gálljudit	gálljodit
gálo7dit	gálodit
gáludit	gálodit
gálágit	gálágit
gámadit	gámádit
gámahit	gámádit
gámodit	gámudit
gánagit	gánágit
gánne7hit	gánnedit
gánnihit	gánnedit
gánnáhit	gánnádit
gápposmit	gáppusmit
gáradit	gárádit
gárastit	gárástit
gárbmudit	gármmodit
gárddodit	gárdudit
gárgalit	gárggalit
gárganit	gárgganit
gárgedit	gárggidit
gárgehit	gárggidit
gárggiidit	gárgijdit
gárggistit	gárgestit
gárgidit	gárggedit
gáriidit	gárijdit
gárkŋagit	gárŋagit
gárrudit	gárrodit
gártadit	gárttadit
gárvodit	gárvvudit
gárvve7hit	gárvedit
gárvvihit	gárvedit
gárvvistit	gárvestit
gárvvo7hit	gárvodit
gárvvuhit	gárvodit
gárvvásmit	gárvásmit
gárvánit	gárvvánit
gáržudit	gárttjodit
gáržžidit	gártjedit
gáržžášit	gártjátjit
gásidit	gásedit
gáskkašit	gáskatjit
gáskke7stit	gáskestit
gáskkistit	gáskestit
gáskásit	gásskásit
gástadit	gásstadit
gásttašit	gástatjit
gáttidit	gáttedit
gávagit	gávágit
gávastit	gávástit
gávddagit	gávdagit
gávdnjánit	gávnnjánit
gávgalit	gávggalit
gávgge7hit	gávgedit
gávggihit	gávgedit
gávggiidit	gávgijdit
gávggistit	gávgestit
gávgguhit	gávgodit
gávildit	gáveldit
gávnnadit	gávnadit
gávnnahit	gávnadit
gávnnjagit	gávnjagit
gávnnjahit	gávnjadit
gávpalit	gávppalit
gávppahit	gávpadit
gávppašit	gávpatjit
gávppildit	gávpeldit
gávrragit	gávragit
gávránit	gávrránit
gávuhit	gávodit
gávvasit	gávvasit
gávvánit	gávvánit
gávzzagit	gávtsagit
gávččadit	gávtjadit
gávččastit	gávtjastit
gáđadit	gádádit
gáđaštit	gádasjtit
gášvalit	gássjvalit
gášvvardit	gásjvvardit
gášvvihit	gásjvvedit
hahcuhit	hahtsodit
hahkadit	hahkadit
hahkihit	hahkedit
hahpadit	hahpadit
hahppalit	hahppalit
haksilit	hakselit
haksostit	haksustit
hapmudit	habmodit
haraidit	harájdit
harcasit	harttsasit
harccastit	hartsastit
harihit	haredit
haskadit	hasskadit
haskkadit	haskadit
havssahit	havsadit
havsse7stit	havsestit
havssihit	havsedit
havssiidit	havsijdit
haŋkkuhit	haŋkodit
heahpanit	hiehpanit
heahppášit	hæhppátjit
heaibbuhit	hiejbodit
heaibbáskit	hæjbáskit
heairre7hit	hiejrredit
heaitalit	hiejttalit
heaittihit	hiejtedit
heaitásit	hæjttásit
heaiudit	hiejodit
heaiuhit	hiejodit
heaiušit	hiejotjit
heakkahit	hiekkadit
healbadit	hielbbadit
healkke7hit	hielkedit
healkkihit	hielkedit
healssastit	hielsastit
heamssistit	hiemsestit
hearidit	hieredit
hearjidit	hierjjedit
hearvvahit	hiervadit
heavahit	hievadit
heavganit	hievgganit
heavvanit	hievvanit
heađuštit	hiedosjtit
heađáskit	hædáskit
heaŋgahit	hieŋggadit
heaŋgasit	hieŋggasit
heaŋggagit	hieŋgagit
heaŋggastit	hieŋgastit
heaŋgguhit	hieŋgodit
heaŋgáhit	hæŋggádit
hedjonit	hedjunit
hedjosit	hedjusit
heikkahit	hejkadit
heillodit	hejlludit
heivedit	hejvvidit
heivehit	hejvvidit
heiosmit	hejusmit
heiošit	hejutjit
hellehit	hellidit
helssodit	helsudit
hereštit	herisjtit
hervošit	hervvutjit
hervvošit	hervutjit
hevrriidit	hevrijdit
heŋggiidit	heŋgijdit
heŋgostit	heŋggustit
hiddjidit	hiddjedit
hidjidit	hidjedit
hieimmastit	hiejmastit
hievganit	hievgganit
hieđuhit	hiedodit
hihtudit	hihtodit
hiistalit	hijsstalit
hilaštit	hilasjtit
hilbbasmit	hilbasmit
hilbbodit	hilbudit
hilbošit	hilbbutjit
hilbudit	hilbbodit
hilcudit	hilttsodit
hilggodit	hilgudit
hilggádit	hilgádit
hilgádit	hilggádit
hiljášit	hiljjátjit
hilljudit	hilljodit
hiltedit	hilltidit
himihit	himedit
himppistit	himpestit
himsudit	himssodit
hipmošit	hibmutjit
hipmudit	hibmodit
hirranit	hirranit
hirasmit	hirásmit
hirpmahit	hirmadit
hirrudit	hirrodit
hitnardit	hidnardit
hivvehit	hivvidit
hivllášit	hivlátjit
hivludit	hivllodit
hiđásmit	hidásmit
hiŋkkašit	hiŋkatjit
hiŋkkihit	hiŋkedit
hiŋkkádit	hiŋkádit
hoagahit	hågadit
hoagihit	hoagedit
hoahkalit	hoahkalit
hoahkidit	hoahkedit
hoahpuhit	hoahpodit
hoaiggardit	hoajgardit
hoaladit	håladit
hoalkadit	hoalkkadit
hoalššistit	hoalsjestit
hoamssistit	hoamsestit
hoavridit	hoavrredit
hoavrre7stit	hoavrestit
hoavrristit	hoavrestit
hoavránit	hoavrránit
hobehit	håbidit
hohccalit	håhttsålit
hohcuhit	håhtsodit
hohkahit	håhkådit
hohkkanit	håhkkånit
hohpohit	håhpudit
hoigadit	håjggådit
hoigasit	håjggåsit
hoiggadit	håjgådit
hoiggahit	håjgådit
holbádit	hålbbådit
holvvodit	hålvudit
holvvádit	hålvådit
hovkkiidit	håvkijdit
hovrriidit	håvrijdit
hudjosit	hudjusit
huhccalit	huhttsalit
huhcuhit	huhtsodit
huhpanit	huhpanit
huhtagit	huhtagit
huiggirdit	hujgerdit
huigášit	hujggátjit
huikkihit	hujkedit
huikkádit	hujkádit
huiošit	hujutjit
huksehit	huksidit
hulaidit	hulájdit
hulardit	hulárdit
huleštit	hulisjtit
humadit	humádit
humahit	humádit
humaidit	humájdit
humeštit	humisjtit
humihit	humedit
hunadit	hunádit
huncadit	hunttsadit
huobastit	huobastit
huoikkahit	huojkadit
huoikkádit	huojkádit
huomidit	huomedit
huomihit	huomedit
huomáhit	huomádit
huovidit	huovedit
huraidit	hurájdit
hurgalit	hurggalit
hurgguhit	hurgodit
hurihit	huredit
hurrulit	hurrolit
hurvudit	hurvvodit
hurvvagit	hurvagit
hurvvuhit	hurvodit
huvlliidit	huvlijdit
huvvidit	huvvedit
huđagit	hudágit
hušaidit	husjájdit
huškkastit	husjkastit
hábbasit	hábbasit
hábbudit	hábbodit
hádjosit	hádjusit
hádjánit	hádjánit
hágganit	hágganit
háhcihit	háhtsedit
háhkásit	háhkásit
háhppehit	háhppidit
háikkašit	hájkatjit
háikkihit	hájkedit
háikkádit	hájkádit
háilidit	hájledit
háissiidit	hájsijdit
háiuhit	hájodit
hállanit	hállanit
háladit	háládit
hálahit	háládit
hálbbe7dit	hálbedit
hálbbidit	hálbedit
hálbbášit	hálbátjit
hálbudit	hálbbodit
hálddahit	háldadit
hálddašit	háldatjit
háleštit	hálisjtit
hálganit	hálgganit
hálidit	háledit
hálihit	háledit
háliidit	hálijdit
háljistit	háljjestit
hálkkihit	hálkedit
hálssagit	hálsagit
háluhit	hálodit
hámssastit	hámsastit
hámssuhit	hámsodit
hámssádit	hámsádit
hámuhit	hámodit
hánddaldit	hándaldit
hánášit	hánátjit
hápmánit	hábmánit
háppastit	háppastit
háppuhit	háppodit
háppustit	háppostit
háppádit	háppádit
hárbmadit	hármmadit
hárjehit	hárjjidit
hárjánit	hárjjánit
hárragit	hárragit
hárvve7dit	hárvedit
hárvvidit	hárvedit
hárčulit	hárttjolit
hárččihit	hártjedit
hárččuhit	hártjodit
háskkidit	háskedit
háskkirdit	háskerdit
hástalit	hásstalit
hásttalit	hástalit
hásttašit	hástatjit
hásttuhit	hástodit
hávddardit	hávdardit
hávddodit	hávdudit
hávdádit	hávddádit
hávggádit	hávgádit
hávkadit	hávkkadit
hávkkádit	hávkádit
hávrragit	hávragit
hávrriidit	hávrijdit
hávrudit	hávrrodit
hávskkuhit	hávskodit
hávskkášit	hávskátjit
hávskudit	hávsskodit
hávvudit	hávvodit
hávvádit	hávvádit
háđirdit	háderdit
háŋggaštit	háŋgasjtit
háŋkasit	háŋkkasit
idjadit	idjadit
ihtalit	ihtalit
iiastit	ijástit
iiašit	ijatjit
ilbmadit	ilmmadit
ilbmanit	ilmmanit
ilggodit	ilgudit
illastit	illastit
illodit	illudit
illosit	illusit
illudit	illodit
illástit	illástit
ilmmuhit	ilmodit
ilosmit	ilusmit
imaštit	imasjtit
inádit	inádit
ipmirdit	ibmerdit
irgalit	irggalit
irgidit	irggedit
irrudit	irrodit
iskkadit	iskadit
iskkahit	iskadit
isádastalit	isádastalit
ittásmit	ittásmit
iđihit	idedit
iđistit	idestit
jahkiidit	jahkijdit
jahlidit	jahledit
jakkaldit	jakkaldit
jakŋadit	jagŋadit
jallošit	jallutjit
jalludit	jallodit
jalaidit	jalájdit
jalastit	jalástit
jalbmalit	jalmmalit
jalggodit	jalgudit
jalihit	jaledit
jalkalit	jalkkalit
jalkkihit	jalkedit
jallašit	jallatjit
jamaidit	jamájdit
jame7hit	jamedit
jamihit	jamedit
janzzahit	jantsadit
jaraidit	jarájdit
jarffahit	jarfadit
jarihit	jaredit
jarkŋasmit	jarŋasmit
jarrudit	jarrodit
jaskkodit	jaskudit
javzedit	javttsidit
jađgodit	jarggudit
jađgohit	jarggudit
jađgŋodit	jarŋŋudit
jađgŋohit	jarŋŋudit
jaŋašit	jaŋatjit
jeagadit	jiegadit
jeagildit	jiegeldit
jearadit	jieradit
jearahit	jieradit
jearralit	jierralit
jearuhit	jierodit
jeđđestit	jeddistit
jiebbadit	jiebbadit
jiekkaldit	jiekkaldit
jiekŋudit	jiegŋodit
jielastit	jielastit
jiellahastalit	jiellahastalit
jieltudit	jielltodit
jienastit	jienastit
jienastan#vuoigadit	jienastanvuojggadit
jienihit	jienedit
jienádit	jienádit
jieppadit	jieppadit
jierbmadit	jiermmadit
jiervvastit	jiervastit
jierásmit	jierásmit
jiessadit	jiessadit
jiessagit	jiessagit
jiessudit	jiessodit
jietnadit	jiednadit
jievjjihit	jievjedit
jievjjildit	jievjeldit
jievladit	jievlladit
jievžžadit	jievtjadit
joahcalit	joahtsalit
joaibmudit	joajmmodit
joaimmagit	joajmagit
joatkkašit	joatkkatjit
joatkásit	joatkásit
joavaidit	jåvajdit
joavgalit	joavggalit
joavgge7hit	joavgedit
joavihit	joavedit
joavvalit	joavvalit
joazihit	joatsedit
johtalit	jåhtålit
johttáhit	jåhttådit
johttástit	jåhttåstit
jolggadit	jålgådit
jolggaštit	jålgåsjtit
jollardit	jållårdit
joppaldit	jåppåldit
joradit	jårådit
jorahit	jårådit
jorbahit	jårbbådit
jorbbasmit	jårbåsmit
jorbbiidit	jårbijdit
jorbbistit	jårbestit
jorbbodit	jårbudit
jore7štit	jåresjtit
jorgalit	jårggålit
jorgasit	jårggåsit
jorggastit	jårgåstit
jorgge7hit	jårgedit
jorggihit	jårgedit
jorggiidit	jårgijdit
jorggistit	jårgestit
jorggodit	jårgudit
jorihit	jåredit
jorralit	jårrålit
jottahit	jåttådit
jovgohit	jåvggudit
jozzidit	jådtsedit
jođašit	jådåtjit
jođihit	jådedit
jođálmit	jådålmit
jugadit	jugádit
jugahit	jugádit
juge7stit	jugestit
jugistit	jugestit
juhkildit	juhkeldit
juhkásit	juhkásit
julahit	juládit
julaidit	julájdit
jule7štit	julesjtit
julggadit	julgadit
julggaštit	julgasjtit
julkalit	julkkalit
julkkihit	julkedit
julkkuhit	julkodit
jullidit	julledit
julmmagit	julmagit
jumaidit	jumájdit
jumihit	jumedit
juogadit	juogadit
juogustit	juogostit
juohkádit	juohkádit
juohkásit	juohkásit
juoiggadit	juojgadit
juoiggahit	juojgadit
juoiggastit	juojgastit
juokŋadit	juogŋadit
juolgadit	juolggadit
juolgguštit	juolgosjtit
juolludit	juollodit
juonastit	juonastit
juorbbuhit	juorbodit
juorbbádit	juorbádit
juorbulit	juorbbolit
juorrudit	juorrodit
juotnidit	juodnedit
juovssahit	juovsadit
juovzudit	juovttsodit
juovzzihit	juovtsedit
juovzzuhit	juovtsodit
juovzzádit	juovtsádit
juođahit	juodadit
juoŋastit	juoŋastit
jurahit	jurádit
juraidit	jurájdit
jurddahit	jurdadit
jurddašit	jurdatjit
jurdilit	jurddelit
jurihit	juredit
jurssastit	jursastit
jurssistit	jursestit
juskalit	jusskalit
juskkihit	juskedit
juskkuhit	juskodit
jusádit	jusádit
jutnošit	judnutjit
juvdudit	juvddodit
juvzzodit	juvtsudit
jáddadit	jáddadit
jáhkihit	jáhkedit
jáhkuhit	jáhkodit
jálddošit	jáldutjit
jálddudit	jáldodit
jálosmit	jálusmit
jámadit	jámádit
jámašit	jámatjit
jáme7stit	jámestit
jámihit	jámedit
jámálgit	jámálgit
jápmásit	jábmásit
játnadit	jádnadit
játtihit	játtedit
jávistit	jávestit
jávkadit	jávkkadit
jávkkehit	jávkidit
jávkkihit	jávkedit
jávkkodit	jávkudit
jávvásit	jávvásit
keamppasmit	kiempasmit
keamppašit	kiempatjit
kievrudit	kievrrodit
koaillagit	koajllagit
koailluhit	koajllodit
koailáhit	koajládit
koailánit	koajlánit
koasttidit	koastedit
konstošit	kånsstutjit
koŋkehit	kåŋkkidit
koŋkánit	kåŋkkånit
kruvnnidit	kruvnedit
kuhciidit	kuhtsijdit
kumppo7stit	kumpostit
kumppustit	kumpostit
kunniidit	kunnijdit
kuohcagit	kuohtsagit
kuohce7hit	kuohtsedit
kuohcildit	kuohtseldit
kuohcistit	kuohtsestit
kuonnagit	kuonnagit
kuorranit	kuorranit
kuovlalit	kuovllalit
kuovlladit	kuovladit
kuovllastit	kuovlastit
labadit	labádit
labahit	labádit
labastit	labástit
labbanit	labbanit
ladnjedit	laddnjidit
ladnjestit	laddnjistit
lagadit	lagádit
lagahit	lagádit
lahkanit	lahkanit
lahkonit	lahkunit
lahpasit	lahpasit
lahppasit	lahppasit
lahttudit	lahttodit
laigadit	lajggadit
laigasit	lajggasit
laigehit	lajggidit
laiggadit	lajgadit
laiggihit	lajgedit
laiggodit	lajgudit
lakkihit	lakkedit
laktasit	laktasit
laktásit	laktásit
lamadit	lamádit
lamagit	lamágit
lamssihit	lamsedit
lanjahit	lanjádit
lapmalit	labmalit
lapmudit	labmodit
lasidit	lasedit
lasihit	lasedit
laskadit	lasskadit
laskehit	lasskidit
laskestit	lasskistit
laskkiidit	laskijdit
lasmmihit	lasmedit
lassánit	lassánit
latnjasit	ladnjasit
lađaidit	ladájdit
lađastit	ladástit
lađgalit	larggalit
lađggihit	largedit
lađggiidit	largijdit
lađggistit	largestit
laššásmit	lassjásmit
leabastit	liebastit
leabbahit	liebbadit
leabbanit	liebbanit
leahkastit	liehkastit
leahkkasit	liehkkasit
leaicidit	liejttsedit
leaikasit	liejkkasit
leaikkastit	liejkastit
leaikkuhit	liejkodit
leaissagit	liejsagit
leamssihit	liemsedit
leanddašit	liendatjit
leanzzagit	lientsagit
leappagit	lieppagit
leappe7hit	lieppedit
leappuhit	lieppodit
leatnjásit	lædnjásit
leavgge7hit	lievgedit
leavvudit	lievvodit
leađgalit	lierggalit
leađgge7hit	liergedit
leađggihit	liergedit
lehehit	lehidit
lehttohit	lehttudit
leháhit	lehádit
leikehit	lejkkidit
leikestit	lejkkistit
leikkodit	lejkudit
leikošit	lejkkutjit
leppodit	leppudit
leŋgestit	leŋggistit
libaidit	libájdit
libardit	libárdit
lidnestit	liddnistit
liegganit	liegganit
liehmudit	liehmodit
liehppadit	liehppadit
liekkadit	liekkadit
liekkihit	liekkedit
liekkistit	liekkestit
liekčasit	liektjasit
liekčásit	liektjásit
liemastit	liemastit
lienjádit	lienjádit
lievllistit	lievlestit
lieškkihit	liesjkedit
liggestit	liggistit
lihkadit	lihkadit
lihkahit	lihkadit
lihkastit	lihkastit
lihke7stit	lihkestit
lihkkasit	lihkkasit
lihkkidit	lihkkedit
lihkkohit	lihkkudit
lihtodit	lihtudit
lihttoláigohit	lihttulájgodit
liigudit	lijggodit
liikodit	lijkkudit
liikostit	lijkkustit
liirrustit	lijrrostit
likkiidit	likkijdit
likkosmit	likkusmit
liktedit	liktidit
liktestit	liktistit
liktudit	liktodit
lilluhit	lillodit
liluhit	lilodit
limškkagit	limsjkagit
limškkistit	limsjkestit
linccagit	lintsagit
linccahit	lintsadit
linccuhit	lintsodit
linihit	linedit
liniidit	linijdit
linistit	linestit
linjagit	linjágit
linjodit	linjudit
linásmit	linásmit
lisistit	lisestit
litnudit	lidnodit
livvohit	livvudit
livhnnodit	livhnnudit
livjáhit	livjjádit
livkalit	livkkalit
livkkihit	livkedit
livkkuhit	livkodit
livkáhit	livkkádit
livodit	livudit
livttásmit	livtásmit
livttášit	livtátjit
livvadit	livvadit
livvudit	livvodit
livzzistit	livtsestit
livššadit	livsjadit
livššastit	livsjastit
livššodit	livsjudit
livššuhit	livsjodit
livžžardit	livtjardit
livžžastit	livtjastit
livžžodit	livtjudit
livžžádit	livtjádit
liđggastit	lirgastit
liđiidit	lidijdit
liđmmagit	lirmagit
liđmmodit	lirmudit
liđpmagit	lidpmagit
liđpmodit	lidpmudit
liđvvagit	lirvagit
liđvvistit	lirvestit
liŋgalit	liŋggalit
liŋggustit	liŋgostit
liškasit	lissjkasit
liškkihit	lisjkedit
loaggánit	loaggánit
loahke7hit	loahkedit
loahpahit	loahpadit
loahppa#meannudit	loahppamiennodit
loahttudit	loahttodit
loaiddadit	loajdadit
loaiddastit	loajdastit
loakkagit	loakkagit
loaktalit	loaktalit
loaktilit	loaktelit
loanahit	lånadit
loanidit	loanedit
loanášit	loanátjit
loapmagit	loabmagit
loarffuhit	loarfodit
loarfulit	loarffolit
loarfánit	loarffánit
loasastit	låsastit
loaskalit	loasskalit
loaskkuhit	loaskodit
loavddašit	loavdatjit
loavddášit	loavdátjit
loavdudit	loavddodit
loavkidit	loavkkedit
loavkkistit	loavkestit
loavuhit	loavodit
loaččadit	loattjadit
loaččihit	loattjedit
loaškalit	loassjkalit
loaškkuhit	loasjkodit
loažžadit	loadtjadit
lobidit	låbedit
lodjudit	lådjodit
lodnjáhit	låddnjådit
lodnjánit	låddnjånit
logadit	lågådit
logahalahit	lågåhaladit
logahit	lågådit
logaldit	lågåldit
logastit	lågåstit
loggásit	låggåsit
lohkalit	låhkålit
lohkkadit	låhkkådit
lohkkádit	låhkkådit
lohkuhit	låhkodit
lohpidit	låhpedit
lohppehit	låhppidit
loikadit	låjkkådit
loikkašit	låjkåtjit
loikkihit	låjkedit
loikkiidit	låjkijdit
loiášit	låjåtjit
lokkastit	låkkåstit
lokkodit	låkkudit
lokkuhit	låkkodit
loktanit	låktånit
loktestit	låktistit
lokŋásit	lågŋåsit
lolahit	lålådit
lonehit	lånidit
lonistit	lånestit
lonjodit	lånjudit
lonjuhit	lånjodit
lonodit	lånudit
lonuhit	lånodit
losidit	låsedit
lossudit	låssodit
losášit	låsåtjit
lotkkihit	låtkkedit
lotkkiidit	låtkkijdit
lotkkodit	låtkkudit
lotnjudit	lådnjodit
lottástit	låttåstit
lovkkiidit	låvkijdit
lovttadit	låvtådit
lovttahit	låvtådit
lozzadit	lådtsådit
loškkiidit	låsjkijdit
loškkistit	låsjkestit
ložžedit	lådtjidit
lubmedit	lubbmidit
luddehit	luddidit
luddestit	luddistit
lulidit	luledit
lulistit	lulestit
lullánit	lullánit
lumosmit	lumusmit
lunjaidit	lunjájdit
luobahit	luobadit
luobbahit	luobbadit
luoddanit	luoddanit
luogustit	luogostit
luohcadit	luohtsadit
luohpadit	luohpadit
luohpudit	luohpodit
luohtidit	luohtedit
luohčásit	luohtjásit
luoikalastte7stit	luojkkalastestit
luoikalit	luojkkalit
luoikkahit	luojkadit
luoillistit	luojllestit
luoimmadit	luojmadit
luoimmádit	luojmádit
luoitalit	luojttalit
luoitilit	luojttelit
luoittašit	luojtatjit
luoittihit	luojtedit
luoitádit	luojttádit
luoiaidit	luojajdit
luoktudit	luoktodit
luonjaidit	luonjajdit
luopmudit	luobmodit
luoppagit	luoppagit
luoskanit	luosskanit
luoskkagit	luoskagit
luotkanit	luotkanit
luotnudit	luodnodit
luovasmit	luovasmit
luovddašit	luovdatjit
luovdilit	luovddelit
luovdádit	luovddádit
luovvanit	luovvanit
luovččahit	luovtjadit
luoškkagit	luosjkagit
luskkiidit	luskijdit
lusttiidit	lustijdit
lutkkiidit	lutkkijdit
lutkkosmit	lutkkusmit
luttodit	luttudit
luvdestit	luvddistit
luvnnjiidit	luvnjijdit
luvvadit	luvvadit
luččuhit	luttjodit
luŋkkagit	luŋkagit
luŋkkahit	luŋkadit
luŋkkistit	luŋkestit
luŋkáhit	luŋkkádit
luŋkánit	luŋkkánit
lábmehit	lábbmidit
láddadit	láddadit
ládjudit	ládjodit
lágastit	lágástit
lágidit	lágedit
lágiidit	lágijdit
láhka#mearridit	láhkamierredit
láhka#vuođđudit	láhkavuoddodit
láhkadit	láhkadit
láhkkodit	láhkkudit
láhkkostit	láhkkustit
láhpadit	láhpadit
láhpe7hit	láhpedit
láhpihit	láhpedit
láhppohit	láhppudit
láhttadit	láhttadit
láhttestit	láhttistit
láhčamastalit	láhtjamastalit
láibbastit	lájbastit
láibbodit	lájbudit
láibbuhit	lájbodit
láidestit	lájddistit
láigohit	lájggudit
láigudit	lájggodit
láikkášit	lájkátjit
láikošit	lájkkutjit
láittašit	lájtatjit
láivudit	lájvvodit
láktadit	láktadit
lálláhit	lálládit
lálašit	lálatjit
lánjadit	lánjádit
lánjodit	lánjudit
lápmudit	lábmodit
lárbmadit	lármmadit
lásttidit	lástedit
látnjasit	ládnjasit
láttadit	láttadit
lávdadit	lávddadit
lávddadit	lávdadit
lávggadit	lávgadit
lávgge7hit	lávgedit
lávggodit	lávgudit
lávkkodit	lávkudit
lávlestit	lávllistit
lávllastit	lávlastit
lávllodit	lávludit
lávttašit	lávtatjit
lávttihit	lávtedit
lávžádit	lávttjádit
lávžžástit	lávtjástit
láŋkadit	láŋkkadit
lášmmodahttalit	lásjmudahttalit
lášmmodit	lásjmudit
malssidit	malsedit
manadit	manádit
manahit	manádit
manihit	manedit
mannalit	mannalit
marššagit	marsjagit
marššuhit	marsjodit
masihit	masedit
mastadit	masstadit
masttadit	mastadit
maŋidit	maŋedit
maŋášit	maŋátjit
maŋŋonit	maŋŋunit
maŋŋánit	maŋŋánit
meaddalit	mieddalit
meaddádit	mæddádit
meafardit	miefardit
meagádit	mægádit
meahccidit	miehttsedit
meahcástit	mæhtsástit
meahčidit	miehtjedit
meaiddašit	miejdatjit
meaiskidit	miejsskedit
mealastit	mielastit
mealtalit	mielltalit
mealádit	mæládit
meammagit	miemmagit
meannudit	miennodit
meargŋasit	mierŋŋasit
mearkadit	mierkkadit
mearkkahit	mierkadit
mearkkašit	mierkatjit
mearkkášit	mærkátjit
mearredit	mierridit
mearridit	mierredit
meattihit	miettedit
meađalditit	miedalditit
meađaldit	miedaldit
meađmmagit	miermagit
meađpmagit	miedpmagit
megodit	megudit
melodit	meludit
menodit	menudit
merkehit	merkkidit
merkkodit	merkudit
meroštit	merusjtit
miehkástit	miehkástit
miehtánit	miehtánit
mieigasit	miejggasit
mieiggastit	miejgastit
miel#váikkuhit	mielvájkodit
mielddistit	mieldestit
mieldduhit	mieldodit
mielddustit	mieldostit
mielde7#váikkuhit	mielldevájkodit
mielggastit	mielgastit
mierkkádit	mierkádit
mieskadit	miesskadit
mievžžastit	mievtjastit
mieđidit	miededit
mieđihit	miededit
mieđuštit	miedosjtit
mieškalit	miessjkalit
mieškkuhit	miesjkodit
mihtidit	mihtedit
mihttohit	mihttudit
millosit	millusit
mirkkohit	mirkudit
misttahit	mistadit
mittodit	mittudit
moakkagit	moakkagit
moalkasit	moalkkasit
moalkkagit	moalkagit
moalkkardit	moalkardit
moallanit	moallanit
moarddašit	moardatjit
moarrasit	moarrasit
moarrudit	moarrodit
moarránit	moarránit
moaráskit	moaráskit
moađaidit	mådajdit
moađgalit	moarggalit
moccastit	måttsåstit
moccáskit	måttsåskit
moddjestit	måddjistit
moddjádit	måddjådit
moddjilit	måddjelit
modjosit	mådjusit
moggidit	måggedit
mohkastit	måhkåstit
mohkkasit	måhkkåsit
mohtudit	måhtodit
moiddodit	måjdudit
moivváskit	måjvåskit
mokkirdit	måkkerdit
mokkáskit	måkkåskit
moladit	målådit
moljastit	måljjåstit
moljádit	måljjådit
molladit	mållådit
mollanit	mållånit
molsasit	målssåsit
molssastit	målsåstit
molssodit	målsudit
molžžardit	måltjårdit
moraštit	måråsjtit
morihit	måredit
moriidit	mårijdit
morranit	mårrånit
morránit	mårrånit
moskkosmit	måskusmit
moskkudit	måskodit
mosttagit	måstågit
movttiidit	måvtijdit
movttáskit	måvtåskit
mozzasit	mådtsåsit
mozzidit	mådtsedit
muddehit	muddidit
mugodit	mugudit
muhraidit	muhrajdit
muhttohit	muhttudit
muitalit	mujttalit
muittašit	mujtatjit
muittuhit	mujtodit
muitáhit	mujttádit
muitástit	mujttástit
mukkagit	mukkagit
mukkiidit	mukkijdit
muktalit	muktalit
muktosit	muktusit
mulggastit	mulgastit
mulggodit	mulgudit
mulggádit	mulgádit
muljardit	muljjardit
mulččihit	multjedit
munahit	munádit
muohtašit	muohtatjit
muohte7stit	muohtestit
muoladit	muoladit
muoládit	muoládit
muossánit	muossánit
muosvvistit	muosvvestit
muosáhit	muosádit
muotkkuhit	muotkkodit
muovjádit	muovjjádit
muozastit	muotsastit
murddihit	murdedit
murdilit	murddelit
murjedit	murjjidit
murkkudit	murkodit
murádit	murádit
mutkkodit	mutkkudit
muttardit	muttardit
muđaldit	mudáldit
máddánit	máddánit
máguhit	mágodit
máhcadit	máhtsadit
máhcahit	máhtsadit
máhcastit	máhtsastit
máhccadit	máhttsadit
máhccasit	máhttsasit
máhcodit	máhtsudit
máhttáhit	máhttádit
máihlliidit	májhlijdit
máinnastit	májnastit
máinnašit	májnatjit
máinnodit	májnudit
máinnustit	májnostit
máisttašit	májstatjit
máizadit	májttsadit
máizziidit	májtsijdit
máizzistit	májtsestit
mállehit	mállidit
máladit	máládit
mále7stit	málestit
málestit	málistit
málistit	málestit
mánidit	mánedit
máraidit	márájdit
márffodit	márfudit
márihit	máredit
márkan#fievrridit	márkkanfievredit
mátkkašit	mátkkatjit
mátkkaštit	mátkkasjtit
mátkkoštit	mátkkusjtit
máttahit	máttadit
máttidit	máttedit
mávssahit	mávsadit
mávssašit	mávsatjit
mávsse7hit	mávsedit
mávssihit	mávsedit
máŋganit	máŋgganit
máŋgehit	máŋggidit
naddjodit	naddjudit
naffagit	naffagit
nagadit	nagádit
nagodit	nagudit
nahke7hit	nahkedit
nahkihit	nahkedit
nahkášit	nahkátjit
naigalit	najggalit
naiggistit	najgestit
naigguhit	najgodit
nakšalit	naksjalit
naladit	naládit
nallasit	nallasit
nallosit	nallusit
namahit	namádit
nammadit	nammadit
namuhit	namodit
nannudit	nannodit
nanosmit	nanusmit
nanošit	nanutjit
nanudit	nanodit
nanustit	nanostit
narggašit	nargatjit
naskke7stit	naskestit
navdasit	navddasit
navddašit	navdatjit
navihit	navedit
navildit	naveldit
navistit	navestit
navválit	navválit
navššihit	navsjedit
navššuhit	navsjodit
nađđadit	naddadit
nealggášit	nælgátjit
nealgudit	nielggodit
nealgádit	nælggádit
nearranit	nierranit
neaskkašit	nieskatjit
neavrudit	nievrrodit
neavttadit	nievtadit
neavttašit	nievtatjit
neavvuhit	nievvodit
neavzzuhit	nievtsodit
negosmit	negusmit
nelggodit	nelgudit
nevrošit	nevrrutjit
nevvodit	nevvudit
nevzzodit	nevtsudit
niegadit	niegadit
niehkudit	niehkodit
nieiadit	niejadit
nieiahit	niejadit
nihlaidit	nihlajdit
nihlistit	nihlestit
niibbástit	nijbástit
niktalit	niktalit
nilkkistit	nilkestit
nimmardit	nimmardit
nimmordit	nimmurdit
nimmorit	nimmurit
nimmurdit	nimmordit
nirppagit	nirpagit
nirppihit	nirpedit
nirvahit	nirvvadit
nirvvahit	nirvadit
nisttihit	nistedit
nistásit	nisstásit
nisádit	nisádit
nivkalit	nivkkalit
nivkkihit	nivkedit
nivkkuhit	nivkodit
nivkkádit	nivkádit
nivkulit	nivkkolit
nivssihit	nivsedit
njabagit	njabágit
njabirdit	njaberdit
njaccastit	njattsastit
njaccuhit	njattsodit
njagagit	njagágit
njaguštit	njagosjtit
njahkalit	njahkalit
njahkastit	njahkastit
njahpasit	njahpasit
njahpastit	njahpastit
njahpe7stit	njahpestit
njahpistit	njahpestit
njahppasit	njahppasit
njakčasit	njaktjasit
njalahit	njaládit
njalddašit	njaldatjit
njaldde7stit	njaldestit
njalddihit	njaldedit
njalddistit	njaldestit
njaldásit	njalldásit
njalgge7hit	njalgedit
njalggihit	njalgedit
njalggiidit	njalgijdit
njalkasit	njalkkasit
njalkkastit	njalkastit
njalkkihit	njalkedit
njalodit	njaludit
njalpalit	njalppalit
njalppagit	njalpagit
njalppe7hit	njalpedit
njalppihit	njalpedit
njalssagit	njalsagit
njalssuhit	njalsodit
njaláhastalit	njaláhastalit
njalččidit	njaltjedit
njammedit	njammidit
njamadit	njamádit
njamahit	njamádit
njamistit	njamestit
njammadit	njammadit
njammasit	njammasit
njammásit	njammásit
njartadit	njarttadit
njarvvagit	njarvagit
njarvvuhit	njarvodit
njaskasit	njasskasit
njaskkastit	njaskastit
njattiidit	njattijdit
njavggodit	njavgudit
njavgguhit	njavgodit
njavkkihit	njavkedit
njavkkiidit	njavkijdit
njavččagit	njavtjagit
njavččihit	njavtjedit
njavččuhit	njavtjodit
njazzasit	njadtsasit
njađašit	njadatjit
njađđásit	njaddásit
njaŋgahit	njaŋggadit
njaŋgalit	njaŋggalit
njaŋgasit	njaŋggasit
njaŋggagit	njaŋgagit
njaŋggardit	njaŋgardit
njaŋggihit	njaŋgedit
njaŋggiidit	njaŋgijdit
njaŋggirdit	njaŋgerdit
njaŋggistit	njaŋgestit
njaŋgguhit	njaŋgodit
njeaccagit	njiettsagit
njeaccahit	njiettsadit
njeaccistit	njiettsestit
njeaccuhit	njiettsodit
njeaidalit	njiejddalit
njeaiddihit	njiejdedit
njeaidásit	njæjddásit
njeakcasit	njiektsasit
njealljánit	njælljánit
njeavccagit	njievttsagit
njeazzahit	njiedtsadit
njeazzasit	njiedtsasit
njeađgasit	njierggasit
njeađggáskit	njærgáskit
njeaššagit	njiessjagit
njeccodit	njettsudit
njiedjalit	njiedjalit
njiehcadit	njiehtsadit
njieiadit	njiejadit
njieiahit	njiejadit
njiekkastit	njiekkastit
njieladit	njieladit
njielahit	njieladit
njielastit	njielastit
njiellalit	njiellalit
njiellasit	njiellasit
njieládit	njieládit
njigaidit	njigájdit
njigodit	njigudit
njigádit	njigádit
njilkalit	njilkkalit
njimaidit	njimájdit
njire7štit	njiresjtit
njirgalit	njirggalit
njirgehit	njirggidit
njirištit	njiresjtit
njirttastit	njirtastit
njiskkastit	njiskastit
njivkkihit	njivkedit
njivkkádit	njivkádit
njivlidit	njivlledit
njivllihit	njivledit
njivllistit	njivlestit
njivžulit	njivttjolit
njivžžardit	njivtjardit
njivžžastit	njivtjastit
njivžžihit	njivtjedit
njivžžodit	njivtjudit
njivžžádit	njivtjádit
njoahcudit	njoahtsodit
njoalccagit	njoaltsagit
njoalo7stit	njoalostit
njoalpalit	njoalppalit
njoalppagit	njoalpagit
njoalppe7hit	njoalpedit
njoalppihit	njoalpedit
njoaládit	njoaládit
njoamihit	njoamedit
njoammasit	njoammasit
njoammudit	njoammodit
njoammásit	njoammásit
njoamuhit	njoamodit
njoamádit	njoamádit
njoaradit	njåradit
njoarahit	njåradit
njoaro7stit	njoarostit
njoaskkihit	njoaskedit
njoavgalit	njoavggalit
njoavggistit	njoavgestit
njoazášit	njoatsátjit
njoađvudit	njoarvvodit
njoađvvagit	njoarvagit
njoađvvasmit	njoarvasmit
njoiddosmit	njåjdusmit
njokkardit	njåkkårdit
njolgalit	njålggålit
njolggiidit	njålgijdit
njolggástit	njålgåstit
njolgidit	njålggedit
njolodit	njåludit
njolvvagit	njålvågit
njolvvihit	njålvedit
njomodit	njåmudit
njorrehit	njårridit
njorrestit	njårristit
njovggiidit	njåvgijdit
njozastit	njåtsåstit
njozádit	njåtsådit
njuikehit	njujkkidit
njuikestit	njujkkistit
njuikkodit	njujkudit
njuikko7hit	njujkodit
njuikkuhit	njujkodit
njuikulit	njujkkolit
njulgehit	njulggidit
njulggodit	njulgudit
njullihit	njulledit
njune7#vuolástit	njunevuolástit
njunnádit	njunnádit
njunuhit	njunodit
njuoggahit	njuoggadit
njuoggasit	njuoggasit
njuohkánit	njuohkánit
njuohkásit	njuohkásit
njuohtasit	njuohtasit
njuokkagit	njuokkagit
njuokkardit	njuokkardit
njuolastit	njuolastit
njuolgadit	njuolggadit
njuolgahit	njuolggadit
njuolggadit	njuolgadit
njuolggašit	njuolgatjit
njuolgge7hit	njuolgedit
njuolggo#muitalit	njuolgomujttalit
njuolvvagit	njuolvagit
njuorbasit	njuorbbasit
njuordasit	njuorddasit
njuordásit	njuorddásit
njuorradit	njuorradit
njuorranit	njuorranit
njuorvadit	njuorvvadit
njuorvvagit	njuorvagit
njuorššagit	njuorsjagit
njuoskadit	njuosskadit
njuoskkadit	njuoskadit
njuoskkašit	njuoskatjit
njuoskke7hit	njuoskedit
njuoskkihit	njuoskedit
njuoskkistit	njuoskestit
njuovadit	njuovadit
njuovahit	njuovadit
njuovildit	njuoveldit
njuovčča#lahkástit	njuovtjalahkástit
njurggodit	njurgudit
njurggádit	njurgádit
njuskkiidit	njuskijdit
njuvddadit	njuvdadit
njuvddašit	njuvdatjit
njuvdde7stit	njuvdestit
njuvdásit	njuvddásit
njágadit	njágádit
njágahit	njágádit
njáhkalit	njáhkalit
njáiggosmit	njájgusmit
njáiggošit	njájgutjit
njáikkagit	njájkagit
njálbmadit	njálmmadit
njálggiidit	njálgijdit
njálgudit	njálggodit
njálmmardit	njálmardit
njálmmuštit	njálmosjtit
njámmodit	njámmudit
njámastit	njámástit
njámmasit	njámmasit
njámmastit	njámmastit
njárbbodit	njárbudit
njárbbášit	njárbátjit
njárbudit	njárbbodit
njáskasit	njásskasit
njávggihit	njávgedit
njávggádit	njávgádit
njávkkadit	njávkadit
njávkkastit	njávkastit
njávkkistit	njávkestit
njázudit	njátsodit
njáđášit	njádátjit
njáđđudit	njáddodit
njáŋgalit	njáŋggalit
njáŋgasit	njáŋggasit
njáŋggihit	njáŋgedit
njáŋggiidit	njáŋgijdit
njáŋggistit	njáŋgestit
njáškalit	njássjkalit
njáškkuhit	njásjkodit
noaiddástit	noajdástit
noarvádit	noarvvádit
noastalit	noasstalit
noastáhit	noasstádit
noastásit	noasstásit
noavkalit	noavkkalit
noavkkastit	noavkastit
noavkkuhit	noavkodit
noavkkádit	noavkádit
noađo7štit	noadosjtit
noađuhit	noadodit
noađuštit	noadosjtit
noađáskit	noadáskit
noađástit	noadástit
noađđádit	noaddádit
nogahit	någådit
nogihit	någedit
nohkadit	nåhkådit
nohkastit	nåhkåstit
nohke7stit	nåhkestit
nohkihit	nåhkedit
nohkkadit	nåhkkådit
noidošit	nåjddutjit
nollagit	nållågit
nollihit	nålledit
nolliidit	nållijdit
norastit	nåråstit
nordadit	nårddådit
nordasit	nårddåsit
norddadit	nårdådit
norddahit	nårdådit
norddastit	nårdåstit
norkkagit	nårkågit
noskkašit	nåskåtjit
noskkihit	nåskedit
notkasit	nåtkåsit
nođđuditit	nåddoditit
nuhkkalit	nuhkkalit
nuhkuštit	nuhkosjtit
nuissodit	nujsudit
nuktalit	nuktalit
nullosit	nullusit
nulppagit	nulpagit
nuohtástit	nuohtástit
nuoladit	nuoladit
nuolahit	nuoladit
nuollasit	nuollasit
nuolludit	nuollodit
nuondadit	nuonddadit
nuorasmit	nuorasmit
nuorašit	nuoratjit
nuorbasit	nuorbbasit
nuorbbastit	nuorbastit
nuoskidit	nuosskedit
nuoskkidit	nuoskedit
nuoskkášit	nuoskátjit
nuoskudit	nuosskodit
nuossadit	nuossadit
nuppástit	nuppástit
nurddagit	nurdagit
nurridit	nurredit
nurssagit	nursagit
nurššagit	nursjagit
nurššihit	nursjedit
nuskošit	nusskutjit
nuvkalit	nuvkkalit
nuvkkihit	nuvkedit
nábirdit	náberdit
nábárdit	nábárdit
náddjodit	náddjudit
nádjasit	nádjasit
náhkkádit	náhkkádit
náiggistit	nájgestit
náitalit	nájttalit
náiadit	nájádit
nákkáskit	nákkáskit
náladit	náládit
nállasit	nállasit
nárpmastit	nármastit
nárridit	nárredit
nárvvagit	nárvagit
nárvvodit	nárvudit
náskodit	násskudit
návddahit	návdadit
návddašit	návdatjit
návdulit	návddolit
návrruhit	návrodit
náđodit	nádudit
náđustit	nádostit
náđđadit	náddadit
náđđahit	náddadit
náđđudit	náddodit
oaddudit	oaddodit
oadjudit	oadjodit
oaggasit	oaggasit
oaguhit	oagodit
oahcudit	oahtsodit
oahkulit	oahkolit
oahpadit	oahpadit
oahpahit	oahpadit
oahpistit	oahpestit
oahpásmit	oahpásmit
oaidnalit	oajnnalit
oainnašit	oajnatjit
oainnihit	oajnedit
oaittáskit	oajtáskit
oaivadit	oajvvadit
oaivvadit	oajvadit
oaivvildit	oajveldit
oaiuhit	oajodit
oakkastit	oakkastit
oakko7stit	oakkostit
oakkuhit	oakkodit
oalgguhit	oalgodit
oalistit	oalestit
oallásit	oallásit
oamastit	åmastit
oamásmit	oamásmit
oamášit	oamátjit
oanidit	oanedit
oanášit	oanátjit
oardnjudit	oarnnjodit
oasistit	oasestit
oasse7#ruhtadit	oasseruhtadit
oastalit	oasstalit
oasttašit	oastatjit
oastte7stit	oastestit
oasttihit	oastedit
oasttistit	oastestit
oasuhit	oasodit
oasástit	oasástit
oatnánit	oadnánit
oavnnjildit	oavnjeldit
oavnnjistit	oavnjestit
oazistit	oatsestit
oaččo7hit	oattjodit
oaččo7stit	oattjostit
oaččástit	oattjástit
oađđáhit	oaddádit
oađašit	ådatjit
oađe7stit	oadestit
oađihit	oadedit
oažžasit	oadtjasit
obehit	åbidit
odjodahttalit	ådjudahttalit
ogodit	ågudit
ogohahttalit	åguhahttalit
ohcalit	åhtsålit
ohpehit	åhpidit
oidnostit	åjnnustit
okkodit	åkkudit
oktedit	åktidit
oktestit	åktistit
oktii7#heivehit	åktij7hejvvidit
oktii#vástidit	åktijvásstedit
ollehit	ållidit
ollásit	ållåsit
olahit	ålådit
olgehit	ålggidit
olggos#golludit	ålgusgållodit
olggudit	ålgodit
olgguštit	ålgosjtit
olgodit	ålggudit
olgonit	ålggunit
ollalit	ållålit
ollistit	ållestit
ollásit	ållåsit
ološit	ålutjit
oláhit	ålådit
omardit	åmårdit
onddodit	åndudit
oppastit	åppåstit
oppašit	åppåtjit
orrostit	årrustit
ordnedit	årnnidit
orodit	årudit
ortnet#ráŋggáštit	årnitráŋgásjtit
ortniidit	årnijdit
orustit	årostit
oskkildit	åskeldit
oskulit	åsskolit
ovda#láigohit	åvddålájggudit
ovdadit	åvddådit
ovdan#loaiddastit	åvddånloajdastit
ovdan#čáie7hit	åvddåntjájedit
ovddas#vástidit	åvdåsvásstedit
ovddastit	åvdåstit
ovddeštit	åvdisjtit
ovddidit	åvdedit
ovddošit	åvdutjit
ovdduštit	åvdosjtit
ovdehit	åvddidit
ovdánit	åvddånit
ovehit	åvidit
ovttaidit	åvtåjdit
ovttastit	åvtåstit
ozadit	åtsådit
oččodit	åttjudit
ođadit	ådådit
ođasmit	ådåsmit
ođastit	ådåstit
ođašit	ådåtjit
ođđa#čalmmagastalit	åddåtjalmagastalit
ožoldit	åtjuldit
ožžodit	ådtjudit
pievladit	pievlladit
pievlladit	pievladit
piinnidit	pijnedit
prentedit	prenttidit
prentehit	prenttidit
rabadit	rabádit
rabaidit	rabájdit
rabastit	rabástit
rabbalit	rabbalit
rabe7stit	rabestit
rabistit	rabestit
rabihit	rabedit
ragadit	ragádit
ragahit	ragádit
ragihit	ragedit
raguhit	ragodit
rahkánit	rahkánit
rahpasit	rahpasit
rahpastit	rahpastit
rahppasit	rahppasit
rahpášit	rahpátjit
rahtasit	rahtasit
rahčalit	rahtjalit
ramppuhit	rampodit
ramsalit	ramssalit
ramssihit	ramsedit
rasildit	raseldit
rasttidit	rastedit
rasttildit	rasteldit
ravdadit	ravddadit
ravgadit	ravggadit
ravgehit	ravggidit
ravggadit	ravgadit
ravggahit	ravgadit
ravggihit	ravgedit
ravggodit	ravgudit
ravkalit	ravkkalit
ravkkihit	ravkedit
ravkkuhit	ravkodit
ravččuhit	ravtjodit
rađadit	radádit
rađastit	radástit
raŋgalit	raŋggalit
raŋggagit	raŋgagit
raŋggihit	raŋgedit
raŋgádit	raŋggádit
raŋihit	raŋedit
raŋistit	raŋestit
rašášit	rasjátjit
raššudit	rassjodit
ražahit	ratjádit
ražastit	ratjástit
ražáskit	ratjáskit
reaggánit	ræggánit
reahccalit	riehttsalit
reahidit	riehedit
reahjidit	riehjedit
reahttadit	riehttadit
reainnidit	riejnedit
reakčanit	riektjanit
realssistit	rielsestit
reanttidit	rientedit
reavggádit	rævgádit
reavžalit	rievttjalit
reavžžagit	rievtjagit
reavžžuhit	rievtjodit
reaškkihit	riesjkedit
reidestit	rejddistit
reikedit	rejkkidit
reimmodit	rejmudit
rekčohit	rektjudit
rentedit	renttidit
rentehit	renttidit
ribadit	ribádit
ribahit	ribádit
ribihit	ribedit
riccagit	rittsagit
ridnahit	riddnadit
riegádit	riegádit
riehkadit	riehkadit
riehkidit	riehkedit
riehtudit	riehtodit
rieibmudit	riejmmodit
rieiihit	riejjdit
rieiádit	riejádit
rieiáskit	riejáskit
riekkistit	riekkestit
riektadit	riektadit
rievdadit	rievddadit
rievddadit	rievdadit
rievidit	rievedit
rievttašit	rievtatjit
riežihit	rietjedit
riežádit	rietjádit
riggudit	riggodit
riggulit	riggolit
rihkkasit	rihkkasit
rihkkuhit	rihkkodit
rihko7stit	rihkostit
rihkustit	rihkostit
rihpastit	rihpastit
rihpašit	rihpatjit
rihpihit	rihpedit
rihppasit	rihppasit
rihppulit	rihppolit
rihčiidit	rihtjijdit
riidalit	rijddalit
riiddáskit	rijdáskit
riimmostit	rijmustit
rikkášit	rikkátjit
rimssagit	rimsagit
rimssistit	rimsestit
rimssodit	rimsudit
rimssuhit	rimsodit
rimssustit	rimsostit
rimškkagit	rimsjkagit
rinuhit	rinodit
rinččagit	rinttjagit
rinččistit	rinttjestit
rinžžistit	rintjestit
risttahit	ristadit
risttašit	ristatjit
ritnudit	ridnodit
rivdnjalit	rivnnjalit
rivnnjuhit	rivnjodit
rivzzagit	rivtsagit
rizagit	ritságit
rizihit	ritsedit
riđeštit	ridisjtit
riđđudit	riddodit
riŋgestit	riŋggistit
rišadit	risjádit
rišaidit	risjájdit
rišihit	risjedit
riškalit	rissjkalit
riškkihit	risjkedit
riškkuhit	risjkodit
rišo7stit	risjostit
riššudit	rissjodit
roabihit	roabedit
roahkadit	roahkadit
roahkasmit	roahkasmit
roahkastit	roahkastit
roahkkasit	roahkkasit
roahko7hit	roahkodit
roahkuhit	roahkodit
roahpihit	roahpedit
roahppánit	roahppánit
roaibbagit	roajbagit
roaibbádit	roajbádit
roaiskalit	roajsskalit
roaiskkagit	roajskagit
roaiskkuhit	roajskodit
roaivalit	roajvvalit
roaivvastit	roajvastit
roakčanit	roaktjanit
roakčasit	roaktjasit
roamssihit	roamsedit
roamššagit	roamsjagit
roanccagit	roantsagit
roanžžagit	roantjagit
roavnnjuhit	roavnjodit
roavvudit	roavvodit
roavádit	roavádit
roavččagit	roavtjagit
roađđahit	roaddadit
roađđidit	roaddedit
roaŋkahit	roaŋkkadit
roaŋkanit	roaŋkkanit
roaŋkkuhit	roaŋkodit
roaškalit	roassjkalit
roaškkagit	roasjkagit
roaškke7hit	roasjkedit
roaškkihit	roasjkedit
roaškkuhit	roasjkodit
robmahit	råbbmådit
rodjadit	rådjådit
roguhit	rågodit
rogádit	rågådit
rohcošit	råhtsutjit
rohkkáhit	råhkkådit
rohtiidit	råhtijdit
rohttedit	råhttidit
rohttehit	råhttidit
rohttestit	råhttistit
rohttásit	råhttåsit
rokkadit	råkkådit
rokkagit	råkkågit
rokkastit	råkkåstit
rokčehit	råktjidit
romášit	råmåtjit
ropmudit	råbmodit
rosvudit	råsvodit
rotnudit	rådnodit
rožagit	råtjågit
rubistit	rubestit
ruccistit	ruttsestit
ruddudit	ruddodit
rufaiditit	rufájditit
rugáhit	rugádit
ruhtadit	ruhtadit
ruibbagit	rujbagit
ruibbuhit	rujbodit
ruibbádit	rujbádit
ruivalit	rujvvalit
ruivvagit	rujvagit
ruivvidit	rujvedit
ruivváskit	rujváskit
ruiosmit	rujusmit
rullehit	rullidit
rumššagit	rumsjagit
runaidit	runájdit
runddihit	rundedit
runiidit	runijdit
runodit	runudit
ruodjadit	ruodjadit
ruohkadit	ruohkadit
ruohkastit	ruohkastit
ruohkkasit	ruohkkasit
ruohtadit	ruohtadit
ruohtahit	ruohtadit
ruohtastit	ruohtastit
ruohte7stit	ruohtestit
ruoibbagit	ruojbagit
ruoibbuhit	ruojbodit
ruoibbádit	ruojbádit
ruoidnadit	ruojnnadit
ruoinnašit	ruojnatjit
ruoiusmit	ruojosmit
ruoksahit	ruoksadit
ruonihit	ruonedit
ruossanit	ruossanit
ruosadit	ruosadit
ruosahit	ruosadit
ruossuhit	ruossodit
ruostudit	ruosstodit
ruovddástit	ruovdástit
ruovdádit	ruovddádit
ruovggadit	ruovgadit
ruovggádit	ruovgádit
ruovssihit	ruovsedit
ruovssildit	ruovseldit
ruovssuhit	ruovsodit
ruoškalit	ruossjkalit
ruoškke7hit	ruosjkedit
ruoškkihit	ruosjkedit
ruoškkuhit	ruosjkodit
ruoššastit	ruossjastit
ruožihit	ruotjedit
ruppodit	ruppudit
ruskestit	russkistit
rusuhit	rusodit
rusádit	rusádit
ruttagit	ruttagit
ruttidit	ruttedit
ruvvedit	ruvvidit
ruvaštit	ruvasjtit
ruvgalit	ruvggalit
ruvgánit	ruvggánit
ruvnnidit	ruvnedit
ruvssodit	ruvsudit
ruvžžuhit	ruvtjodit
ruččagit	ruttjagit
ruččistit	ruttjestit
ruđgalit	rurggalit
ruđodit	rududit
ruđuhit	rudodit
ruŋkkistit	ruŋkestit
ruškkodit	rusjkudit
ruššudit	russjodit
rábastit	rábástit
rábidit	rábedit
rábmehit	rábbmidit
rábo7stit	rábostit
rábustit	rábostit
rábádit	rábádit
ráfohit	ráfudit
ráfuhit	ráfodit
ráfáidit	ráfájdit
rágadit	rágádit
rágeštit	rágisjtit
rággalit	rággalit
rágádit	rágádit
ráhkadit	ráhkadit
ráhke7stit	ráhkestit
ráhkistit	ráhkestit
ráhkkanit	ráhkkanit
ráhkkedit	ráhkkidit
ráhkásmit	ráhkásmit
ráhpásmit	ráhpásmit
ráhpášit	ráhpátjit
ráhtalit	ráhtalit
ráiddostit	rájdustit
ráiggidit	rájgedit
ráigánit	rájggánit
ráikidit	rájkkedit
ráikkistit	rájkestit
ráillistit	rájllestit
ráinnodit	rájnudit
ráiskkagit	rájskagit
ráiskkidit	rájskedit
ráiskkiidit	rájskijdit
ráiskkistit	rájskestit
ráiskudit	rájsskodit
ráivvastit	rájvastit
ráiadit	rájádit
ráiahit	rájádit
rákkihit	rákkedit
rákkášit	rákkátjit
rámmehit	rámmidit
rámidit	rámedit
rámiidit	rámijdit
rámskkagit	rámskagit
rámssagit	rámsagit
rámškalit	rámssjkalit
rámškkihit	rámsjkedit
rámškkistit	rámsjkestit
rámškkodit	rámsjkudit
rámškkuhit	rámsjkodit
rámškkádit	rámsjkádit
rámššagit	rámsjagit
ránodit	ránudit
ránččagit	ránttjagit
rápmadit	rábmadit
rápmustit	rábmostit
ráppaštit	ráppasjtit
rátkkašit	rátkkatjit
rávdadit	rávddadit
rávddásmit	rávdásmit
rávjjastit	rávjastit
rávkalit	rávkkalit
rávkkahit	rávkadit
rávásmit	rávásmit
rávžadit	rávttjadit
rávžžašit	rávtjatjit
rávžžildit	rávtjeldit
ráččagit	ráttjagit
ráđahit	rádádit
ráđaidit	rádájdit
ráđastit	rádástit
ráđihit	rádedit
ráđistit	rádestit
ráđđidit	ráddedit
ráŋggáštit	ráŋgásjtit
ráškalit	rássjkalit
ráškkihit	rásjkedit
rášudit	rásjodit
ráššudit	rássjodit
rážžadit	rádtjadit
saddjehit	saddjidit
sadjanit	sadjanit
sagadit	sagádit
sagahit	sagádit
sahkanit	sahkanit
sahkiidit	sahkijdit
sahkkehit	sahkkidit
saidnadit	sajnnadit
sainnahit	sajnadit
saiustit	sajostit
saiuštit	sajosjtit
saiásmit	sajásmit
sakŋadit	sagŋadit
sakŋidit	sagŋedit
salastit	salástit
salggiidit	salgijdit
salkalit	salkkalit
salkasit	salkkasit
salkkihit	salkedit
salkkuhit	salkodit
salodit	saludit
saluhit	salodit
samaidit	samájdit
sartudit	sarttodit
satnjasit	sadnjasit
sattihit	sattedit
savdadit	savddadit
savddastit	savdastit
savdnjilit	savnnjelit
savihit	savedit
savkalit	savkkalit
savkkuhit	savkodit
savnnjašit	savnjatjit
savnnjihit	savnjedit
seabadit	siebadit
seaggudit	sieggodit
seaguhit	siegodit
seagáskit	sægáskit
seahkanit	siehkanit
seahkidit	siehkedit
seahkánit	sæhkánit
seailluhit	siejllodit
seailudit	siejlodit
seaivalit	siejvvalit
seaivve7hit	siejvedit
seaivvuhit	siejvodit
seaivvádit	sæjvádit
seakkidit	siekkedit
seakkášit	sækkátjit
seakŋudit	siegŋodit
sealgadit	sielggadit
sealggahit	sielgadit
sealgádit	sælggádit
seallasit	siellasit
seanadit	sienadit
searggihit	siergedit
searvidit	siervvedit
searvvadit	siervadit
seatnadit	siednadit
seavadit	sievadit
seavašit	sievatjit
seavddagit	sievdagit
seave7stit	sievestit
seavnnjahit	sievnjadit
seavnnjašit	sievnjatjit
seavnnjihit	sievnjedit
seavnnjuhit	sievnjodit
seavnnjášit	sævnjátjit
seavvilit	sievvelit
segodit	segudit
seivvodit	sejvudit
selehit	selidit
selvehit	selvvidit
sepmohit	sebmudit
sevddiidit	sevdijdit
sevnnjodit	sevnjudit
sevttodit	sevtudit
sibildit	sibeldit
sibirdit	siberdit
sidjádit	sidjádit
siedjudit	siedjodit
siektadit	siektadit
sieradit	sieradit
sierahit	sieradit
sierkŋadit	sierŋadit
sierranit	sierranit
sievttastit	sievtastit
sihkastit	sihkastit
sihke7stit	sihkestit
sihkkasit	sihkkasit
sihkodit	sihkudit
sihkuhit	sihkodit
siiddastit	sijdastit
siivvosmit	sijvusmit
sikkildit	sikkeldit
sildásit	silldásit
silludit	sillodit
silášit	silátjit
sinjaidit	sinjájdit
sirddašit	sirdatjit
sirddihit	sirdedit
sirdásit	sirddásit
sirgŋadit	sirŋŋadit
sisa#fievrre7dit	sisafievredit
sisa#fievrridit	sisafievredit
sisa#gáibidit	sisagájbbedit
sisa#čálihit	sisatjáledit
siskkidit	siskedit
siskkildit	siskeldit
siskkuštit	siskosjtit
siskánit	sisskánit
sitnjasit	sidnjasit
sittardit	sittardit
sivahit	sivádit
sivdnidit	sivnnedit
sivjjogastalit	sivjugastalit
sivladit	sivlladit
siđasmit	sidásmit
siđgŋadit	sirŋŋadit
siđvahit	sirvvadit
siđvvagit	sirvagit
skabastit	skabástit
skahraidit	skahrajdit
skahrihit	skahredit
skaldduhit	skaldodit
skarkkihit	skarkedit
skavvehit	skavvidit
skavžžahit	skavtjadit
skavžžašit	skavtjatjit
skeaikkihit	skiejkedit
skealmmastit	skielmastit
skearro7stit	skierrostit
skearrustit	skierrostit
skeartnjagit	skiernjagit
skeavkádit	skævkkádit
skeavkáhit	skævkkádit
skeavžžihit	skievtjedit
skeavžžuhit	skievtjodit
skelbmošit	skelmmutjit
skelččiidit	skeltjijdit
skerrostit	skerrustit
skertnjiidit	skernjijdit
skevvehit	skevvidit
skibahit	skibádit
skielgahit	skielggadit
skielggagit	skielgagit
skielgguhit	skielgodit
skielttardit	skieltardit
skierpmuhit	skiermodit
skierpmádit	skiermádit
skierro7stit	skierrostit
skiervanit	skiervvanit
skievttardit	skievtardit
skievttidit	skievtedit
skievvidit	skievvedit
skihkidit	skihkedit
skihppodit	skihppudit
skihtardit	skihtardit
skihčahit	skihtjadit
skihččahit	skihttjadit
skilahit	skiládit
skilaidit	skilájdit
skilgalit	skilggalit
skilganit	skilgganit
skilgge7hit	skilgedit
skilihit	skiledit
skilkalit	skilkkalit
skilkke7hit	skilkedit
skilkkihit	skilkedit
skilkkuhit	skilkodit
skilttardit	skiltardit
skindošit	skinddutjit
skirragit	skirragit
skirruhit	skirrodit
skirvanit	skirvvanit
skirvehit	skirvvidit
skivvehit	skivvidit
skivllagit	skivlagit
skivžžagit	skivtjagit
skiđardit	skidárdit
skiŋgalit	skiŋggalit
skiŋggihit	skiŋgedit
skiŋgguhit	skiŋgodit
skiŋggádit	skiŋgádit
skoabahit	skåbadit
skoabaidit	skåbajdit
skoabihit	skoabedit
skoalihit	skoaledit
skoalkalit	skoalkkalit
skoalkke7hit	skoalkedit
skoalkkihit	skoalkedit
skoalkkuhit	skoalkodit
skoarahit	skåradit
skoaraidit	skårajdit
skoarihit	skoaredit
skoarragit	skoarragit
skoarččagit	skoartjagit
skoavddagit	skoavdagit
skoavdudit	skoavddodit
skoavhllagit	skoavhlagit
skoavhludit	skoavhllodit
skoavkalit	skoavkkalit
skoavkke7hit	skoavkedit
skoavkkihit	skoavkedit
skoavkkuhit	skoavkodit
skoađastit	skådastit
skoažihit	skoatjedit
skolladit	skållådit
skolppagit	skålpågit
skolppuhit	skålpodit
skolvvagit	skålvågit
skubbestit	skubbistit
skuhraidit	skuhrajdit
skuhrihit	skuhredit
skuibahit	skujbbadit
skuibbagit	skujbagit
skulkkodit	skulkudit
skulčalit	skulttjalit
skulččihit	skultjedit
skulččuhit	skultjodit
skunjaidit	skunjájdit
skunjihit	skunjedit
skuoivvagit	skuojvagit
skuolaidit	skuolajdit
skuolffuhit	skuolfodit
skuoljastit	skuoljjastit
skuolkasit	skuolkkasit
skuolkkastit	skuolkastit
skuonjaidit	skuonjajdit
skuonjuhit	skuonjodit
skuortnagit	skuornagit
skuožurdit	skuotjordit
skurkkihit	skurkedit
skurragit	skurragit
skurtnjagit	skurnjagit
skurtnjuhit	skurnjodit
skurvvagit	skurvagit
skurččagit	skurtjagit
skuvaidit	skuvájdit
skuvihit	skuvedit
skuvnnjagit	skuvnjagit
skuŋkkagit	skuŋkagit
skuŋkkuhit	skuŋkodit
skužagit	skutjágit
skužaidit	skutjájdit
skužistit	skutjestit
skáhčasit	skáhtjasit
skáidnedit	skájnnidit
skáiaidit	skájájdit
skáiihit	skájjdit
skáktádit	skáktádit
skálahit	skáládit
skálaidit	skálájdit
skálbmestit	skálmmistit
skálihit	skáledit
skálkkastit	skálkastit
skálkkihit	skálkedit
skálkošit	skálkkutjit
skálmmastit	skálmastit
skárastit	skárástit
skárbbagit	skárbagit
skávgadit	skávggadit
skávgalit	skávggalit
skávuhit	skávodit
skážastit	skátjástit
skážihit	skátjedit
skážádit	skátjádit
smarffagit	smarfagit
smarvvagit	smarvagit
smealčagit	smielttjagit
smiehtadit	smiehtadit
smiehtahit	smiehtadit
smiergalit	smierggalit
smierggihit	smiergedit
smiergguhit	smiergodit
smierrudit	smierrodit
smiezaidit	smietsajdit
smirezit	smiritsit
smirošit	smirutjit
smiđásmit	smidásmit
smoaldanit	smoalldanit
smoggidit	småggedit
smokkagit	småkkågit
smokkodit	småkkudit
smolggiidit	smålgijdit
smollanit	smållånit
smorodit	smårudit
smáhkiidit	smáhkijdit
smáittášit	smájtátjit
smávuhit	smávodit
smávvudit	smávvodit
snahpastit	snahpastit
snarrodit	snarrudit
snaraidit	snarájdit
snarragit	snarragit
sneaidadit	sniejddadit
snelkkodit	snelkudit
snielásmit	snielásmit
snievkalit	snievkkalit
snievkkuhit	snievkodit
snihpastit	snihpastit
snihpodit	snihpudit
snihppasit	snihppasit
snirkkagit	snirkagit
snirkkuhit	snirkodit
snoabihit	snoabedit
snoabádit	snoabádit
snoaggudit	snoaggodit
snoakkášit	snoakkátjit
snoalkkistit	snoalkestit
snogagit	snågågit
snoguhit	snågodit
snolkkagit	snålkågit
snorrehit	snårridit
snorránit	snårrånit
snorragit	snårrågit
snorranit	snårrånit
snorrasit	snårråsit
snorruhit	snårrodit
snuohtardit	snuohtardit
snuolggidit	snuolgedit
snuolggistit	snuolgestit
snuorddildit	snuordeldit
snuordudit	snuorddodit
snurkkihit	snurkedit
snuskkihit	snuskedit
snuđádit	snudádit
snárkanit	snárkkanit
snárkkagit	snárkagit
snárkudit	snárkkodit
snávggodit	snávgudit
soabadit	såbadit
soabahit	såbadit
soabbulit	soabbolit
soadjádit	soadjádit
soaggudit	soaggodit
soahpadit	soahpadit
soaigge7hit	soajgedit
soaiggihit	soajgedit
soaikulit	soajkkolit
soaimmadit	soajmadit
soaitte7stit	soajtestit
soaldudit	soalldodit
soalsidit	soalssedit
soalssidit	soalsedit
soalssistit	soalsestit
soappastit	soappastit
soappástit	soappástit
soarcalit	soarttsalit
soardidit	soarddedit
soardásit	soarddásit
soarpudit	soarppodit
soasihit	soasedit
soatkasit	soatkasit
soavddildit	soavdeldit
soavludit	soavllodit
soađistit	soadestit
soađáskit	soadáskit
soaŋuhit	soaŋodit
soažžudit	soadtjodit
sodjalit	sådjålit
sodjasit	sådjåsit
sodnjánit	såddnjånit
sohpasit	såhpåsit
soicalit	såjttsålit
soiccihit	såjtsedit
soiccistit	såjtsestit
soiccuhit	såjtsodit
soiccáskit	såjtsåskit
soidadit	såjddådit
soiadit	såjådit
soiahit	såjådit
soiihit	såjjdit
soktudit	såktodit
solgádit	sålggådit
solodit	såludit
solžidit	sålltjedit
sonjuhit	sånjodit
soradit	sårådit
sorbmanit	sårmmånit
sorbmehit	sårmmidit
sorjalit	sårjjålit
sotnadit	sådnådit
sovkalit	såvkkålit
sovkkuhit	såvkodit
sođagit	sådågit
spabbalit	spabbalit
spahčalit	spahtjalit
spaigasit	spajggasit
spaigguhit	spajgodit
spakkagit	spakkagit
spalcadit	spalttsadit
spalccidit	spaltsedit
spalccihit	spaltsedit
spanuhit	spanodit
spappuhit	spappodit
sparrudit	sparrodit
sparahit	sparádit
sparaidit	sparájdit
spargalit	sparggalit
spargguhit	spargodit
sparkalit	sparkkalit
sparkelastit	sparkkilastit
sparkke7hit	sparkedit
sparkkihit	sparkedit
sparkkuhit	sparkodit
spatnjasit	spadnjasit
spažahit	spatjádit
spažaidit	spatjájdit
spažihit	spatjedit
spažuhit	spatjodit
speaigalit	spiejggalit
spealastit	spielastit
speažžasit	spiedtjasit
spiehkastit	spiehkastit
spiehkkasit	spiehkkasit
spielastit	spielastit
spierggadit	spiergadit
spierggádit	spiergádit
spihkodit	spihkudit
spiiddistit	spijdestit
spiidne#guođo7hit	spijnneguododit
spiidnošit	spijnnutjit
spinjaidit	spinjájdit
spivkohit	spivkkudit
spivkošit	spivkkutjit
spoahke7hit	spoahkedit
spoahkihit	spoahkedit
spoahkkalit	spoahkkalit
spoahkuhit	spoahkodit
spoggalit	spåggålit
spokkuhit	spåkkodit
spulžudit	spulltjodit
spággudit	spággodit
spáigalit	spájggalit
spáigasit	spájggasit
spáiggihit	spájgedit
spáiggádit	spájgádit
spáikasit	spájkkasit
spáikkastit	spájkastit
spáikkihit	spájkedit
spáittiidit	spájtijdit
spálčudit	spálttjodit
spálččildit	spáltjeldit
spálžudit	spálltjodit
spálžžildit	spáltjeldit
spánastit	spánástit
spánžadit	spánttjadit
spánžžagit	spántjagit
spánžžistit	spántjestit
spárkadit	spárkkadit
srubistit	srubestit
staigadit	stajggadit
staiggiidit	stajgijdit
staiidit	stajjdit
stalkadit	stalkkadit
stargadit	starggadit
starggasmit	stargasmit
stavkáhit	stavkkádit
steaikalit	stiejkkalit
steaikke7hit	stiejkedit
steanžalit	stienttjalit
steanžáhit	stænttjádit
steanžžagit	stientjagit
steanžže7hit	stientjedit
steanžžihit	stientjedit
steanžžuhit	stientjodit
steavlidit	stievlledit
steavžžuhit	stievtjodit
steaččagit	stiettjagit
steačče7hit	stiettjedit
steaččihit	stiettjedit
steaččuhit	stiettjodit
steažžalit	stiedtjalit
steažžasit	stiedtjasit
stielgudit	stielggodit
stielkudit	stielkkodit
stielkádit	stielkkádit
stihkadit	stihkadit
stihkádit	stihkádit
stilččihit	stiltjedit
stilččuhit	stiltjodit
stilččádit	stiltjádit
stircalit	stirttsalit
stirccihit	stirtsedit
stirccuhit	stirtsodit
stirdudit	stirddodit
stoagáskit	stoagáskit
stoaidudit	stoajddodit
stoaluhit	stoalodit
stoancalit	stoanttsalit
stoancce7hit	stoantsedit
stoanccuhit	stoantsodit
stoanžalit	stoanttjalit
stoanžžihit	stoantjedit
stoanžžuhit	stoantjodit
stoarbmiditit	stoarmmeditit
stoavkalit	stoavkkalit
stoavkke7hit	stoavkedit
stoavkkuhit	stoavkodit
stohkkadit	ståhkkådit
stohkkádit	ståhkkådit
stohppádit	ståhppådit
stolkkihit	stålkedit
stoncalit	stånttsålit
stonccuhit	ståntsodit
strubistit	strubestit
stráillistit	strájllestit
stuibmidit	stujmmedit
stuimmáskit	stujmáskit
stuláskit	stuláskit
stulčalit	stulttjalit
stulččihit	stultjedit
stulččuhit	stultjodit
stumppuhit	stumpodit
stuoridit	stuoredit
stuorrudit	stuorrodit
stuorásmit	stuorásmit
stuorášit	stuorátjit
sturgalit	sturggalit
sturggihit	sturgedit
sturjjidit	sturjedit
stuŋgadit	stuŋggadit
stuŋgehit	stuŋggidit
stužahit	stutjádit
stužaidit	stutjájdit
stužihit	stutjedit
stágguditit	stággoditit
stáhpardit	stáhpardit
stáhpádit	stáhpádit
stáidnadit	stájnnadit
stáipasit	stájppasit
stáippardit	stájpardit
stáippasmit	stájpasmit
stáippodit	stájpudit
stáippuhit	stájpodit
stánžudit	stánttjodit
stávedit	stávidit
stávrrihit	stávredit
stávrruhit	stávrodit
stávrádit	stávrrádit
stávráhit	stávrrádit
stávžžihit	stávtjedit
stáđásmit	stádásmit
suddadit	suddadit
suddohit	suddudit
suddudit	suddodit
sugadit	sugádit
sugahit	sugádit
suhkalit	suhkalit
suhpodit	suhpudit
suhtadit	suhtadit
suhtihit	suhtedit
suhttadit	suhttadit
suibbodit	sujbudit
suiahit	sujádit
sulastit	sulástit
suodjalit	suodjalit
suohkudit	suohkodit
suohppádit	suohppádit
suohppásit	suohppásit
suoibbihit	suojbedit
suoibbuhit	suojbodit
suoibbádit	suojbádit
suoibánit	suojbbánit
suoivve7hit	suojvedit
suoivvihit	suojvedit
suoiásmit	suojásmit
suokkagit	suokkagit
suokkardit	suokkardit
suoksadit	suoksadit
suolbmudit	suolmmodit
suoldnudit	suolnnodit
suolle7#fievrridit	suollefievredit
suoládit	suoládit
suomastit	suomastit
suonjadit	suonjadit
suonjardit	suonjardit
suorganit	suorgganit
suorggahit	suorgadit
suorggidit	suorgedit
suorranit	suorranit
suortudit	suorttodit
suoskkahit	suoskadit
suoskkastit	suoskastit
suossadit	suossadit
suosttuhit	suostodit
suotnjalit	suodnjalit
suovastit	suovastit
suovganit	suovgganit
suovssildit	suovseldit
suovvadit	suovvadit
suovvidit	suovvedit
suovvudit	suovvodit
suovvádit	suovvádit
suođihit	suodedit
suođđadit	suoddadit
suožahit	suotjadit
surgehit	surggidit
surggiidit	surgijdit
sustilit	susstelit
susttašit	sustatjit
sutmmistit	sutmmestit
suttadit	suttadit
suttihit	suttedit
suvccastit	suvttsastit
suvddihit	suvdedit
suvjadit	suvjjadit
suvlliidit	suvlijdit
suvrragit	suvragit
suvrriidit	suvrijdit
suvrro7stit	suvrostit
suvrrustit	suvrostit
suvrrásmit	suvrásmit
suvrudit	suvrrodit
suvrulit	suvrrolit
suvččagit	suvtjagit
sáddedit	sáddidit
sáddehit	sáddidit
ságastit	ságástit
sággalit	sággalit
sáhcasit	sáhtsasit
sáhkkohit	sáhkkudit
sáhkkuhit	sáhkkodit
sáhko7hit	sáhkodit
sáhkuhit	sáhkodit
sáhpodit	sáhpudit
sáhtašit	sáhtatjit
sáhto7stit	sáhtostit
sáhttalit	sáhttalit
sáhčalit	sáhtjalit
sáhčasit	sáhtjasit
sáiganit	sájgganit
sáiggagit	sájgagit
sáimmastit	sájmastit
sáittástit	sájtástit
sáivadit	sájvvadit
sáivvildit	sájveldit
sákkagit	sákkagit
sákkastit	sákkastit
sálttiidit	sáltijdit
sálttášit	sáltátjit
sáltudit	sálltodit
sámildit	sámeldit
sámástit	sámástit
sánuhit	sánodit
sánáidit	sánájdit
sárastit	sárástit
sárdnidit	sárnnedit
sárgasit	sárggasit
sárggastit	sárgastit
sárggodit	sárgudit
sárgulit	sárggolit
sárjjastit	sárjastit
sárjádit	sárjjádit
sárrasit	sárrasit
sártnaštit	sárnasjtit
sártnodit	sárnudit
sártnuhit	sárnodit
sártnádit	sárnádit
sátne7#lahkástit	sádnelahkástit
sátne7#viđástit	sádnevidástit
sátnádit	sádnádit
sávadit	sávádit
sávnnjodit	sávnjudit
sávnnodit	sávnudit
sávrudit	sávrrodit
sávvalit	sávvalit
sázastit	sátsástit
sázodit	sátsudit
sáŋardit	sáŋárdit
teahtistit	tiehtestit
teahtásmit	tæhtásmit
tennjedit	tennjidit
tevdnedit	tevnnidit
tiggedit	tiggidit
tiiddastit	tijdastit
udjosit	udjusit
uhcahastalit	uhtsahastalit
uhccudit	uhttsodit
uhccánit	uhttsánit
uhcedit	uhtsidit
uhcidit	uhtsedit
uhcáhastalit	uhtsáhastalit
uhcášit	uhtsátjit
uhkidit	uhkedit
uiosmit	ujusmit
uiošit	ujutjit
ulahit	uládit
unnudit	unnodit
unnánit	unnánit
unnidit	unnedit
unnáhastalit	unnáhastalit
unnášit	unnátjit
unohastit	unuhastit
unohastalit	unuhastalit
urddistit	urdestit
uskkidit	uskedit
uskánit	usskánit
uvhridit	uvhredit
uŋggardit	uŋgardit
vabaidit	vabájdit
vadjasit	vadjasit
vaiadit	vajádit
vaiahit	vajádit
vaiuldit	vajoldit
vakŋalit	vagŋalit
valastit	valástit
valjášit	valjjátjit
valášit	valátjit
vanadit	vanádit
vanahit	vanádit
varasmit	varásmit
varastit	varástit
vardahit	varddadit
varddašit	vardatjit
varradit	varradit
vasmalit	vassmalit
vaspalit	vasspalit
vatnalit	vadnalit
vatnasit	vadnasit
vavdadit	vavddadit
vavddadit	vavdadit
vađastit	vadástit
vađustit	vadostit
vaŋkkagit	vaŋkagit
vaŋuhit	vaŋodit
vaŋádit	vaŋádit
vašuhit	vasjodit
vašáskit	vasjáskit
vaššulit	vassjolit
veagahit	viegadit
veaguhit	viegodit
veahke7hit	viehkedit
veahkehit	viehkidit
veahkihit	viehkedit
veahtalit	viehtalit
veahttadit	viehttadit
veahttalit	viehttalit
veahtudit	viehtodit
veaisidit	viejssedit
veaie7hit	viejedit
veaie7stit	viejestit
veaiihit	viejjdit
vealahit	vieladit
veallahit	vielladit
veallánit	vællánit
vealtadit	vielltadit
vealuhit	vielodit
vealčalit	vielttjalit
vealčasit	vielttjasit
vealččagit	vieltjagit
vealčče7hit	vieltjedit
vealččihit	vieltjedit
veanzasit	vienttsasit
veanzzagit	vientsagit
vearahit	vieradit
veardidit	vierddedit
veardnidit	viernnedit
vearidit	vieredit
vearistit	vierestit
vearjudit	vierjjodit
vearránit	værránit
veartnáskit	værnáskit
vearuhit	vierodit
vearáskit	væráskit
veatnáskit	vædnáskit
veavssástit	vævsástit
veavttastit	vievtastit
veašidit	vietjedit
veažirdit	vietjerdit
vehtiidit	vehtijdit
veiggodit	vejgudit
veiolaštit	vejulasjtit
velledit	vellidit
vellehit	vellidit
velehit	velidit
velgohit	velggudit
veriidit	verijdit
verrošit	verrutjit
viccadit	vittsadit
vieccistit	viettsestit
viegadit	viegadit
viegahit	viegadit
vieggasit	vieggasit
viehkalit	viehkalit
viehttalit	viehttalit
vielgahit	vielggadit
vielggašit	vielgatjit
vielggihit	vielgedit
vielggildit	vielgeldit
vielgguhit	vielgodit
vielggášit	vielgátjit
vielgánit	vielggánit
vielladit	vielladit
viergádit	vierggádit
vierradit	vierradit
vierttudit	viertodit
vierášit	vierátjit
viesihit	viesedit
viessadit	viessadit
vietnadit	viednadit
vievgŋadit	vievgŋadit
vieččahit	viettjadit
vieččildit	viettjeldit
viežžalit	viedtjalit
vihahit	vihádit
vihkkehit	vihkkidit
vihpadit	vihpadit
vihttánit	vihttánit
viibadit	vijbbadit
viiddidit	vijdedit
viidudit	vijddodit
viidánit	vijddánit
viidáset#fievrridit	vijddásetfievredit
viidáset#gárgedit	vijddásetgárggidit
viimmáskit	vijmáskit
viissášit	vijsátjit
viisudit	vijssodit
vikkahit	vikkadit
vikšadit	viksjadit
vildadit	villdadit
vilddosmit	vildusmit
vilddošit	vildutjit
vilddálgit	vildálgit
vilddáskit	vildáskit
vildudit	villdodit
vileštit	vilisjtit
vilggodit	vilgudit
vilppagit	vilpagit
vilppastit	vilpastit
vilppihit	vilpedit
vilppádit	vilpádit
vilššagit	vilsjagit
vilššastit	vilsjastit
vilššádit	vilsjádit
vinjagit	vinjágit
vinjildit	vinjeldit
viradit	virádit
virgádit	virggádit
virgái#nammadit	virggájnammadit
virgáidit	virggájdit
virkkodit	virkudit
virkkosmit	virkusmit
virradit	virradit
virtestit	virttistit
virttásmit	virtásmit
visostit	visustit
vistilit	visstelit
vizardit	vitsárdit
višahit	visjádit
viššalit	vissjalit
vižardit	vitjárdit
vuhpodit	vuhpudit
vuhtodit	vuhtudit
vuhttodit	vuhttudit
vuigestit	vujggistit
vuobaidit	vuobajdit
vuoddjáhit	vuoddjádit
vuodjalit	vuodjalit
vuodje7lit	vuodjelit
vuodjilit	vuodjelit
vuodjudit	vuodjodit
vuogasmit	vuogasmit
vuogašit	vuogatjit
vuogihit	vuogedit
vuohkadit	vuohkadit
vuohpádit	vuohpádit
vuohttalit	vuohttalit
vuohčudit	vuohtjodit
vuoidalit	vuojddalit
vuoidasit	vuojddasit
vuoiddadit	vuojdadit
vuoiddastit	vuojdastit
vuoigadit	vuojggadit
vuoigatvuođa#vuođđudit	vuojggatvuodavuoddodit
vuoinnidit	vuojnedit
vuoissadit	vuojsadit
vuoissihit	vuojsedit
vuoissádit	vuojsádit
vuoitalit	vuojttalit
vuoiŋŋadit	vuojŋadit
vuoiŋŋastaladit	vuojŋastaladit
vuoiŋŋastit	vuojŋastit
vuoiŋŋe7hit	vuojŋedit
vuoiŋŋidit	vuojŋedit
vuoiŋŋihit	vuojŋedit
vuoiadit	vuojadit
vuoiahit	vuojadit
vuoiašit	vuojatjit
vuoie7hit	vuojedit
vuoie7stit	vuojestit
vuoiihit	vuojjdit
vuoiildit	vuojjldit
vuoiuhit	vuojodit
vuoiádit	vuojádit
vuoladit	vuoladit
vuolgalit	vuolggalit
vuolggadit	vuolgadit
vuolggahit	vuolgadit
vuolgilit	vuolggelit
vuolidit	vuoledit
vuolildit	vuoleldit
vuollasit	vuollasit
vuolludit	vuollodit
vuollái#sárggastit	vuollájsárgastit
vuollái#sázastit	vuollájsátsástit
vuollánit	vuollánit
vuollástit	vuollástit
vuoluštit	vuolosjtit
vuolšudit	vuolssjodit
vuonjasmit	vuonjasmit
vuorasmit	vuorasmit
vuorašit	vuoratjit
vuorbádit	vuorbbádit
vuorddašit	vuordatjit
vuordde7stit	vuordestit
vuorddihit	vuordedit
vuorddildit	vuordeldit
vuordilit	vuorddelit
vuorjjildit	vuorjeldit
vuorjjášit	vuorjátjit
vuortnuhit	vuornodit
vuoruhit	vuorodit
vuose7hit	vuosedit
vuosihit	vuosedit
vuosmme7stit	vuosmestit
vuosmmistit	vuosmestit
vuoste#beallái7#gaskkustit	vuosstebælláj7gaskostit
vuoste7#hágostit	vuosstehágustit
vuoste#jienastit	vuosstejienastit
vuosttaldit	vuostaldit
vuosttildit	vuosteldit
vuostánit	vuosstánit
vuotnámastalit	vuodnámastalit
vuovdalit	vuovddalit
vuovdduštit	vuovdosjtit
vuovdášit	vuovddátjit
vuovssadit	vuovsadit
vuovssihit	vuovsedit
vuovssuhit	vuovsodit
vuovzasit	vuovttsasit
vuovzásit	vuovttsásit
vuoččistit	vuottjestit
vuođustit	vuodostit
vuođuštit	vuodosjtit
vuođđudit	vuoddodit
vuoŋásmit	vuoŋásmit
vuoššastit	vuossjastit
vuoššudit	vuossjodit
vuožuhit	vuotjodit
vurkkodit	vurkudit
vuvdošit	vuvddutjit
váccahit	váttsadit
váccašit	váttsatjit
váccihit	váttsedit
váddudit	váddodit
vádjolit	vádjulit
váfistit	váfestit
váguhit	vágodit
váhkkasit	váhkkasit
váhnemastalit	váhnimastalit
váibadit	vájbbadit
váibbadit	vájbadit
váibbahit	vájbadit
váidalit	vájddalit
váidudit	vájddodit
váikkuhit	vájkodit
váillahit	vájlladit
váiludit	vájlodit
váimmoskit	vájmuskit
váinnuhit	vájnodit
váipasit	vájppasit
váippastit	vájpastit
váippihit	vájpedit
váippodit	vájpudit
váippádit	vájpádit
váivvahit	vájvadit
váivvidit	vájvedit
váivvihit	vájvedit
váivvášit	vájvátjit
váialdit	vájáldit
váiuldit	vájoldit
váksáditit	váksáditit
vákšodit	váksjudit
vákšohit	váksjudit
vákšostit	váksjustit
válbmanit	válmmanit
váldalit	válldalit
válddahit	váldadit
váldde7stit	váldestit
válddihit	váldedit
válddáhit	váldádit
válganit	válgganit
válladit	válladit
válmmastit	válmastit
válmmaštit	válmasjtit
vánastit	vánástit
vánddardit	vándardit
vánttasmit	vántasmit
vánášit	vánátjit
várašit	váratjit
várdahit	várddadit
várgehit	várggidit
várjalit	várjjalit
várohit	várudit
várssuhit	vársodit
váruhit	várodit
vásihit	vásedit
vástidit	vásstedit
vásttostit	vástustit
vátnudit	vádnodit
váttásmit	váttásmit
váttášit	váttátjit
vávašit	vávatjit
vávjjašit	vávjatjit
vávllo7stit	vávlostit
vávllustit	vávlostit
vázzilit	vádtselit
vázzodit	vádtsudit
ábbasit	ábbasit
ábbudit	ábbodit
ábuhit	ábodit
áccuhit	áttsodit
ádjánit	ádjánit
ádjásit	ádjásit
ággadit	ággadit
áhcahit	áhtsadit
áhpe7golgadit	áhpegolgadit
áhppádit	áhppádit
áhpánit	áhpánit
áhpásmit	áhpásmit
áhtaštit	áhtasjtit
áibadit	ájbbadit
áibbašit	ájbatjit
áiccadit	ájtsadit
áiddastit	ájdastit
áiddo7stit	ájdostit
áitalit	ájttalit
áittardit	ájtardit
áittašit	ájtatjit
áiihit	ájjdit
ákkastit	ákkastit
állanit	állanit
állestit	állistit
álbmasit	álmmasit
álgalit	álggalit
álggadit	álgadit
álggahit	álgadit
álkidit	álkkedit
állahit	álladit
álmmastit	álmastit
áluhit	álodit
álustit	álostit
ánodit	ánudit
áno7stit	ánostit
ánssáhit	ánsádit
ánssášit	ánsátjit
ánuhit	ánodit
ánustit	ánostit
áppastit	áppastit
áppodit	áppudit
áppuhit	áppodit
áppustit	áppostit
áppádit	áppádit
áradit	árádit
árasmit	árásmit
árašit	áratjit
árbestit	árbbistit
árggašit	árgatjit
árggášit	árgátjit
árgudit	árggodit
áristit	árestit
árkkálmastalit	árkálmastalit
árkkášit	árkátjit
árpmihit	ármedit
árpmo7štit	ármosjtit
árpmášit	ármátjit
árranit	árranit
árvalit	árvvalit
árvidit	árvvedit
árvvasmit	árvasmit
árvvašit	árvatjit
árvvoštit	árvusjtit
árvádahttalit	árvvádahttalit
áráskit	áráskit
ásadit	ásádit
ásahit	ásádit
ásaidit	ásájdit
ásodit	ásudit
ássalit	ássalit
ástadit	ásstadit
ásustit	ásostit
ávaštit	ávasjtit
ávddasmit	ávdasmit
ávdnedit	ávnnidit
ávdniditit	ávnneditit
ávkkuhit	ávkodit
ávládit	ávlládit
ávnnaldit	ávnaldit
ávnnastit	ávnastit
ávvudit	ávvodit
ávžžuhit	ávtjodit
áŋggašit	áŋgatjit
áŋggaštit	áŋgasjtit
áŋggirdit	áŋgerdit
ášše#meannudit	ássjemiennodit
ášše7#ráhkkanit	ássjeráhkkanit
ášše#čuoččuhit	ássjetjuottjodit
áššodit	ássjudit
áššudit	ássjodit
áŧestit	átistit
čabadit	tjabádit
čabardit	tjabárdit
čagalduhte7stit	tjagálduhtestit
čagardit	tjagárdit
čagarduhte7stit	tjagárduhtestit
čahkkadit	tjahkkadit
čahpalit	tjahpalit
čahraidit	tjahrajdit
čahrralit	tjahrralit
čahrádit	tjahrádit
čaimmadit	tjajmadit
čaimmahit	tjajmadit
čaimme7hit	tjajmedit
čaimmihit	tjajmedit
čaimmádit	tjajmádit
čakčulit	tjaktjolit
čaladit	tjaládit
čalahit	tjaládit
čalastit	tjalástit
čalbmadit	tjalmmadit
čalgadit	tjalggadit
čalgalit	tjalggalit
čalggadit	tjalgadit
čalggahit	tjalgadit
čalgge7hit	tjalgedit
čalggihit	tjalgedit
čallalit	tjallalit
čallasit	tjallasit
čallidit	tjalledit
čalludit	tjallodit
čalmmustit	tjalmostit
čanadit	tjanádit
čanahit	tjanádit
čanastit	tjanástit
čarkkistit	tjarkestit
čarvvahit	tjarvadit
čarvvastit	tjarvastit
časkilit	tjasskelit
časkkašit	tjaskatjit
časkke7stit	tjaskestit
časkkihit	tjaskedit
časkkistit	tjaskestit
časkásit	tjasskásit
čatnalit	tjadnalit
čatnasit	tjadnasit
čavddásmit	tjavdásmit
čavdudit	tjavddodit
čavgalit	tjavggalit
čavganit	tjavgganit
čavgasit	tjavggasit
čavgestit	tjavggistit
čavggadit	tjavgadit
čavggahit	tjavgadit
čavggastit	tjavgastit
čavgge7hit	tjavgedit
čavggihit	tjavgedit
čavgánit	tjavggánit
čađahit	tjadádit
čeagŋahit	tjieggŋadit
čeahkarit	tjiehkarit
čeahppudit	tjiehppodit
čeahppulit	tjiehppolit
čeakŋagit	tjiegŋagit
čeakŋuhit	tjiegŋodit
čealdadit	tjielldadit
čeallulit	tjiellolit
čealuhit	tjielodit
čealádit	tjæládit
čeargge7hit	tjiergedit
čearggihit	tjiergedit
čeargulit	tjierggolit
čearidit	tjieredit
čearssistit	tjiersestit
čearssuhit	tjiersodit
čearsánit	tjærssánit
čeasahit	tjiesadit
čeasihit	tjiesedit
čeaskkihit	tjieskedit
čeaskkuhit	tjieskodit
čeaskánit	tjæsskánit
čegŋedit	tjeggŋidit
čegŋestit	tjeggŋistit
čelodit	tjeludit
čerggiidit	tjergijdit
českkodit	tjeskudit
čiegadit	tjiegadit
čiegahit	tjiegadit
čiegardit	tjiegardit
čiegastit	tjiegastit
čiehkadit	tjiehkadit
čiehkalit	tjiehkalit
čiehkádit	tjiehkádit
čiehpastit	tjiehpastit
čiekčalit	tjiektjalit
čiekčasit	tjiektjasit
čiekŋudit	tjiegŋodit
čiekŋulit	tjiegŋolit
čielgadit	tjielggadit
čielgalit	tjielggalit
čielggadit	tjielgadit
čielgge7hit	tjielgedit
čielggihit	tjielgedit
čierastit	tjierastit
čiero7stit	tjierostit
čierrasit	tjierrasit
čieruhit	tjierodit
čierustit	tjierostit
čieskasit	tjiesskasit
čieskkadit	tjieskadit
čieskkahit	tjieskadit
čievččadit	tjievtjadit
čievččahit	tjievtjadit
čievččastit	tjievtjastit
čieđihit	tjiededit
čieŋašit	tjieŋatjit
čieŋidit	tjieŋedit
čieŋuhit	tjieŋodit
čigastit	tjigástit
čiktásit	tjiktásit
čikŋalit	tjigŋalit
čilláhit	tjilládit
čilgedit	tjilggidit
čilgehit	tjilggidit
čilgestit	tjilggistit
čilluhit	tjillodit
čippo7stit	tjippostit
čippustit	tjippostit
čirrostit	tjirrustit
čiradit	tjirádit
čirodit	tjirudit
čirradit	tjirradit
čirssuhit	tjirsodit
čirsánit	tjirssánit
čivhllagit	tjivhlagit
čivrragit	tjivragit
čivrriidit	tjivrijdit
čivttadit	tjivtadit
čivttašit	tjivtatjit
čivtte7stit	tjivtestit
čivttihit	tjivtedit
čiđašit	tjidatjit
čiđistit	tjidestit
čiŋadit	tjiŋádit
čiŋahit	tjiŋádit
čiŋkkodit	tjiŋkudit
čiŋkkuhit	tjiŋkodit
čiŋkkádit	tjiŋkádit
čiŋkulit	tjiŋkkolit
čoabmudit	tjoabbmodit
čoagganit	tjoagganit
čoaggilit	tjoaggelit
čoaggásit	tjoaggásit
čoahkkanit	tjoahkkanit
čoahkáidit	tjoahkájdit
čoahraidit	tjoahrajdit
čoahrihit	tjoahredit
čoakkašit	tjoakkatjit
čoakke7stit	tjoakkestit
čoakkihit	tjoakkedit
čoakkildit	tjoakkeldit
čoakkistit	tjoakkestit
čoalkalit	tjoalkkalit
čoalkke7hit	tjoalkedit
čoalkkuhit	tjoalkodit
čoallulit	tjoallolit
čoaluhit	tjoalodit
čoalčánit	tjoalttjánit
čoalččuhit	tjoaltjodit
čoapmuhit	tjoabmodit
čoarihit	tjoaredit
čoasihit	tjoasedit
čoaskkidit	tjoaskedit
čoaskkihit	tjoaskedit
čoaskkášit	tjoaskátjit
čoaskudit	tjoasskodit
čoaskulit	tjoasskolit
čoavdalit	tjoavddalit
čoavddašit	tjoavdatjit
čoavddihit	tjoavdedit
čoavdilit	tjoavddelit
čoavdásit	tjoavddásit
čoavjudit	tjoavjjodit
čoavlásit	tjoavllásit
čoaŋkulit	tjoaŋkkolit
čobmedit	tjåbbmidit
čogadit	tjågådit
čogahit	tjågådit
čogastit	tjågåstit
čogodit	tjågudit
čogo7stit	tjågostit
čoguhit	tjågodit
čogustit	tjågostit
čogádit	tjågådit
čohkadit	tjåhkådit
čohkahit	tjåhkådit
čohkasit	tjåhkåsit
čohkiidit	tjåhkijdit
čohkkedit	tjåhkkidit
čohkkehit	tjåhkkidit
čohkkestit	tjåhkkistit
čohkkádit	tjåhkkådit
čohkkáhit	tjåhkkådit
čohkodit	tjåhkudit
čohkulit	tjåhkolit
čohkánit	tjåhkånit
čollehit	tjållidit
čollestit	tjållistit
čolgadit	tjålggådit
čolgasit	tjålggåsit
čolggadit	tjålgådit
čolggahit	tjålgådit
čollulit	tjållolit
čoluhit	tjålodit
čomagit	tjåmågit
čomastit	tjåmåstit
čomistit	tjåmestit
čoppaldit	tjåppåldit
čorbmadit	tjårmmådit
čorbmalit	tjårmmålit
čorgehit	tjårggidit
čorgestit	tjårggistit
čorggodit	tjårgudit
čorpmadit	tjårmådit
čoskkiidit	tjåskijdit
čovlasit	tjåvllåsit
čođđudit	tjåddodit
čođđulit	tjåddolit
čudjosit	tjudjusit
čuggestit	tjuggistit
čuimmodit	tjujmudit
čuiuhit	tjujodit
čukkodit	tjukkudit
čukkoldit	tjukkuldit
čulkkihit	tjulkedit
čuodjalit	tjuodjalit
čuogadit	tjuogadit
čuogahit	tjuogadit
čuoggasit	tjuoggasit
čuoggulit	tjuoggolit
čuohcalit	tjuohtsalit
čuohkalit	tjuohkalit
čuohkudit	tjuohkodit
čuohpadit	tjuohpadit
čuohpahit	tjuohpadit
čuohpaldit	tjuohpaldit
čuohpastit	tjuohpastit
čuohppalit	tjuohppalit
čuoibmulit	tjuojmmolit
čuoigalit	tjuojggalit
čuoiggadit	tjuojgadit
čuoiggahit	tjuojgadit
čuoiggaldit	tjuojgaldit
čuoiggastit	tjuojgastit
čuoimmastit	tjuojmastit
čuoimmuhit	tjuojmodit
čuoimmádit	tjuojmádit
čuoiadit	tjuojadit
čuoiahit	tjuojadit
čuoiaidit	tjuojajdit
čuoiihit	tjuojjdit
čuoiustit	tjuojostit
čuokke7hit	tjuokkedit
čuokkihit	tjuokkedit
čuokkuhit	tjuokkodit
čuoladit	tjuoladit
čuolahit	tjuoladit
čuolastit	tjuolastit
čuolbmadit	tjuolmmadit
čuolbmalit	tjuolmmalit
čuolddahit	tjuoldadit
čuolddastit	tjuoldastit
čuolddašit	tjuoldatjit
čuolddihit	tjuoldedit
čuoldilit	tjuolldelit
čuoldásit	tjuolldásit
čuollalit	tjuollalit
čuollasit	tjuollasit
čuolmmadit	tjuolmadit
čuoládit	tjuoládit
čuomadit	tjuomadit
čuomahit	tjuomadit
čuomastit	tjuomastit
čuonádit	tjuonádit
čuopmalit	tjuobmalit
čuorbbidit	tjuorbedit
čuorbbášit	tjuorbátjit
čuorbudit	tjuorbbodit
čuorgahit	tjuorggadit
čuorpmastit	tjuormastit
čuorvulit	tjuorvvolit
čuorvvuhit	tjuorvodit
čuoskkuhit	tjuoskodit
čuoskulit	tjuosskolit
čuovgalit	tjuovggalit
čuovggadit	tjuovgadit
čuovggahit	tjuovgadit
čuovggastit	tjuovgastit
čuovgge7hit	tjuovgedit
čuovggihit	tjuovgedit
čuovggildit	tjuovgeldit
čuovgguhit	tjuovgodit
čuovggášit	tjuovgátjit
čuovo7stit	tjuovostit
čuovuhit	tjuovodit
čuovvo7lit	tjuovvolit
čuovvulit	tjuovvolit
čuozašit	tjuotsatjit
čuozihit	tjuotsedit
čuoččahit	tjuottjadit
čuoččastit	tjuottjastit
čuoččildit	tjuottjeldit
čuoččo7hit	tjuottjodit
čuoččuhit	tjuottjodit
čuožže7lit	tjuodtjelit
čuožžilit	tjuodtjelit
čurbošit	tjurbbutjit
čurggodit	tjurgudit
čurtahit	tjurttadit
čurttuhit	tjurtodit
čurvvodit	tjurvudit
čuskkodit	tjuskudit
čuvddagit	tjuvdagit
čuvddiidit	tjuvdijdit
čuvddástit	tjuvdástit
čuvdedit	tjuvddidit
čuvggiidit	tjuvgijdit
čuvggodit	tjuvgudit
čuvkudit	tjuvkkodit
čuvodit	tjuvudit
čuvohahttalit	tjuvuhahttalit
čuvvodit	tjuvvudit
čuvččagit	tjuvtjagit
čuččodit	tjuttjudit
čužžehit	tjudtjidit
čábbudit	tjábbodit
čábbulit	tjábbolit
čádjidit	tjádjedit
čádjánit	tjádjánit
čágadit	tjágádit
čáhcudit	tjáhtsodit
čáhkadit	tjáhkadit
čáhkkedit	tjáhkkidit
čáhkkehit	tjáhkkidit
čáhkkestit	tjáhkkistit
čáhpihit	tjáhpedit
čáhpildit	tjáhpeldit
čáhpodit	tjáhpudit
čáhppahit	tjáhppadit
čáhppádit	tjáhppádit
čáhppánit	tjáhppánit
čáie7hit	tjájedit
čákŋadit	tjágŋadit
čákŋalit	tjágŋalit
čálašit	tjálatjit
čále7stit	tjálestit
čálgadit	tjálggadit
čálgalit	tjálggalit
čálggihit	tjálgedit
čálihit	tjáledit
čálistit	tjálestit
čállilit	tjállelit
čállásit	tjállásit
čáppášit	tjáppátjit
čáradit	tjárádit
čárdnadit	tjárnnadit
čárvasit	tjárvvasit
čárvehit	tjárvvidit
čárvulit	tjárvvolit
čárvvastit	tjárvastit
čárvvodit	tjárvudit
čárvvuhit	tjárvodit
čárvásit	tjárvvásit
čárásmit	tjárásmit
čáskadit	tjásskadit
čáskalit	tjásskalit
čáskkadit	tjáskadit
čáskkihit	tjáskedit
čávdásit	tjávddásit
čávvásit	tjávvásit
čáđggašit	tjárgatjit
čáŋadit	tjáŋádit
čáŋahit	tjáŋádit
šaddadit	sjaddadit
šaddalit	sjaddalit
šalkudit	sjalkkodit
šalmmastit	sjalmastit
šealgahit	sjielggadit
šealgalit	sjielggalit
šealgge7hit	sjielgedit
šealggihit	sjielgedit
šealgguhit	sjielgodit
šealggádit	sjælgádit
šealgádit	sjælggádit
šealmmastit	sjielmastit
šealmmádit	sjælmádit
šeamihit	sjiemedit
šearasmit	sjierasmit
šearrahit	sjierradit
šeatkkastit	sjietkkastit
šeatkkuhit	sjietkkodit
šelggodit	sjelgudit
šerosmit	sjerusmit
šetkkodit	sjetkkudit
šiehtadit	sjiehtadit
šiehttadit	sjiehttadit
šiervudit	sjiervvodit
šiervvidit	sjiervedit
šiggalit	sjiggalit
šikkastit	sjikkastit
šikkodit	sjikkudit
šimuhit	sjimodit
širaidit	sjirájdit
širgalit	sjirggalit
širgguhit	sjirgodit
širihit	sjiredit
šlahttádit	slahttádit
šlahtádit	slahtádit
šleaivalit	sliejvvalit
šleađgalit	slierggalit
šleađgge7hit	sliergedit
šleađggihit	sliergedit
šleađgguhit	sliergodit
šleađggádit	slærgádit
šleaŋgalit	slieŋggalit
šleaŋgasit	slieŋggasit
šleaŋgge7hit	slieŋgedit
šleaŋggihit	slieŋgedit
šleažaidit	slietjajdit
šleidošit	slejddutjit
šleŋggodit	sleŋgudit
šlibardit	slibárdit
šlieddadit	slieddadit
šlieddahit	slieddadit
šlieddánit	slieddánit
šlienjihit	slienjedit
šliettadit	sliettadit
šliettihit	sliettedit
šliettildit	slietteldit
šliettuhit	sliettodit
šlihpardit	slihpardit
šliividit	slijvvedit
šliivvidit	slijvedit
šlimpasit	slimppasit
šlimppagit	slimpagit
šlimppardit	slimpardit
šlimppistit	slimpestit
šlinzzagit	slintsagit
šlivgasit	slivggasit
šlivggastit	slivgastit
šlivggihit	slivgedit
šlivggodit	slivgudit
šlivgguhit	slivgodit
šlivgásit	slivggásit
šliđagit	slidágit
šliđardit	slidárdit
šloabardit	slåbardit
šloahkihit	sloahkedit
šloahkkalit	sloahkkalit
šloahkuhit	sloahkodit
šloahpardit	sloahpardit
šloahtalit	sloahtalit
šloancce7hit	sloantsedit
šloappardit	sloappardit
šloavastit	slåvastit
šloavgalit	sloavggalit
šloavgge7hit	sloavgedit
šloavggihit	sloavgedit
šloavihit	sloavedit
šloađastit	slådastit
šloaŋgasit	sloaŋggasit
šloaŋggagit	sloaŋgagit
šloaŋggihit	sloaŋgedit
šloaŋgguhit	sloaŋgodit
šloaŋkalit	sloaŋkkalit
šloaŋkke7hit	sloaŋkedit
šloaŋkkihit	sloaŋkedit
šloaŋkkistit	sloaŋkestit
šloaŋkkuhit	sloaŋkodit
šlubbahit	slubbadit
šlubbudit	slubbodit
šlubistit	slubestit
šluhpardit	sluhpardit
šluhpasit	sluhpasit
šlundahit	slunddadit
šlunddagit	slundagit
šlundduhit	slundodit
šlundudit	slunddodit
šlundádit	slunddádit
šlundánit	slunddánit
šluohkásmit	sluohkásmit
šluohkášit	sluohkátjit
šluppardit	sluppardit
šluppihit	sluppedit
šlurvvuhit	slurvodit
šluvgásit	sluvggásit
šluččuhit	sluttjodit
šluđuhit	sludodit
šluŋkkagit	sluŋkagit
šluŋkkahit	sluŋkadit
šluŋkkistit	sluŋkestit
šluŋkáhit	sluŋkkádit
šluŋkánit	sluŋkkánit
šlábirdit	sláberdit
šlággalit	slággalit
šláhpardit	sláhpardit
šlákkihit	slákkedit
šlámaidit	slámájdit
šlámihit	slámedit
šlánddidit	slándedit
šlárbmadit	slármmadit
šlárvadit	slárvvadit
šlárvvidit	slárvedit
šláttardit	sláttardit
šlávehit	slávidit
šnjaggalit	sjnjaggalit
šnjakke7hit	sjnjakkedit
šnjakkuhit	sjnjakkodit
šnjalčadit	sjnjalttjadit
šnjalččagit	sjnjaltjagit
šnjalččahit	sjnjaltjadit
šnjalččuhit	sjnjaltjodit
šnjalžadit	sjnjalltjadit
šnjalžžagit	sjnjaltjagit
šnjalžžahit	sjnjaltjadit
šnjalžžuhit	sjnjaltjodit
šnjarvvagit	sjnjarvagit
šnjarvvuhit	sjnjarvodit
šnjilččagit	sjnjiltjagit
šnjilččuhit	sjnjiltjodit
šnjilžžagit	sjnjiltjagit
šnjilžžuhit	sjnjiltjodit
šnjirrehit	sjnjirridit
šnjirahit	sjnjirádit
šnjiraidit	sjnjirájdit
šnjirggádit	sjnjirgádit
šnjirihit	sjnjiredit
šnjivaidit	sjnjivájdit
šnjivgalit	sjnjivggalit
šnjivggihit	sjnjivgedit
šnjivgguhit	sjnjivgodit
šnjivihit	sjnjivedit
šnjoalccagit	sjnjoaltsagit
šnjoaraidit	sjnjårajdit
šnjoargge7hit	sjnjoargedit
šnjoarggihit	sjnjoargedit
šnjoargguhit	sjnjoargodit
šnjuoggasit	sjnjuoggasit
šnjuokkagit	sjnjuokkagit
šnjuokkardit	sjnjuokkardit
šnjuokkuhit	sjnjuokkodit
šoambbistit	sjoambestit
šoavaidit	sjåvajdit
šoavihit	sjoavedit
šoavludit	sjoavllodit
šoaŋkkuhit	sjoaŋkodit
šogádit	sjågådit
šolgadit	sjålggådit
šolggiidit	sjålgijdit
šolirdit	sjålerdit
šombbistit	sjåmbestit
šovkkodit	sjåvkudit
šođbbodit	sjårbudit
šoŋkkuhit	sjåŋkodit
šuddidit	sjuddedit
šuldderit	sjuldirit
šumppihit	sjumpedit
šuohkašit	sjuohkatjit
šuohkihit	sjuohkedit
šuoŋihit	sjuoŋedit
šuraidit	sjurájdit
šuvaidit	sjuvájdit
šuvgalit	sjuvggalit
šuvgge7hit	sjuvgedit
šuvggihit	sjuvgedit
šuvgguhit	sjuvgodit
šuvihit	sjuvedit
šuvččagit	sjuvtjagit
šuđaidit	sjudájdit
šuđihit	sjudedit
šállošit	sjállutjit
šárahit	sjárádit
šáraidit	sjárájdit
šárgalit	sjárggalit
šárggihit	sjárgedit
šárgguhit	sjárgodit
šárihit	sjáredit
šávahit	sjávádit
šávaidit	sjávájdit
šávdásit	sjávddásit
šávgalit	sjávggalit
šávggihit	sjávgedit
šávgguhit	sjávgodit
šávihit	sjávedit
