                                   100%
0%>>>>>>>>>>>>>>>>>>>>>>>>>>>>>>>>	a
a^spektuála	a^spektoála	a
abmejeaddji	abbmejeaddje	a
absoluhtalaš	absuluhtalasj	a
absoluhtta	absuluhtta	a
abstrákta	abstrákta	a
absurda	absurda	a
accagas	attsagas	a
addevaš	addevasj	a
adjektiivvalágan	adjektijvvalágan	a
administratiiva	admenistratijva	a
adversatiiva	adversatijva	a
affektiiva	affektijva	a
ag^gressiiva	ag^gressijva	a
agi#beai#buorre	age#biej#buorre	a
agi#beai#buorri	age#biej#buorre	a
agiheapme	ageheapme	a
ahkkái	ahkkáj	a
ahppar	ahppar	a
aitosaš	ajttusasj	a
akademalaš	akádemalasj	a
akademihkalaš	akádemihkalasj	a
akkusatiiva#hápmásaš	akkusatijva#hábmásasj	a
akromáhtalaš	akrumáhtalasj	a
aktalaš	aktalasj	a
aktasaš	aktasasj	a
aktilaš	aktelasj	a
akusttalaš	akustalasj	a
akváhtalaš	akváhtalasj	a
alfabehtalaš	alffabehtalasj	a
alfanumeralaš	alffanumeralasj	a
alit	alet	a
alit#ruoksat	alet#ruoksat	a
alit#vielgat	alet#vielggat	a
alitlágáš	aletlágásj	a
alla#dássásaš	alla#dássásasj	a
alla#áiggálaš	alla#ájgálasj	a
alla#árvosaš	alla#árvvusasj	a
allalágan	allalágan	a
allegoralaš	allegoralasj	a
allegoriijalaš	allegorijjalasj	a
allegorálaš	allegorálasj	a
alluvialaš	alluvialasj	a
almennetlágan	almennetlágan	a
almennetlágán	almennetlágán	a
almmos#rievttálaš	almus#rievtálasj	a
almmus	almus	a
alolaš	alulasj	a
alpin	alppen	a
amas#giel	amás#giel	a
amorálalaš	amurálalasj	a
analogalaš	análogalasj	a
analogiijalaš	análogijjalasj	a
analyhtalaš	anályhtalasj	a
anatomalaš	anátomalasj	a
anemalaš	anemalasj	a
anemiijalaš	anemijjalasj	a
anihahtti	anehahtte	a
animálalaš	anemálalasj	a
anonyma	anunyma	a
anti#rasistalaš	antte#rasestalasj	a
anti#rasisttalaš	antte#rasestalasj	a
anti#sosiála	antte#såsiála	a
antihkalaš	anttehkalasj	a
antisipatiiva	anttesipatijva	a
antropologalaš	antrupologalasj	a
apostovllalaš	apustovllalasj	a
areála	areála	a
arkeologalaš	arkkeologalasj	a
arkeologálaš	arkkeologálasj	a
arktihkalaš	arktehkalasj	a
arktálaš	arktálasj	a
artikulatoralaš	arttekulatoralasj	a
asehaš	asehasj	a
aseheapme	aseheapme	a
asfáltái	asfáltáj	a
asihaš	asehasj	a
asiheapme	aseheapme	a
askehtalaš	asskehtalasj	a
assosaš	assusasj	a
assái	assáj	a
astmáhtalaš	astmáhtalasj	a
asyndehtalaš	asyndehtalasj	a
atelihkalaš	atelihkalasj	a
atnemeahttun	adnemeahttun	a
atnimeahttun	adnemeahttun	a
atoma#gevolaš	atuma#gevulasj	a
audi^o#visuála	aude^o#visoála	a
auditiiva	audetijva	a
auditiivvalaš	audetijvvalasj	a
augs^burgalaš	augs^burggalasj	a
auteanttalaš	auteanttalasj	a
autenttalaš	autenttalasj	a
auto#semánttalaš	auto#semánttalasj	a
automahtalaš	autumahtalasj	a
automatiiva	autumatijva	a
automáhtalaš	autumáhtalasj	a
autonomalaš	autunomalasj	a
autoratiiva	auturatijva	a
autoritatiiva	auturitatijva	a
ađđamahtes	addamahtes	a
ađđái	addáj	a
badjel#beassameahttun	badjel#biessameahttun	a
badjel#geahčahahtti	badjel#giehtjahahtte	a
badjel#jagáš	badjel#jagásj	a
badjel#lunddolaš	badjel#lundulasj	a
badjel#mearálaš	badjel#mærálasj	a
badjelii#luohtehahtti	badjelij#luohtehahtte	a
badjil#beassameahttun	badjel#biessameahttun	a
badjil#geahčahahtti	badjel#giehtjahahtte	a
badjil#hearki	badjel#hierkke	a
badjil#mielat	badjel#mielat	a
badjilii#luohtihahtti	badjelij#luohtehahtte	a
badjálas	badjálas	a
bahkat	bahkat	a
bahča	bahtja	a
bajilduslaš	bajelduslasj	a
bajit	bajet	a
bajit#dási	bajet#dáse	a
bajás#ráhkadeaddji	bajás#ráhkadeaddje	a
bajáš	bajásj	a
bakkas	bakkas	a
balahahtti	baláhahtte	a
balddehahtti	baldehahtte	a
balddihahtti	baldehahtte	a
balsái	balssáj	a
baltalaš	balltalasj	a
balvái	balvváj	a
barbáralaš	barbbáralasj	a
barggukeahtes	bargukeahtes	a
bargo#fápmo#politihkalaš	barggo#fábmo#påletihkalasj	a
basakeat	basákeat	a
basiheapme	baseheapme	a
bastteheapme	basteheapme	a
basttiheapme	basteheapme	a
basttoheapme	bastuheapme	a
bažihahtti	batjehahtte	a
beahttimeahttun	biehttemeahttun	a
beailasaš	biejlasasj	a
beaive#jaŋas	biejvve#jaŋás	a
beaivvi#sealvi	biejve#sielvve	a
beaktilmeahttun	biektelmeahttun	a
bealjiheapme	bieljjeheapme	a
beallalas	biellalas	a
bealle#virggálaš	bielle#virgálasj	a
bealle#vuddjii	bielle#vuddjij	a
bealle#álás	bielle#álás	a
bealle#čujolaš	bielle#tjujulasj	a
bealle#čuoddjil	bielle#tjuoddjel	a
bealleatno	bielleatno	a
bealleheat	bielleheat	a
bealátkeahtes	bælátkeahtes	a
beanttis	bientes	a
bearas	bieras	a
bearraš#guovdasaš	bierrasj#guovddasasj	a
beasakeat	biesakeat	a
beasseheapme	biesseheapme	a
beassiheapme	biesseheapme	a
beatnagahtes	biednagahtes	a
beatnatlágán	biednatlágán	a
bellolas	bellulas	a
benjaminlaš	benjáminlasj	a
beroštahtti	berusjtahtte	a
bestiálalaš	besstiálalasj	a
bi^o^gráfalaš	bi^o^gráfálasj	a
bi^ologalaš	bi^ålugalasj	a
bi^ologálaš	bi^ålugálasj	a
biehtalkeahtes	biehtalkeahtes	a
biehčamahtes	biehtjamahtes	a
biekkus	biekkus	a
biellui	bielluj	a
bierggo#šlái-	biergo#sláj-	a
bievllus	bievlus	a
bieđggus	biergus	a
bieđđu	bieddo	a
bihkaheapme	bihkaheapme	a
bihkkái	bihkkáj	a
biktil	biktel	a
bikŋaleaddjái	bigŋaleaddjáj	a
bilabiála	bilábiála	a
bilaterála	biláterála	a
binddeheapme	bindeheapme	a
binddiheapme	bindeheapme	a
binddoheapme	binduheapme	a
bindil	binddel	a
binára	binára	a
birgehahtti	birggehahtte	a
birra#jagáš	birra#jagásj	a
birra#jahkásaš	birra#jahkásasj	a
birzzas	birtsas	a
birzzehas	birtsehas	a
bisovaš	bisuvasj	a
bissomeahttun	bissumeahttun	a
bissovaš	bissuvasj	a
bistevaš	bisstevasj	a
bistil	bisstel	a
bistteheapme	bisteheapme	a
bisttiheapme	bisteheapme	a
bisttoheapme	bistuheapme	a
bisttuheapme	bistuheapme	a
bivahahtti	biváhahtte	a
bivddehahtti	bivdehahtte	a
bivddihahtti	bivdehahtte	a
bivzzehas	bivtsehas	a
boagustahtti	boagustahtte	a
boahkas	boahkas	a
boahkis	boahkes	a
boahtte#áigásaš	boahtte#ájggásasj	a
boahttevaš	boahttevasj	a
boaitto#beal	boajto#biel	a
boalddehahtti	boaldehahtte	a
boalddihahtti	boaldehahtte	a
boaldevaš	boalldevasj	a
boares#mállesaš	boares#mállesasj	a
boares#áigásaš	boares#ájggásasj	a
boareslágan	boareslágan	a
boargil	boarggel	a
boastto	boasto	a
boastto#oinnolaš	boasto#åjnulasj	a
boasttu	boasto	a
boatkanmeahttun	boatkanmeahttun	a
boatkatmeahttun	boatkatmeahttun	a
boatkkaheapme	boatkkaheapme	a
boatkkakeahtes	boatkkakeahtes	a
boađuskeahtes	boaduskeahtes	a
boaššumus	boassjumus	a
boddosaš	båddusasj	a
bohccilágan	båhttselágan	a
bohccilágán	båhttselágán	a
bois#botneheapme	båjs#bådneheapme	a
bois#botniheapme	båjs#bådneheapme	a
bollui	bålluj	a
bolttokeat	båltukeat	a
bonju	bånjo	a
borahahtti	båråhahtte	a
boranas	bårånas	a
boreála	båreála	a
bostta	båstå	a
botneheapme	bådneheapme	a
botniheapme	bådneheapme	a
bovdnái	båvnnåj	a
bođđehahtti	båddehahtte	a
brihtalaš	brihtalasj	a
buddásaš	buddásasj	a
bugo	bugo	a
buhtes#oahpalaš	buhtes#oahpalasj	a
buhtismeahttun	buhtesmeahttun	a
buiccas	bujtsas	a
buiga	bujgga	a
buleš	bulesj	a
bullji#čalmmat	bullje#tjalmat	a
buohkanas	buohkanas	a
buohtalas	buohtalas	a
buoiddiheapme	buojdeheapme	a
buolaheapme	buolaheapme	a
buolaš	buolasj	a
buolaš#jaŋas	buolasj#jaŋás	a
buoleheapme	buoleheapme	a
buoliheapme	buoleheapme	a
buollevaš	buollevasj	a
buoloheapme	buoluheapme	a
buolvvat	buolvat	a
buolžái	buolltjáj	a
buore	buore	a
buorggos	buorgus	a
buoritmeahttun	buoretmeahttun	a
buorre#dohkálaš	buorre#dåhkålasj	a
buot#beallásaš	buot#bællásasj	a
buot#diehtti	buot#diehtte	a
buot#guoskevaš	buot#guosskevasj	a
buotlágan	buotlágan	a
buotlágán	buotlágán	a
buotlágáš	buotlágásj	a
buškkas	busjkas	a
byro^kráhtalaš	byro^kráhtalasj	a
bábirlágan	báberlágan	a
bádde#keramihkalaš	bádde#kerámihkalasj	a
bádde#kerámalaš	bádde#kerámalasj	a
báddi#bahá	bádde#bahá	a
báddi#lodji	bádde#lådje	a
bággolonistanlágan	bággulonistanlágan	a
bággolonistanlágán	bággulonistanlágán	a
báhpárlágan	báhpárlágan	a
báidnemeahttun	bájnnemeahttun	a
báidnimeahttun	bájnnemeahttun	a
báikkalaš	bájkalasj	a
báikkolaš	bájkulasj	a
báitevaš	bájttevasj	a
bákte#fágalaš	bákte#fágálasj	a
báktelágan	báktelágan	a
báldalas	bálldalas	a
bálddalas	báldalas	a
bálgges#projektionála	bálges#pråjektionála	a
bálgáheapme	bálggáheapme	a
báljis	báljjes	a
bállas	bállas	a
bállir	báller	a
bániheapme	báneheapme	a
báraheapme	báráheapme	a
báralaš	bárálasj	a
bárbáralaš	bárbbáralasj	a
bárra#stávval	bárra#stávval	a
bárulágan	bárulágan	a
báráhis#stávval	báráhis#stávval	a
bás	bás	a
bávččasteaddji	bávtjasteaddje	a
bázahaddan	bátsáhaddan	a
bázahallan	bátsáhallan	a
bážehahtti	bátjehahtte	a
bážekeat	bátjekeat	a
bážihahtti	bátjehahtte	a
caggasmeahttun	tsaggasmeahttun	a
cahkkil	tsahkkel	a
ceahkkálas	tsæhkkálas	a
ceaikkas	tsiejkas	a
ceakko#njuolgat	tsiekko#njuolggat	a
ceakkus	tsiekkus	a
cealkemeahttun	tsielkkemeahttun	a
cealkimeahttun	tsielkkemeahttun	a
civnna	tsivna	a
civzza	tsivtsa	a
cuippas	tsujpas	a
cuoccaheapme	tsuottsaheapme	a
cuoccas	tsuottsas	a
cuohppái	tsuohppáj	a
cuvkemeahttun	tsuvkkemeahttun	a
dalloš	dallusj	a
dalá	dalá	a
daláš	dalásj	a
dan#veardásaš	dan#værddásasj	a
danšlái	dansjláj	a
darvvas	darvas	a
dassáš	dassásj	a
daškat	dassjkat	a
de^pressiiva	de^pressijva	a
de^struktiiva	de^struktijva	a
deahkiheapme	diehkeheapme	a
deahtis	diehtes	a
dearvvašmeahttun	diervasjmeahttun	a
deatalaš	dietalasj	a
deatnolaš	diednulasj	a
deattoheapme	diettuheapme	a
deavdemeahttun	dievddemeahttun	a
deavdimeahttun	dievddemeahttun	a
deavis	dieves	a
deavkat	dievkkat	a
deaŧalaš	dietalasj	a
deaŧálaš	dætálasj	a
definihtta	defenihtta	a
dehalaš	dehálasj	a
dehálaš	dehálasj	a
deiktalaš	dejktalasj	a
demo^gráfalaš	demo^gráfálasj	a
demo^kráhtalaš	demo^kráhtalasj	a
deonttalaš	deontalasj	a
derivatiiva	derevatijva	a
deskriptiivalaš	deskreptijvalasj	a
detáljalaš	detáljalasj	a
deverbála	deverbála	a
deđot	dedut	a
di^a^gnostalaš	di^a^gnåsstålasj	a
di^agonála	di^agunála	a
di^alektála	di^alektála	a
dia^kronalaš	dia^krånålasj	a
didákttalaš	didákttalasj	a
diehpas	diehpas	a
diehtimeahttun	diehtemeahttun	a
diehttalas	diehttalas	a
diehttelas	diehttelas	a
diehttevaš	diehttevasj	a
diehttislágan	diehtteslágan	a
diehttislágán	diehtteslágán	a
dieiggas	diejgas	a
diekkáraš	diekkárasj	a
dielas	dielas	a
dielvvis	dielves	a
dien#sullasaš	dien#sullasasj	a
dievas#válddálaš	dievas#váldálasj	a
dievaslaš	dievaslasj	a
dievasmeahttun	dievasmeahttun	a
dieđa#teorehtalaš	dieda#teorehtalasj	a
dieđus	diedus	a
digitála	digetála	a
digitálalaš	digetálalasj	a
dihto	dihto	a
dihtolágan	dihtulágan	a
dihtolágán	dihtulágán	a
diibmo#beallásaš	dijmmo#bællásasj	a
diimmá	dijmá	a
diimmá#dálvváš	dijmá#dálvásj	a
diimmá#geasáš	dijmá#gæsásj	a
dilddas	dildas	a
dilkui	dilkkuj	a
diplomáhtalaš	diplumáhtalasj	a
distrivtta#politihkalaš	distrevtta#påletihkalasj	a
doabalaš	dåbalasj	a
doadjemeahttun	doadjemeahttun	a
doadjimeahttun	doadjemeahttun	a
doaibma#ekonomalaš	doajmma#ekunomalasj	a
doaibma#hehttejuvvon	doajmma#hehttejuvvon	a
doaibmevaš	doajmmevasj	a
doaimmahuslaš	doajmahuslasj	a
doaivvohahtti	doajvuhahtte	a
doalahahtti	dålahahtte	a
doallavaš	doallavasj	a
doallevaš	doallevasj	a
doallil	doallel	a
doanda	doandda	a
doares#politihkalaš	doares#påletihkalasj	a
doares#politihkkalaš	doares#påletihkkalasj	a
doarssas	doarsas	a
doaččis	doattjes	a
doažžat	doadtjat	a
doažži	doadtje	a
dobbelaš	dåbbelasj	a
dogmáhtalaš	dågmåhtalasj	a
dohkkehahtti	dåhkkehahtte	a
dohkkemeahttun	dåhkkemeahttun	a
dohkketmeahttun	dåhkketmeahttun	a
dolaheapme	dålåheapme	a
dolddas	dåldås	a
dolkadahtti	dålkkådahtte	a
dolla#ruoksat	dållå#ruoksat	a
dolla#vulggolaš	dållå#vulgulasj	a
dolos	dålus	a
dološ#dárrolaš	dålusj#dárrulasj	a
dolá	dålå	a
dovdo#mearkkalaš	dåvddo#mierkalasj	a
dovdui#čuohcci	dåvdduj#tjuohttse	a
doŋas	dåŋås	a
dramatihkalaš	dramátihkalasj	a
duhtávaš	duhtávasj	a
duhát#geardásaš	duhát#gærddásasj	a
duivvas	dujvas	a
dulpi#geažat	dulppe#gietjat	a
dulppas	dulpas	a
dulvvis	dulves	a
dulán	dulán	a
dumssas	dumsas	a
dumsui	dumssuj	a
duohkásaš	duohkásasj	a
duohpakeahtes	duohpakeahtes	a
duohtatmeahttun	duohtatmeahttun	a
duojás	duojás	a
duojáš	duojásj	a
duollet	duollet	a
duolloheapme	duolluheapme	a
duolmmus	duolmus	a
duolva#dovdi	duolvva#dåvdde	a
duoláš	duolásj	a
duorgái	duorggáj	a
duottaraddjái	duottaraddjáj	a
duođaštuslaš	duodasjtuslasj	a
dupleaksa	dupleaksa	a
duppal	duppal	a
duppal#geardásaš	duppal#gærddásasj	a
duđahahtti	dudáhahtte	a
duŋggas	duŋgas	a
dušši	dussje	a
dynamalaš	dynámalasj	a
dynámalaš	dynámalasj	a
dábálaš#politihkalaš	dábálasj#påletihkalasj	a
dádjagaš	dádjagasj	a
dáhpalaš	dáhpalasj	a
dáidimeahttun	dájddemeahttun	a
dálkkas#dieđalaš	dálkas#diedalasj	a
dálkkaslaš	dálkaslasj	a
dálvvas	dálvas	a
dálvásaš	dálvvásasj	a
dálá	dálá	a
dámakeat	dámákeat	a
dán#háváš	dán#hávásj	a
dán#jagáš	dán#jagásj	a
dán#sullasaš	dán#sullasasj	a
dánlágan	dánlágan	a
dánska	dánsska	a
dánska-norgga	dánsska-nårgå	a
dárbbašlaš	dárbasjlasj	a
dárbbašmeahttun	dárbasjmeahttun	a
dáro#giel	dáro#giel	a
dáseheapme	dáseheapme	a
dásiheapme	dáseheapme	a
dásse#deattoheapme	dásse#diettuheapme	a
dásse#deattokeahtes	dásse#diettukeahtes	a
dásse#deattukeahtes	dásse#diettukeahtes	a
dásse#dettolaš	dásse#dettulasj	a
dásse#gilggat	dásse#gilgat	a
dásse#juolggat	dásse#juolgat	a
dásse#ravddat	dásse#ravdat	a
dásse#siiddot	dásse#sijdut	a
dásse#árvosaš	dásse#árvvusasj	a
dássi#gilggat	dásse#gilgat	a
dássi#juolggat	dásse#juolgat	a
dássi#ravddat	dásse#ravdat	a
dássi#siiddot	dásse#sijdut	a
dássi-deattoheapme	dássi-diettuheapme	a
dássitmeahttun	dássetmeahttun	a
dássálas	dássálas	a
dássáš	dássásj	a
dávggas	dávgas	a
dávggasmeahttun	dávgasmeahttun	a
dávji	dávjje	a
dávttas	dávtas	a
dávttaskas	dávtaskas	a
dávtteheapme	dávteheapme	a
dávttiheapme	dávteheapme	a
dáválaš	dáválasj	a
dáđas	dádás	a
dáđggis	dárges	a
eahkedis-	iehkedis-	a
eahkes-	iehkes-	a
eahpe#bassi	iehpe#basse	a
eahpe#dievaslaš	iehpe#dievaslasj	a
eahpe#dohkálaš	iehpe#dåhkålasj	a
eahpe#duohta	iehpe#duohta	a
eahpe#duđahahtti	iehpe#dudáhahtte	a
eahpe#dábálaš	iehpe#dábálasj	a
eahpe#formála	iehpe#fårmåla	a
eahpe#formálalaš	iehpe#fårmålalasj	a
eahpe#giella#oahpalaš	iehpe#giella#oahpalasj	a
eahpe#gorrelaš	iehpe#gårrelasj	a
eahpe#govttolaš	iehpe#gåvtulasj	a
eahpe#jáhkehahtti	iehpe#jáhkehahtte	a
eahpe#logalaš	iehpe#lågålasj	a
eahpe#luohtehahtti	iehpe#luohtehahtte	a
eahpe#mávssolaš	iehpe#mávsulasj	a
eahpe#njuolgat	iehpe#njuolggat	a
eahpe#njuolggaduslaš	iehpe#njuolgaduslasj	a
eahpe#normála	iehpe#nårmåla	a
eahpe#ovttalaš	iehpe#åvtålasj	a
eahpe#ozolaš	iehpe#åtsulasj	a
eahpe#politihkalaš	iehpe#påletihkalasj	a
eahpe#realisttalaš	iehpe#rielestalasj	a
eahpe#rehalaš	iehpe#rehálasj	a
eahpe#segmentálalaš	iehpe#segmentálalasj	a
eahpe#virggálaš	iehpe#virgálasj	a
eahpe#vuogálaš	iehpe#vuogálasj	a
eahpe#čuožžovaš	iehpe#tjuodtjuvasj	a
eahpe-realisttalaš	iehpe-rielestalasj	a
eahpi#bassi	iehpe#basse	a
eahpi#duohta	iehpe#duohta	a
eahpi#duđahahtti	iehpe#dudáhahtte	a
eahpi#gullu	iehpe#gullo	a
eahpi#jáhkihahtti	iehpe#jáhkehahtte	a
eahpi#luohtihahtti	iehpe#luohtehahtte	a
eahpi#normála	iehpe#nårmåla	a
eahpi#sealvi	iehpe#sielvve	a
eahpi#veaddji	iehpe#vieddje	a
eahpi#čielggas	iehpe#tjielgas	a
eahpidahtti	iehpedahtte	a
eahttu#ruoksat	iehtto#ruoksat	a
eaitnaha	iejtnaha	a
eakti	iekte	a
eaktu#dáhtolaš	iekto#dáhtulasj	a
eallin#vulggolaš	iellen#vulgulasj	a
eambbo	iembo	a
eami#álbmot#guoskevaš	ieme#álmmut#guosskevasj	a
eana#dieđalaš	iena#diedalasj	a
eana#dieđálaš	iena#diedálasj	a
eana#gottálaš	iena#gåttålasj	a
eanalaš	ienalasj	a
eanan#dieđálaš	ienan#diedálasj	a
earalágan	ieralágan	a
earalágán	ieralágán	a
eareliiggán	ierelijggán	a
eareliiggáš	ierelijggásj	a
earenoamáš	ierenoamásj	a
earenomáš	ierenomásj	a
eará#dássásaš	ærá#dássásasj	a
eará#ivdnásaš	ærá#ivnnásasj	a
eará#mállet	ærá#mállet	a
earálágan	ærálágan	a
earálágán	ærálágán	a
easka#riegádan	iesska#riegádan	a
eastatmeahttun	iesstatmeahttun	a
easttaheapme	iestaheapme	a
eatnan#dieđalaš	iednan#diedalasj	a
eatnan#vuoles	iednan#vuoles	a
eatnanlaš	iednanlasj	a
eatnat#geardásaš	iednat#gærddásasj	a
eatnat#lohkosaš	iednat#låhkusasj	a
eatniheapme	iedneheapme	a
eavttoheapme	ievtuheapme	a
eavttuheapme	ievtuheapme	a
eaŋgalas	ieŋggalas	a
eaŋgals	ieŋggals	a
ebmui	ebbmuj	a
edomlaš	edumlasj	a
effektiiva	effektijva	a
egoisttalaš	egujstalasj	a
ehtalaš	ehtalasj	a
ekologalaš	ekulogalasj	a
ekologálaš	ekulogálasj	a
ekonomalaš	ekunomalasj	a
ekonomiija#politihkalaš	ekunomijja#påletihkalasj	a
ekonomálaš	ekunomálasj	a
eks^klusiiva	eks^klusijva	a
eks^plisihtta	eks^plisehtta	a
eksoforalaš	eksuforalasj	a
eksohtalaš	eksuhtalasj	a
eksosentrihkalaš	eksusentrihkalasj	a
eksotihkalaš	eksutihkalasj	a
eksperimentála	eksperimentála	a
ekstremisttalaš	ekstremistalasj	a
ekstáhtalaš	ekstáhtalasj	a
ekvivaleanta	ekvevaleanta	a
elastihkalaš	elástihkalasj	a
elegánta	elegánta	a
elektralaš	elektralasj	a
elektrihkalaš	elektrihkalasj	a
elektronalaš	elektronalasj	a
elementára	elementára	a
ellipttalaš	ellepttalasj	a
empiralaš	empperalasj	a
en^klihtalaš	en^klihtalasj	a
endena	enddena	a
endosentrihkalaš	enddusentrihkalasj	a
enharmonalaš	enharmonalasj	a
epihka-po^ehtalaš	epehka-po^ehtalasj	a
epihkalaš	epehkalasj	a
epistemalaš	epestemalasj	a
ereliiggán	erelijggán	a
ereliiggáš	erelijggásj	a
erenoamaš	erenoamasj	a
erenoamán	erenoamán	a
erenoamáš	erenoamásj	a
erenoamáš#pedagogalaš	erenoamásj#pedágogalasj	a
erenomáš	erenomásj	a
eret#cealkkehahtti	eret#tsielkehahtte	a
erohtalaš	eruhtalasj	a
erotihkalaš	erutihkalasj	a
estehtalaš	esstehtalasj	a
etnalaš	ednalasj	a
etnihkalaš	ednehkalasj	a
etno^gráfalaš	edno^gráfálasj	a
etnologalaš	ednulogalasj	a
etnosentrihkalaš	ednusentrihkalasj	a
etnálaš	ednálasj	a
etymologalaš	etymologalasj	a
eufemisttalaš	eufemistalasj	a
euro#sentralaš	euro#sentralasj	a
evangelalaš	evángelalasj	a
eváhkkolaš	eváhkkolasj	a
eŋgalas	eŋggalas	a
eŋgelas	eŋggelas	a
fadnil	faddnel	a
fakultehtaid#gaskasaš	fakultehtajd#gasskasasj	a
fanatihkalaš	fanátihkalasj	a
fantastihkalaš	fanttastihkalasj	a
fantásttalaš	fanttástalasj	a
fanáhtalaš	fanáhtalasj	a
fašisttalaš	fasjestalasj	a
fearalágan	fieralágan	a
fearalágán	fieralágán	a
feargasaš	fierggasasj	a
fearggaheapme	fiergaheapme	a
federála	federála	a
feministtalaš	femenistalasj	a
fenomenála	fenumenála	a
feodála	feodála	a
feodálalaš	feodálalasj	a
fiber#optihkalaš	fiber#åptehkalasj	a
fierggeheapme	fiergeheapme	a
fierggiheapme	fiergeheapme	a
fierttos	fiertus	a
fievro#gollos#guovdasaš	fievrro#gållus#guovddasasj	a
fievrro#guovdasaš	fievro#guovddasasj	a
figuratiiva	figuratijva	a
fiktiiva	fiktijva	a
filmáhtalaš	filmáhtalasj	a
filologalaš	filulogalasj	a
filosofalaš	filusofalasj	a
filosofálaš	filusofálasj	a
finihtta	finehtta	a
fioleahtta	fioleahtta	a
fiskat	fisskat	a
fiskeslágan	fisskeslágan	a
fiskeslágán	fisskeslágán	a
fitno#fágalaš	fidno#fágálasj	a
fitnodat#ekonomálaš	fidnudat#ekunomálasj	a
fitnolaš	fidnulasj	a
fivlat	fivllat	a
flegmáhtalaš	flegmáhtalasj	a
fleksi	flekse	a
folk#loristtalaš	fålk#lårestalasj	a
fonehtalaš	fånehtalasj	a
fonemalaš	fånemalasj	a
fonemáhtalaš	fånemáhtalasj	a
fono#távttalaš	fåno#távtalasj	a
fonologalaš	fånulogalasj	a
fonologálaš	fånulogálasj	a
formála	fårmåla	a
formálalaš	fårmålalasj	a
free^styla	free^styla	a
free^style	free^style	a
friddja#hápmásaš	friddja#hábmásasj	a
friija	frijja	a
friija#hápmásaš	frijja#hábmásasj	a
fundamentalisttalaš	funddamentalistalasj	a
funktionála	funktionála	a
funkšonála	funksjunála	a
funkšunála	funksjunála	a
fuomášahtti	fuomátjahtte	a
fuopmášahtti	fuobmátjahtte	a
fuorji	fuorjje	a
fuorás	fuorás	a
fuotni	fuodne	a
fuođđi	fuodde	a
fylka#gieldalaš	fylkka#gielldalasj	a
fysalaš	fysálasj	a
fysikála	fysekála	a
fysikálalaš	fysekálalasj	a
fysálaš	fysálasj	a
fágaid#gaskasaš	fágájd#gasskasasj	a
fágalaš	fágálasj	a
fáhkka	fáhkka	a
fáhkka#mohkat	fáhkka#måhkåt	a
fáhkkat	fáhkkat	a
fáhkkatlaš	fáhkkatlasj	a
fálmmiheapme	fálmeheapme	a
fálska	fálska	a
fántásttalaš	fánttástalasj	a
fásta	fássta	a
fástideaddji	fásstedeaddje	a
fávdnái	fávnnáj	a
fávllibuš	fávlebusj	a
fášisttalaš	fásjestalasj	a
føderála	føderála	a
gaba#ivdnásaš	gaba#ivnnásasj	a
gabbái	gabbáj	a
gadnái	gaddnáj	a
gahpergeahtes	gahpergeahtes	a
gahperha	gahperha	a
gahperkeahtes	gahperkeahtes	a
gaitlágan	gajtlágan	a
gaitlágán	gajtlágán	a
galba#hámat	galbba#hámát	a
galdái	galldáj	a
galkkadeaddji	galkadeaddje	a
gallilágan	gallelágan	a
gallilágán	gallelágán	a
galljes	galljes	a
galljosaš	galljusasj	a
gallás	gallás	a
garas	garás	a
garri	garre	a
garril	garrel	a
garvemeahttun	garvvemeahttun	a
garvimeahttun	garvvemeahttun	a
gaska#boddasaš	gasska#båddåsasj	a
gaska#boddosaš	gasska#båddusasj	a
gaska#gielddalaš	gasska#gieldalasj	a
gaska#mearálaš	gasska#mærálasj	a
gaska#áigásaš	gasska#ájggásasj	a
gaska#árvosaš	gasska#árvvusasj	a
gaskan#šatta	gasskan#sjatta	a
gaskanas	gasskanas	a
gaskandaga	gasskandaga	a
gaskaneas	gasskaneas	a
gaskkaheapme	gaskaheapme	a
gaskkasaš	gaskasasj	a
gastrologalaš	gastrulogalasj	a
gastronomalaš	gastrunomalasj	a
gavjái	gavjjáj	a
gavri	gavrre	a
gavžžas	gavtjas	a
geahpas	giehpas	a
geahpedan#gelbbolaš	giehpedan#gelbulasj	a
geahppat	giehppat	a
geahčimeahttun	giehtjemeahttun	a
geahčálas	gæhtjálas	a
geaiddus	giejdus	a
geailo#hámat	giejlo#hámát	a
geaisárlaš	gæjssárlasj	a
geamus	giemus	a
geanoheapme	gienuheapme	a
geanuheapme	gienuheapme	a
gearddaš	gierdasj	a
gearpmus	giermus	a
gearrat	gierrat	a
geaseheapme	gieseheapme	a
geasiheapme	gieseheapme	a
geasoheapme	giesuheapme	a
geasse#ruonas	giesse#ruonas	a
geassi#ruonas	giesse#ruonas	a
geassil	giessel	a
geasuheaddji	giesuheaddje	a
geavatlaš	gievatlasj	a
geavllas	gievlas	a
geavrras	gievras	a
geavzzas	gievtsas	a
geađas	giedas	a
geađgái	gærggáj	a
geažehis	gietjehes	a
geažo	gietjo	a
geažos	gietjus	a
gehppes	gehppes	a
gehppeslágan	gehppeslágan	a
gehppeslágán	gehppeslágán	a
gene^alogálaš	gene^alugálasj	a
genehtalaš	genehtalasj	a
generatiiva	generatijva	a
generealla	generealla	a
generella	generella	a
genitiiva#hápmásaš	genetijva#hábmásasj	a
geniála	geniála	a
geo#sentrála	geo#sentrála	a
geo^gráfalaš	geo^gráfálasj	a
geologalaš	geolugalasj	a
geometralaš	geometralasj	a
geometrihkalaš	geometrihkalasj	a
geotermihkalaš	geotermihkalasj	a
gerremas	gerremas	a
gesii	gesij	a
giddat	giddat	a
giekcájeaddji	giektsájeaddje	a
giela#gaskasaš	giela#gasskasasj	a
gieldalaš	gielldalasj	a
gielddus	gieldus	a
giella#dieđalaš	giella#diedalasj	a
giella#oahpalaš	giella#oahpalasj	a
gierddoheapme	gierduheapme	a
gierdevaš	gierddevasj	a
gieskadaš	giesskadasj	a
giimmas	gijmas	a
giitimeahttun	gijttemeahttun	a
gillomaddjái	gillumaddjáj	a
gillámeahttun	gillámeahttun	a
gilvvakeahtes	gilvakeahtes	a
gilvvehahtti	gilvehahtte	a
gilvvihahtti	gilvehahtte	a
girji#loguheapme	girjje#låguheapme	a
girkat	girkkat	a
girrat	girrat	a
givrosaš	givrrusasj	a
givssas	givsas	a
giđđasaš	giddasasj	a
globála	glåbåla	a
globálalaš	glåbålalasj	a
glottála	glåttåla	a
goabbat#beallásaš	goabbat#bællásasj	a
goabmái	goabbmáj	a
goahcce#lágan	goahttse#lágán	a
goahcce#lágaš	goahttse#lágasj	a
goahcce#lágán	goahttse#lágán	a
goahcce#lágáš	goahttse#lágásj	a
goahkkái	goahkkáj	a
goaiddus	goajdus	a
goaidi	goajdde	a
goakšat	goaktjat	a
goalššas	goalsjas	a
goappeš	goappesj	a
goarkŋohahtti	goarŋuhahtte	a
goarpmohahtti	goarmuhahtte	a
goavis	goaves	a
goavkkas	goavkas	a
goađiheapme	goadeheapme	a
gobas	gåbås	a
gohpi#vuđot	gåhpe#vudut	a
gohtolaš	gåhtulasj	a
goike	gåjkke	a
goikil	gåjkkel	a
goikivaš	gåjkkevasj	a
gokčevaš	gåktjevasj	a
golbma#oktalaš	gålmmå#åktålasj	a
golbma#ollil	gålmmå#ållel	a
golgil	gålggel	a
golgoslágan	gålgguslágan	a
golgoslágán	gålgguslágán	a
gollil	gållel	a
golmma#beaivásaš	gålmå#bæjvvásasj	a
golmma#ceahkálaš	gålmå#tsæhkálasj	a
golmma#gearddáš	gålmå#gærdásj	a
golmma#geardán	gålmå#gærddán	a
golmma#geardásaš	gålmå#gærddásasj	a
golmma#juvllat	gålmå#juvlat	a
golmma#oasat	gålmå#åsat	a
golmma#oktalaš	gålmå#åktålasj	a
golmma#oktasaš	gålmå#åktåsasj	a
golmma#sárgálaš	gålmå#sárggálasj	a
golmma-jahkásaš	gålmå-jahkásasj	a
golnnas	gålnås	a
gomohalli	gåmuhalle	a
gonagaslaš	gånågaslasj	a
goreheapme	gåreheapme	a
goriheapme	gåreheapme	a
gorrálas	gårrålas	a
gortnas	gårnås	a
gotihkalaš	gåtehkalasj	a
gottiheapme	gåtteheapme	a
govdat	gåvddåt	a
govddoheapme	gåvduheapme	a
govddus	gåvdus	a
govdosaš	gåvddusasj	a
govnnas	gåvnås	a
govttohis	gåvtuhes	a
govttolaš	gåvtulasj	a
govttolašmeahttun	gåvtulasjmeahttun	a
govvideaddji	gåvvedeaddje	a
govččoheapme	gåvtjuheapme	a
govččolaš	gåvtjulasj	a
grammatalaš	grammatalasj	a
grammáhtalaš	grammáhtalasj	a
greikkalaš	grejkalasj	a
groteaska	gråteaska	a
gráfalaš	gráfálasj	a
grámmasaš	grámmasasj	a
gudni#dievas	guddne#dievas	a
gudniheapme	guddneheapme	a
guhke#dáleš	guhke#dálesj	a
guhke#áigásaš	guhke#ájggásasj	a
guhkes#áiggi	guhkes#ájge	a
guhkes#áigásaš	guhkes#ájggásasj	a
guhkilmas	guhkelmas	a
guhkolaš	guhkulasj	a
guhkálmas	guhkálmas	a
guimmešvuođalágan	gujmesjvuodalágan	a
gulavaš	gulávasj	a
gullevaš	gullevasj	a
gullivaš	gullevasj	a
gullojeaddji	gullujeaddje	a
gullomeahttun	gullumeahttun	a
gulus	gulus	a
gumpái	gumppáj	a
guoddevaš	guoddevasj	a
guoddin#nákcalaš	guodden#náktsalasj	a
guohca	guohtsa	a
guoikái	guojkkáj	a
guokte#ollil	guokte#ållel	a
guoktelaš	guoktelasj	a
guoleheapme	guoleheapme	a
guoliheapme	guoleheapme	a
guollái	guolláj	a
guonna	guonna	a
guorahallameahttun	guorahallameahttun	a
guoros	guorus	a
guorranmeahttun	guorranmeahttun	a
guorus	guorus	a
guoskameahttun	guosskameahttun	a
guoskevaš	guosskevasj	a
guoskkaheaddji	guoskaheaddje	a
guossaskas	guossaskas	a
guovda#geaidnolaš	guovdda#giejnnulasj	a
guovddášlaš	guovdásjlasj	a
guovllu#guovdasaš	guovlo#guovddasasj	a
guovllu#psykiátralaš	guovlo#psykiátralasj	a
guovlu#politihkalaš	guovllo#påletihkalasj	a
guovlu#politihkkalaš	guovllo#påletihkkalasj	a
guovlulaš	guovllulasj	a
guovnnjas	guovnjas	a
guovtte#bealat	guovte#bielat	a
guovtte#beallásaš	guovte#bællásasj	a
guovtte#bealát	guovte#bælát	a
guovtte#dássásaš	guovte#dássásasj	a
guovtte#gearddaš	guovte#gierdasj	a
guovtte#geardán	guovte#gærddán	a
guovtte#geardásaš	guovte#gærddásasj	a
guovtte#juvllat	guovte#juvlat	a
guovtte#miesat	guovte#miesat	a
guovtte#oasat	guovte#åsat	a
guovtte#ollil	guovte#ållel	a
guovtte#suorat	guovte#suorat	a
guovtte#sárgálaš	guovte#sárggálasj	a
guovtte#čilggolaš	guovte#tjilgulasj	a
guovttelágan	guovtelágan	a
guovtti#gaskasaš	guovte#gasskasasj	a
guovtti#guolmmat	guovte#guolmat	a
guovttá#gaskasaš	guovtá#gasskasasj	a
gurccas	gurtsas	a
gurdui	gurdduj	a
gurggástat#guovdasaš	gurgástat#guovddasasj	a
gurrái	gurráj	a
gurut	gurut	a
guskkolaš	guskulasj	a
gustojeaddji	gusstujeaddje	a
gustomeahttun	gusstumeahttun	a
gustovaš	gusstuvasj	a
gutniheapme	gudneheapme	a
guvges#ruoksat	guvgges#ruoksat	a
guvlolaš	guvllulasj	a
gádnosaš	gáddnusasj	a
gáfat	gáfát	a
gáhtten#árvosaš	gáhtten#árvvusasj	a
gáiddus	gájdus	a
gáirras	gájrras	a
gáldo#projektionála	gálldo#pråjektionála	a
gálggus	gálgus	a
gálmmas	gálmas	a
gálos	gálus	a
gálus	gálus	a
gálššas	gálsjas	a
gánnihahtti	gánnehahtte	a
gánnáhahtti	gánnáhahtte	a
gáppus	gáppus	a
gárka	gárkka	a
gárkka	gárka	a
gárkkis	gárkes	a
gárkŋas	gárŋas	a
gárvviheapme	gárveheapme	a
gáržžekeahtes	gártjekeahtes	a
gávddas	gávdas	a
gávpelaš	gávppelasj	a
gávrras	gávras	a
gávvar	gávvar	a
gávzzas	gávtsas	a
harbmadas	harmmadas	a
harbmat	harmmat	a
harmonalaš	harmunalasj	a
harmoniijalaš	harmunijjalasj	a
harmovnnalaš	harmuvnalasj	a
hatteheapme	hatteheapme	a
hattiheapme	hatteheapme	a
heagga#váldi	hiegga#vállde	a
heahkas	hiehkas	a
heahpatlaš	hiehpatlasj	a
heahpatmeahttun	hiehpatmeahttun	a
heaila	hiejla	a
heailla	hiejlla	a
heaivvoheapme	hiejvuheapme	a
heajoslágan	hiejuslágan	a
heajoslágán	hiejuslágán	a
heakka#deaŧalaš	hiekka#dietalasj	a
heakka#dehálaš	hiekka#dehálasj	a
heakka#váralaš	hiekka#várálasj	a
heakka#várálaš	hiekka#várálasj	a
healpu	hielppo	a
hearrákeahtes	hærrákeahtes	a
heava	hieva	a
heađiheapme	hiedeheapme	a
heila	hejla	a
heilla	hejlla	a
heittot	hejtut	a
heivemeahttun	hejvvemeahttun	a
heivetmeahttun	hejvvetmeahttun	a
heivvolaš	hejvulasj	a
hermehtalaš	hermehtalasj	a
hermetihkalaš	hermetihkalasj	a
herveja	hervveja	a
heterogena	heterogena	a
hevskkálaš	hevskálasj	a
hevssolaš	hevsulasj	a
hiebanas	hiebanas	a
hier^árkkalaš	hier^árkalasj	a
hilján	hiljján	a
hirbmat	hirmmat	a
hirbmatlaš	hirmmatlasj	a
hirpmus	hirmus	a
hirras	hirras	a
historjjákeahtes	hissturjjákeahtes	a
historjjálaš	hissturjjálasj	a
historjá-bi^o^grafiija	hissturjá-bi^o^grafijja	a
historjálaš	hissturjálasj	a
hoalddaheapme	hoaldaheapme	a
hobas	håbås	a
hohppil	håhppel	a
homo#seksuála	håmo#seksoála	a
homogena	håmugena	a
horisontálalaš	håresontálalasj	a
huksenkeahtes	huksenkeahtes	a
humaniteara	humániteara	a
humanitára	humánitára	a
humoristtalaš	humuristalasj	a
humána	humána	a
humánalaš	humánalasj	a
huvlla	huvla	a
hypera	hypera	a
hypotehtalaš	hyputehtalasj	a
háittis	hájtes	a
hálddahuslaš	háldahuslasj	a
hálddatlaš	háldatlasj	a
hálssas	hálsas	a
hálttat	háltat	a
hámiheapme	hámeheapme	a
hápme#jámas	hábme#jámás	a
hápme#oahpalaš	hábme#oahpalasj	a
hápmásaš	hábmásasj	a
háriheapme	háreheapme	a
hárjjiheapme	hárjeheapme	a
hármonalaš	hármunalasj	a
hármovnnalaš	hármuvnalasj	a
hárras	hárras	a
hárvenaš	hárvvenasj	a
hárvi	hárvve	a
hávrra	hávra	a
hávskkes	hávskes	a
háváš	hávásj	a
iddjái	iddjáj	a
idealaš	idealasj	a
idealisttalaš	idealistalasj	a
ideanttalaš	ideanttalasj	a
ideationála	ideationála	a
ideologalaš	ideologalasj	a
ideologálaš	ideologálasj	a
ideála	ideála	a
idiomáhtalaš	idiomáhtalasj	a
idjasaš	idjasasj	a
iehčanas	iehtjanas	a
ievttá	ievtá	a
ievttáš	ievtásj	a
ieš#addiluvvon	iesj#addeluvvon	a
ieš#buorre	iesj#buorre	a
ieš#gieđalaš	iesj#giedalasj	a
ieš#guhtetlágan	iesj#guhtetlágan	a
ieš#guđetgelágan	iesj#gudetgelágan	a
ieš#guđetgelágaš	iesj#gudetgelágasj	a
ieš#guđetgelágán	iesj#gudetgelágán	a
ieš#guđetgelágáš	iesj#gudetgelágásj	a
ieš#guđetlágan	iesj#gudetlágan	a
ieš#guđetlágán	iesj#gudetlágán	a
ieš#lágalaš	iesj#lágálasj	a
ieš#oahppan	iesj#oahppan	a
ieš#ráhkaduvvon	iesj#ráhkaduvvon	a
ieš#vuđot	iesj#vudut	a
iežas#lágan	ietjas#lágán	a
iežas#lágán	ietjas#lágán	a
iežaslaš	ietjaslasj	a
iežálágan	ietjálágan	a
ihttá	ihttá	a
ihtá	ihtá	a
ihtáš	ihtásj	a
ii-referentiála	ij-referentiála	a
ilgadit	ilggadet	a
illatiiva#hápmásaš	illatijva#hábmásasj	a
illudahtti	illudahtte	a
im^plikationála	im^plikátionála	a
im^plisihtta	im^plisehtta	a
im^pressiiva	im^pressijva	a
imaginára	imáginára	a
imašlaš	imasjlasj	a
immaneanta	immaneanta	a
immateriálalaš	immateriálalasj	a
impersonála	imppersonála	a
in^struktiiva	in^struktijva	a
in^transitiiva	in^transsetijva	a
indefinihtta	inddefinihtta	a
individuála	inddeviduála	a
individuálalaš	inddeviduálalasj	a
indiviidalaš	inddevijdalasj	a
indo-fijilaš	inddo-fijelasj	a
industriijalaš	inddustrijjalasj	a
industriála	inddustriála	a
infernálalaš	infernálalasj	a
infinihta	infenihta	a
infinihtta	infenihtta	a
inkonsekveanta	inkunsekveanta	a
instinktiiva	insstenktijva	a
inteansa	intteansa	a
intellektuála	inttellektuála	a
intelligeanta	inttelligeanta	a
intensiiva	inttensijva	a
intentionála	inttentionála	a
inter#aktiiva	intter#aktijva	a
inter#aktiivalaš	intter#aktijvalasj	a
inter#legála	intter#legála	a
inter#našonála	intter#nasjunála	a
inter#našunála	intter#nasjunála	a
inter#našunálalaš	intter#nasjunálalasj	a
inter#našuvnnalaš	intter#nasjuvnalasj	a
inter#naššuvnnalaš	intter#nassjuvnalasj	a
inter#nášunála	intter#násjunála	a
inter#psykologalaš	intter#psykulogalasj	a
inter#tekstuála	intter#tekstoála	a
intra#kultuvrralaš	intra#kulltuvrralasj	a
intra#psykologalaš	intra#psykulogalasj	a
intrusiiva	intrusijva	a
ipmilaš	ibmelasj	a
ipmillaš	ibmellasj	a
ipmirdahtti	ibmerdahtte	a
ipmirmeahttun	ibmermeahttun	a
ironalaš	irunalasj	a
ironiijalaš	irunijjalasj	a
ironálaš	irunálasj	a
irrationála	irrationála	a
isitkeahtes	isetkeahtes	a
islamihtalaš	islamihtalasj	a
issoras	issuras	a
ittis	ittes	a
ivdnái	ivnnáj	a
ivdnásaš	ivnnásasj	a
ivnneheapme	ivneheapme	a
ivnniheapme	ivneheapme	a
ivttá	ivtá	a
ivttáš	ivtásj	a
iđalaš	idálasj	a
iđedaš	idedasj	a
jagŋi	jaggŋe	a
jagŋil	jaggŋel	a
jahkas	jahkas	a
jalahas	jaláhas	a
jappas	jappas	a
jarkŋas	jarŋas	a
jassái	jassáj	a
jeageheapme	jiegeheapme	a
jeageleaddjái	jiegeleaddjáj	a
jeagelgeahtes	jiegelgeahtes	a
jeagelha	jiegelha	a
jeagelheapme	jiegelheapme	a
jeagelkeahtes	jiegelkeahtes	a
jeagiheapme	jiegeheapme	a
jeagilheapme	jiegelheapme	a
jeahkalahtes	jiehkalahtes	a
jeahkaleaddjái	jiehkaleaddjáj	a
jeahkálahtes	jæhkálahtes	a
jealahas	jielahas	a
jeavddalaš	jievdalasj	a
jeđđehahtti	jeddehahtte	a
jiegŋái	jieggŋáj	a
jiekŋa#galmmas	jiegŋa#galmas	a
jierpmiheapme	jiermeheapme	a
jiesas	jiesas	a
jiessas	jiessas	a
jietna#vuoigadahtton	jiedna#vuojggadahtton	a
jietnadat#lágalaš	jiednadat#lágálasj	a
jietnasaš	jiednasasj	a
jievjjaheapme	jievjaheapme	a
jievjái	jievjjáj	a
jievttá	jievtá	a
joallu	joallo	a
joatkevaš	joatkevasj	a
joatkkoheapme	joatkkuheapme	a
joavggas	joavgas	a
joavggus	joavgus	a
joggái	jåggåj	a
jognái	jågnåj	a
jogŋái	jåggŋåj	a
joraheapme	jåråheapme	a
jorgalmeahttun	jårggålmeahttun	a
jorggo#buiccas	jårgo#bujtsas	a
jorril	jårrel	a
jotkkolaš	jåtkkulasj	a
jođiheapme	jådeheapme	a
jođoheapme	jåduheapme	a
jođuheapme	jåduheapme	a
jugahahtti	jugáhahtte	a
juogakeahtes	juogakeahtes	a
juogehahtti	juogehahtte	a
juogihahtti	juogehahtte	a
juogoheapme	juoguheapme	a
juohke#beaivválaš	juohke#bæjválasj	a
juohke#beallásaš	juohke#bællásasj	a
juohkelágan	juohkelágan	a
juohkemeahttun	juohkemeahttun	a
juohkešlái	juohkesjláj	a
juohkimeahttun	juohkemeahttun	a
juohkásmeahttun	juohkásmeahttun	a
juolggiheapme	juolgeheapme	a
juollet	juollet	a
juorbbas	juorbas	a
juorbbehas	juorbehas	a
juovvái	juovváj	a
jurddašmeahttun	jurdasjmeahttun	a
juridihkalaš	juredihkalasj	a
juvssahahtti	juvsahahtte	a
jádnil	jáddnel	a
jáffui	jáffuj	a
jáfo#fiinnis	jáfo#fijnes	a
jáhkehahtti	jáhkehahtte	a
jáhketmeahttun	jáhketmeahttun	a
jáhkihahtti	jáhkehahtte	a
jáhkkemeahttun	jáhkkemeahttun	a
jáhkkimeahttun	jáhkkemeahttun	a
jálddos	jáldus	a
jámmis	jámmes	a
jánas	jánás	a
jápmimeahttun	jábmemeahttun	a
jápmán	jábmán	a
jávkameahttun	jávkkameahttun	a
jávrreheapme	jávreheapme	a
jávrriheapme	jávreheapme	a
kapitalisttalaš	kapetalistalasj	a
kardinála	karddenála	a
kataforalaš	katáforalasj	a
katolihkalaš	katulihkalasj	a
kaukasialaš	kaukasialasj	a
kemihkalaš	kemehkalasj	a
kemiijalaš	kemijjalasj	a
kirurgalaš	kirurgalasj	a
kivrosaš	kivrrusasj	a
klassihkalaš	klassehkalasj	a
klimáhtalaš	klimáhtalasj	a
klinalaš	klinálasj	a
knáhpis	knáhpes	a
kollegiála	kållegiála	a
kollektiivvalaš	kållektijvvalasj	a
koloni^alisttalaš	kålune^alestalasj	a
koltálaš	kålltålasj	a
komihkalaš	kåmehkalasj	a
kommersiealla	kåmmersiealla	a
kommersiála	kåmmersiála	a
kommunikatiiva	kåmmunikatijva	a
kommunála	kåmmunála	a
komplementára	kåmplementára	a
kon^stitutionála	kån^stitutionála	a
kon^stitušonála	kån^stitutjonála	a
kon^stitušunála	kån^stitutjunála	a
kon^struktiiva	kån^struktijva	a
kon^struktiivalaš	kån^struktijvalasj	a
kon^struktiivvalaš	kån^struktijvvalasj	a
konkrehta	kånkrehta	a
konkrehtalaš	kånkrehtalasj	a
konsekveanta	kånssekveanta	a
konseptoála	kånsseptoála	a
konseptuála	kånsseptuála	a
konstitušunealla	kånsstetusjunealla	a
kontinentála	kånttenentála	a
kontrastiivvalaš	kåntråstijvvalasj	a
kontroversiealla	kåntruversiealla	a
koreferentiála	kåreferentiála	a
korporatiiva	kårppuratijva	a
kosmehtalaš	kåssmehtalasj	a
kreatiiva	krietijva	a
kreatiivalaš	krietijvalasj	a
kristálla#čuovgat	krisstálla#tjuovggat	a
kristállalaš	krisstállalasj	a
kromáhtalaš	kråmåhtalasj	a
kronalaš	krånålasj	a
kronologalaš	krånulogalasj	a
kruvdnasaš	kruvnnasasj	a
kruvdnosaš	kruvnnusasj	a
kultur#politihkalaš	kulltur#påletihkalasj	a
kultuvrralaš	kulltuvrralasj	a
kuohca	kuohtsa	a
kuonna	kuonna	a
kuorus	kuorus	a
kursiiva	kurssijva	a
kvalitatiivalaš	kvaletatijvalasj	a
kvantitatiiva	kvanttetatijva	a
kvantitatiivalaš	kvanttetatijvalasj	a
kyrillalaš	kyrellalasj	a
labiála	labiála	a
laddjui	laddjuj	a
ladjat	ladjat	a
ladnjil	laddnjel	a
laestadiána	laesstadiána	a
lagabuš	lagábusj	a
lagas	lagás	a
lagat	lagát	a
lagaš	lagasj	a
lahkalas	lahkalas	a
lahkkálas	lahkkálas	a
lastái	lasstáj	a
latnjat	ladnjat	a
lavttis	lavtes	a
laššit	lassjet	a
leabbat	liebbat	a
leahkemeahttun	liehkemeahttun	a
leahkimeahttun	liehkemeahttun	a
leakkas	liekkas	a
leamssas	liemsas	a
leastadialaš	liesstadialasj	a
leatmeahttun	lietmeahttun	a
leavllas	lievlas	a
leavvi	lievve	a
legála	legála	a
leksikográfalaš	leksekográfalasj	a
leksikála	leksekála	a
leksikálalaš	leksekálalasj	a
liberála	liberála	a
liberálalaš	liberálalasj	a
libmii	libbmij	a
liebmái	liebbmáj	a
liehmos	liehmus	a
lievllisteaddji	lievlesteaddje	a
lievvil	lievvel	a
liigi#guhkki	lijgge#guhkke	a
liigi#hearki	lijgge#hierkke	a
lingvistihkalaš	lingvestihkalasj	a
lingvisttalaš	lingvestalasj	a
linjas	linjás	a
livttis	livtes	a
liđbmat	lirmmat	a
liđvvas	lirvas	a
loabmái	loabbmáj	a
loadtja	loadtja	a
loahpalaš	loahpalasj	a
loahppameahttun	loahppameahttun	a
loahtis	loahtes	a
loaktevaš	loaktevasj	a
loamššas	loamsjas	a
loaččis	loattjes	a
loažžat	loadtjat	a
lobiheapme	låbeheapme	a
lobmui	låbbmuj	a
lobálaš	låbålasj	a
logahahtti	lågåhahtte	a
logalaš	lågålasj	a
logihkalaš	lågehkalasj	a
logoforalaš	låguforalasj	a
lohkameahttun	låhkåmeahttun	a
lohtat	låhtåt	a
lojála	låjåla	a
lokála	låkåla	a
lonjas	lånjås	a
losideaddji	låsedeaddje	a
lotkat	låtkåt	a
lotnjat	lådnjåt	a
lovttolaš	låvtulasj	a
loškkas	låsjkås	a
lu#jávrrelaš	lu#jávrelasj	a
luhtolaš	luhtulasj	a
luoddái	luoddáj	a
luodnái	luoddnáj	a
luohpi	luohpe	a
luohtehahtti	luohtehahtte	a
luohtihahtti	luohtehahtte	a
luomus	luomus	a
luonddu#dieđalaš	luondo#diedalasj	a
luonddu#dilálaš	luondo#dilálasj	a
luonddu#vuostásaš	luondo#vuosstásasj	a
luonddulágan	luondulágan	a
luonddulágán	luondulágán	a
luoskkas	luoskas	a
luossa#biebman#friija	luossa#biebbman#frijja	a
luossái	luossáj	a
luottaheapme	luottaheapme	a
luovddalas	luovdalas	a
luođaheapme	luodaheapme	a
luođđái	luoddáj	a
luoškkas	luosjkas	a
lusa#beassameahttun	lusa#biessameahttun	a
luteralaš	luteralasj	a
luvnnja	luvnja	a
luvvil	luvvel	a
luŋkkas	luŋkas	a
lyralaš	lyrálasj	a
lyrihkalaš	lyrehkalasj	a
láfos	láfus	a
lága#fámolaš	lága#fámulasj	a
lága#vuosttas	lága#vuostas	a
lága#vuostásaš	lága#vuosstásasj	a
lágan	lágán	a
lágán	lágán	a
láhka#fámolaš	láhka#fámulasj	a
láhka#čálakeahtes	láhka#tjálákeahtes	a
láhkalágan	láhkalágan	a
láhkalágán	láhkalágán	a
láitimeahttun	lájttemeahttun	a
láittehahtti	lájtehahtte	a
láittihahtti	lájtehahtte	a
lákcái	láktsáj	a
lámas	lámás	a
lámis	lámes	a
lánas	lánás	a
láskko#njuolgat	lásko#njuolggat	a
lávccaheapme	lávttsaheapme	a
lávgalas	lávggalas	a
lávgat	lávggat	a
lávggaheapme	lávgaheapme	a
lávggoheapme	lávguheapme	a
lávgil	lávggel	a
lávlleheapme	lávleheapme	a
lávlliheapme	lávleheapme	a
lávttas	lávtas	a
lávvolágan	lávvulágan	a
lávvolágán	lávvulágán	a
lávžálas	lávttjálas	a
láđas	ládás	a
læstadi^alaš	læsstade^alasj	a
læstadi^olaš	læsstade^ålåsj	a
magihkalaš	magehkalasj	a
magiijalaš	magijjalasj	a
mahtásaš	mahtásasj	a
majestehtalaš	majestehtalasj	a
makkáraš	makkárasj	a
maksimála	maksemála	a
manahahtti	manáhahtte	a
maniheapme	maneheapme	a
mannan#idjasaš	mannan#idjasasj	a
mannosaš	mannusasj	a
marginála	marggenála	a
maritiibma	maretijmma	a
maritiima	maretijma	a
matemáhtalaš	matemáhtalasj	a
materi^alisttalaš	matere^alestalasj	a
matriarkálalaš	matriarkálalasj	a
mađáš	madásj	a
maŋit	maŋet	a
maŋit#vurrosaš	maŋet#vurrusasj	a
maŋŋelaš	maŋŋelasj	a
maŋŋit	maŋŋet	a
meamma	miemma	a
meammas	miemmas	a
mearka#vuđot	mierkka#vudut	a
mearkkahahtti	mierkahahtte	a
mearkkašahtti	mierkatjahtte	a
mearkkašeaddji	mierkatjeaddje	a
mearkkašmeahttun	mierkasjmeahttun	a
mearre#projektionála	mierre#pråjektionála	a
mearre#áigásaš	mierre#ájggásasj	a
mearridan#válddálaš	mierredan#váldálasj	a
mearritmeahttun	mierretmeahttun	a
meavrresgárelágan	mievresgárelágan	a
meađggus	miergus	a
meađmma	mierma	a
medisiinnalaš	medesijnalasj	a
mediála	mediála	a
megalománalaš	megálománalasj	a
mekánalaš	mekánalasj	a
melodramáhtalaš	meludramáhtalasj	a
mentála	menttála	a
mentálalaš	menttálalasj	a
merolaš	merulasj	a
mesolihtalaš	mesulihtalasj	a
meta#gielalaš	meta#gielalasj	a
metaforalaš	metáforalasj	a
metatehtalaš	metátehtalasj	a
meteorologalaš	meteorologalasj	a
metodologalaš	metudologalasj	a
miehte#doaris	miehte#doares	a
miehti#doaris	miehte#doares	a
miehtá#riikasaš	miehtá#rijkkasasj	a
mieiggus	miejgus	a
miel#riegádan	miel#riegádan	a
miela#evttot	miela#evtut	a
mielaid#geassi	mielajd#giesse	a
mielkkiheapme	mielkeheapme	a
miella#giddevaš	miella#giddevasj	a
miella#hápmásaš	miella#hábmásasj	a
miesiheapme	mieseheapme	a
miessái	miessáj	a
mievkkis	mievkes	a
mihtilmas	mihtelmas	a
mihtitmeahttun	mihtetmeahttun	a
miháš	mihásj	a
militearalaš	miletearalasj	a
militánta	miletánta	a
miljovdnasaš	miljjuvnnasasj	a
minimála	minemála	a
minuktasaš	minuktasasj	a
mirkkolaš	mirkulasj	a
moaitimeahttun	moajttemeahttun	a
moaittehahtti	moajtehahtte	a
moakkas	moakkas	a
moalas	målas	a
moalkkas	moalkas	a
moalkás	moalkkás	a
moallái	moalláj	a
moatte#vahkkosaš	moatte#vahkkusasj	a
moattelágan	moattelágan	a
moattelágán	moattelágán	a
moattilágan	moattelágan	a
moattilágán	moattelágán	a
mobiila	måbijla	a
modearna	mådearna	a
mohkeheapme	måhkeheapme	a
mohkiheapme	måhkeheapme	a
mohkkái	måhkkåj	a
mohtorkeahtes	måhturkeahtes	a
mohttái	måhttåj	a
molddas	måldås	a
molsa#eaktolaš	målsså#iektulasj	a
molssa#ektosaš	målså#ektusasj	a
molssa#evttolaš	målså#evtulasj	a
molssolaš	målsulasj	a
momentána	måmentána	a
monemuš#hámat	månemusj#hámát	a
monimuš#hámat	månemusj#hámát	a
monogámalaš	månugámalasj	a
monopollágan	månupollágan	a
monopollágán	månupollágán	a
moralalaš	mårålalasj	a
morfofonologalaš	mårffufonologalasj	a
morfologalaš	mårffulogalasj	a
morfologálaš	mårffulogálasj	a
morrái	mårråj	a
morálalaš	mårålalasj	a
moskkus	måskus	a
mosttas	måstås	a
motoralaš	måturalasj	a
muddosaš	muddusasj	a
muhtehahtekeahtes	muhtehahtekeahtes	a
muhtinlágan	muhtenlágan	a
muhtinlágaš	muhtenlágasj	a
muhtinlágán	muhtenlágán	a
muhtinlágáš	muhtenlágásj	a
muhtunlágan	muhtunlágan	a
muhtunlágaš	muhtunlágasj	a
muhtunlágán	muhtunlágán	a
muhtunlágáš	muhtunlágásj	a
muidui	mujdduj	a
mukkas	mukkas	a
multi#funktionála	mullte#funktionála	a
multi#funkšunála	mullte#funksjunála	a
multi#laterála	mullte#laterála	a
multi#medialaš	mullte#medialasj	a
muohta#vielgat	muohta#vielggat	a
muohtaheapme	muohtaheapme	a
muolddas	muoldas	a
muoldái	muolldáj	a
muoraheapme	muoraheapme	a
muorrái	muorráj	a
muosiheapme	muoseheapme	a
muosvvis	muosvves	a
murtolas	murttulas	a
musihkkalaš	musehkkalasj	a
musikálalaš	musekálalasj	a
muttát	muttát	a
mystihkalaš	mysstehkalasj	a
mytologalaš	mytulogalasj	a
má^ilmmi#viidosaš	má^ilme#vijddusasj	a
máddeleabbo	máddeleabbo	a
mágihkalaš	mágehkalasj	a
mágiijalaš	mágijjalasj	a
mágnehtalaš	mágnehtalasj	a
máhccevaš	máhttsevasj	a
máihlleheapme	májhleheapme	a
máihlliheapme	májhleheapme	a
máilmme#loga	májlmme#lågå	a
máilmmi#loga	májlmme#lågå	a
máinnašuvvon	májnatjuvvon	a
máinniheapme	májneheapme	a
máisttoheapme	májstuheapme	a
máizzas	májtsas	a
málle#gelbbolaš	málle#gelbulasj	a
márke#mearrásaš	márkke#mærrásasj	a
máttibuš	máttebusj	a
máđoheapme	máduheapme	a
máŋga#holddet	máŋgga#håldet	a
máŋgga#bealat	máŋga#bielat	a
máŋgga#beallásaš	máŋga#bællásasj	a
máŋgga#bealálaš	máŋga#bælálasj	a
máŋgga#buolvvat	máŋga#buolvat	a
máŋgga#dieđalaš	máŋga#diedalasj	a
máŋgga#dássásaš	máŋga#dássásasj	a
máŋgga#fágalaš	máŋga#fágálasj	a
máŋgga#geardán	máŋga#gærddán	a
máŋgga#geardásaš	máŋga#gærddásasj	a
máŋgga#ivdnásaš	máŋga#ivnnásasj	a
máŋgga#lágan	máŋga#lágán	a
máŋgga#suorat	máŋga#suorat	a
máŋgga#čearddalaš	máŋga#tjierdalasj	a
máŋggaid#gaskasaš	máŋgajd#gasskasasj	a
máŋggalágan	máŋgalágan	a
máŋggalágán	máŋgalágán	a
máŋggašlái	máŋgasjláj	a
mášiinnalaš	másjijnalasj	a
máŧoheapme	mátuheapme	a
máŧolaš	mátulasj	a
máŧuheapme	mátuheapme	a
nalas	nalás	a
namahahtti	namáhahtte	a
namakeahtes	namákeahtes	a
nana#guoddevaš	nana#guoddevasj	a
nannehahtti	nannehahtte	a
nannemeahttun	nannemeahttun	a
nasála	nasála	a
nationála	nationála	a
nautalaš	nautalasj	a
navkkas	navkas	a
nađaheapme	nadáheapme	a
nađđa#joatkkalaš	nadda#joatkkalasj	a
našonála	nasjunála	a
našunála	nasjunála	a
našuvnnalaš	nasjuvnalasj	a
naššuvnnalaš	nassjuvnalasj	a
neagoheapme	nieguheapme	a
nearas	nieras	a
nearoheapme	nieruheapme	a
negatiiva	negátijva	a
negatiivalaš	negátijvalasj	a
negatiivvalaš	negátijvvalasj	a
neo#lihtalaš	neo#lihtalasj	a
neo^grammatihkalaš	neo^grammatihkalasj	a
nepper	nepper	a
neutrála	neutrála	a
nevvot	nevvut	a
niesttiheapme	niesteheapme	a
nievkkas	nievkas	a
njabas	njabás	a
njagas	njagás	a
njalppas	njalpas	a
njalssas	njalsas	a
njaláhas	njaláhas	a
njarvvas	njarvas	a
njavgat	njavggat	a
njavččas	njavtjas	a
njealje#geardán	njieljje#gærddán	a
njealje#geardásaš	njieljje#gærddásasj	a
njeallje#juvllat	njiellje#juvlat	a
njeavccas	njievttsas	a
njeađgi	njiergge	a
njeaššas	njiessjas	a
njieloheapme	njieluheapme	a
njieluheapme	njieluheapme	a
njivlla	njivla	a
njivllas	njivlas	a
njoahppat	njoahppat	a
njoahppil	njoahppel	a
njoaiddus	njoajdus	a
njoalccas	njoaltsas	a
njoalokeahtes	njoalukeahtes	a
njoalppas	njoalpas	a
njoađggas	njoargas	a
njoađvvas	njoarvas	a
njuneheapme	njuneheapme	a
njuniheapme	njuneheapme	a
njuokkas	njuokkas	a
njuokčan#vuloš	njuoktjan#vulusj	a
njuolggadus#vuloš	njuolgadus#vulusj	a
njuolggaduslaš	njuolgaduslasj	a
njuolgguslaš	njuolguslasj	a
njuolvves	njuolves	a
njuorradeaddji	njuorradeaddje	a
njuorvvas	njuorvas	a
njuorššas	njuorsjas	a
njuovžil	njuovttjel	a
njuovžžas	njuovtjas	a
njáiggos	njájgus	a
njáikkas	njájkas	a
njálggat	njálgat	a
njálggis	njálges	a
njálmmiheapme	njálmeheapme	a
njárgái	njárggáj	a
njávkkas	njávkas	a
njázos	njátsus	a
njáđđi	njádde	a
njáŋggas	njáŋgas	a
noaiddes	noajdes	a
nohkameahttun	nåhkåmeahttun	a
nohkavaš	nåhkåvasj	a
nohkkivaš	nåhkkevasj	a
nominatiiva#hápmásaš	nåmenatijva#hábmásasj	a
nominála	nåmenála	a
nomotehtalaš	nåmutehtalasj	a
normatiiva	nårmåtijva	a
normála	nårmåla	a
norrøna	nårrøna	a
nu#gohčoduvvon	nu#gåhtjuduvvon	a
nubbe	nubbe	a
nuohtaheapme	nuohtaheapme	a
nuolus	nuolus	a
nuoraid#psykiátralaš	nuorajd#psykiátralasj	a
nuovvas	nuovvas	a
nuppe#árvosaš	nuppe#árvvusasj	a
nuppelágan	nuppelágan	a
nuppáš	nuppásj	a
nurddas	nurdas	a
nurssas	nursas	a
náddjil	náddjel	a
náiiva	nájjva	a
náitalgeahtes	nájttalgeahtes	a
náitoslágan	nájttuslágan	a
nálggas	nálgas	a
náliheapme	náleheapme	a
nárvvas	nárvas	a
návvái	návváj	a
nášunála	násjunála	a
nášunálalaš	násjunálalasj	a
nášuvnnalaš	násjuvnalasj	a
nášuvnnála	násjuvnála	a
nášuvnála	násjuvnála	a
náššuvnnalaš	nássjuvnalasj	a
nøytrála	nøytrála	a
oahpismeahttun	oahpesmeahttun	a
oaidnimeahttun	oajnnemeahttun	a
oainnus	oajnus	a
oaive#lámis	oajvve#lámes	a
oaive#njuolggaduslaš	oajvve#njuolgaduslasj	a
oaivvesnaga	oajvesnaga	a
oaivviheapme	oajveheapme	a
oallásahtes	oallásahtes	a
oami#dovddoheapme	oame#dåvduheapme	a
oanehis#áigásaš	oanehis#ájggásasj	a
oapmedaš	oabmedasj	a
oaraheapme	åraheapme	a
oasiheapme	oaseheapme	a
oasse#mávssekeahtes	oasse#mávsekeahtes	a
oasse#áigásaš	oasse#ájggásasj	a
oassálaš	oassálasj	a
oavlái	oavlláj	a
oavsseheapme	oavseheapme	a
oavssiheapme	oavseheapme	a
oaččiheapme	oattjeheapme	a
oađekeat	oadekeat	a
objektiiva	åbjektijva	a
objektiivvalaš	åbjektijvvalasj	a
obmui	åbbmuj	a
observationála	åbservationála	a
offensiiva	åffensijva	a
offensiivvalaš	åffensijvvalasj	a
oidduheapme	åjduheapme	a
okkasionála	åkkåsionála	a
okta#geardán	åktå#gærddán	a
okta#geardásaš	åktå#gærddásasj	a
okta#vuolgganas	åktå#vuolganas	a
oktagaslaš	åktågaslasj	a
oktalaš	åktålasj	a
oktasaš	åktåsasj	a
oktat	åktåt	a
oktii#gullevaš	åktij#gullevasj	a
oktii#heivvolaš	åktij#hejvulasj	a
oktii#soahpevaš	åktij#soahpevasj	a
oktii#soahppevaš	åktij#soahppevasj	a
oktilaš	åktelasj	a
oktilis	åkteles	a
olatmeahttun	ålåtmeahttun	a
olbmoheapme	ålmmuheapme	a
olgeš	ålggesj	a
olggos#buoidi	ålgus#buojdde	a
olggubuš	ålgubusj	a
olgguldas	ålguldas	a
olggut	ålgut	a
olgo#parlamentáralaš	ålggo#parlamentáralasj	a
olgo#riikka#politihkalaš	ålggo#rijka#påletihkalasj	a
ollašuhttin#gelbbolaš	ållåtjuhttin#gelbulasj	a
olles#áigásaš	ålles#ájggásasj	a
olles#árvosaš	ålles#árvvusasj	a
ollislaš	ålleslasj	a
ollol#vuloš	ållul#vulusj	a
ollu	ållo	a
olmmoš#nákkis	ålmusj#nákkes	a
olu	ålo	a
olympalaš	ålympalasj	a
onomasiologalaš	ånumasiologalasj	a
operatiivvalaš	åperatijvvalasj	a
oppa	åppå	a
oppa#eurohpálaš	åppå#euruhpálasj	a
oppalaš	åppålasj	a
optimistalaš	åptemistalasj	a
optimála	åptemála	a
oranša	åråntja	a
ordásaš	årddåsasj	a
organisatoralaš	årggånisatoralasj	a
organisatovrralaš	årggånisatovrralasj	a
organisatuvrralaš	årggånisatuvrralasj	a
orgánalaš	årggånalasj	a
orientála	årientála	a
ortnet#gullevaš	årnet#gullevasj	a
orto^gráfalaš	årtto^gráfálasj	a
ortodoksalaš	årttudoksalasj	a
ortopedalaš	årttupedalasj	a
ortopediijalaš	årttupedijjalasj	a
oruhahtti	åruhahtte	a
oránša	åråntja	a
otná	ådnå	a
ovda#historjjálaš	åvddå#hissturjjálasj	a
ovda#mearkkalaš	åvddå#mierkalasj	a
ovda#romálaš	åvddå#råmålasj	a
ovdal#áiggi#riegádan	åvddål#ájge#riegádan	a
ovdalaš	åvddålasj	a
ovddas#vástáduslaš	åvdås#vásstáduslasj	a
ovddet#jagáš	åvdet#jagásj	a
ovddeš	åvdesj	a
ovddit	åvdet	a
ovdáneaddji	åvddåneaddje	a
ovtta#bealat	åvtå#bielat	a
ovtta#beallásaš	åvtå#bællásasj	a
ovtta#bealálaš	åvtå#bælálasj	a
ovtta#bealát	åvtå#bælát	a
ovtta#dimensionála	åvtå#dimensionála	a
ovtta#dássásaš	åvtå#dássásasj	a
ovtta#geardán	åvtå#gærddán	a
ovtta#geardásaš	åvtå#gærddásasj	a
ovtta#givrosaš	åvtå#givrrusasj	a
ovtta#guhkkosaš	åvtå#guhkkusasj	a
ovtta#háválaš	åvtå#háválasj	a
ovtta#háváš	åvtå#hávásj	a
ovtta#ivnnálaš	åvtå#ivnálasj	a
ovtta#luoddasaš	åvtå#luoddasasj	a
ovtta#lágan	åvtå#lágán	a
ovtta#mađu	åvtå#mado	a
ovtta#náittuslaš	åvtå#nájtuslasj	a
ovtta#oaivil	åvtå#oajvvel	a
ovtta#sorttat	åvtå#sårtåt	a
ovtta#sparggálaš	åvtå#spargálasj	a
ovtta#sullasaš	åvtå#sullasasj	a
ovtta#sárgálaš	åvtå#sárggálasj	a
ovtta#veardásaš	åvtå#værddásasj	a
ovtta#vásttolaš	åvtå#vástulasj	a
ovtta#áigásaš	åvtå#ájggásasj	a
ovtta#árvosaš	åvtå#árvvusasj	a
ovtta#čilggolaš	åvtå#tjilgulasj	a
ovttagaslaš	åvtågaslasj	a
ovttaheapme	åvtåheapme	a
ovttalaš	åvtålasj	a
ovttalágan	åvtålágan	a
ovttastuvvon	åvtåstuvvon	a
ovttilis	åvteles	a
ođasnuvakeahtes	ådåsnuvakeahtes	a
ođđa#mállet	åddå#mállet	a
ođđa#áigásaš	åddå#ájggásasj	a
ođđa^ivnnálaš	åddå^ivnálasj	a
palestiinnálaš	palestijnálasj	a
paradigmáhtalaš	parádigmáhtalasj	a
parlamentaralaš	parlamentaralasj	a
parlamenttalaš	parlamenttalasj	a
partiála	parttiála	a
passiivvalaš	passijvvalasj	a
patriarkálalaš	patriarkálalasj	a
peailasaš	piejlasasj	a
pedagogalaš	pedágogalasj	a
pedagogálaš	pedágogálasj	a
persovnnaheapme	perssuvnaheapme	a
persovnnalaš	perssuvnalasj	a
persovnnálaš	perssuvnálasj	a
persuvnnaheapme	perssuvnaheapme	a
persuvnnalaš	perssuvnalasj	a
peršuvnnalaš	perssjuvnalasj	a
pivlii	pivllij	a
pneumáhtalaš	pneumáhtalasj	a
po^ehtalaš	po^ehtalasj	a
politihkalaš	påletihkalasj	a
politihkkalaš	påletihkkalasj	a
politihkálaš	påletihkálasj	a
polygamiijalaš	pålygamijjalasj	a
polygámalaš	pålygámalasj	a
polára	pålåra	a
populeara#dieđalaš	påpuleara#diedalasj	a
populára	påpulára	a
posetiiva	påsetijva	a
positiiva	påsetijva	a
positiivalaš	påsetijvalasj	a
positiivvalaš	påsetijvvalasj	a
potentiála	påtentiála	a
pragmatihkalaš	pragmatihkalasj	a
pragmáhtalaš	pragmáhtalasj	a
praktihkalaš	praktehkalasj	a
prejudisiála	prejudisiála	a
preliminára	preleminára	a
prenten#gárvvis	prentten#gárves	a
primitiiva	primetijva	a
primitiivvalaš	primetijvvalasj	a
primára	primára	a
prinsihpalaš	prinssehpalasj	a
prinsihppalaš	prinssehppalasj	a
prinsipiála	prinssepiála	a
prinsipála	prinssepála	a
priváhta#rievttálaš	priváhta#rievtálasj	a
priváhta#vuoigatvuođalaš	priváhta#vuojggatvuodalasj	a
priváhtta	priváhtta	a
pro^gressiiva	pro^gressijva	a
pro^klihtalaš	pro^klihtalasj	a
problemáhtalaš	pråblemáhtalasj	a
produktiiva	pråduktijva	a
produktiivvalaš	pråduktijvvalasj	a
profehtalaš	pråfehtalasj	a
programmáhtalaš	prågråmmáhtalasj	a
projektionála	pråjektionála	a
prosentuála	pråsentuála	a
prosessu^ealla	pråsessu^iella	a
prosessuála	pråsessuála	a
prosálaš	pråsålasj	a
protestánttalaš	pråtestánttalasj	a
psyhkalaš	psyhkalasj	a
psyhkálaš	psyhkálasj	a
psykalaš	psykálasj	a
psykihkalaš	psykehkalasj	a
psykiátralaš	psykiátralasj	a
psykohtalaš	psykuhtalasj	a
psykologalaš	psykulogalasj	a
psykosomáhtalaš	psykusomáhtalasj	a
psykososiála	psykusosiála	a
punktuála	punktoála	a
pytagoralaš	pytágoralasj	a
páraheapme	páráheapme	a
pássiivvalaš	pássijvvalasj	a
raddálas	raddálas	a
radi^o#aktiiva	rade^o#aktijva	a
rahkat	rahkat	a
rahpas	rahpas	a
rajá#rastá	rajá#rasstá	a
rasisttalaš	rasestalasj	a
rastásaš	rasstásasj	a
rationála	rationála	a
ravdameahttun	ravddameahttun	a
ravddabuš	ravdabusj	a
ravddaheapme	ravdaheapme	a
ravddamus	ravdamus	a
ravjjas	ravjas	a
re^ella	re^ella	a
re^fleksiiva	re^fleksijva	a
re^presentatiiva	re^presentatijva	a
reahalaš	riehalasj	a
realistalaš	rielestalasj	a
reanzzas	rientsas	a
recessiiva	retsessijva	a
referentiála	referentiála	a
regi^onála	rege^ånåla	a
regi^onálalaš	rege^ånålalasj	a
regi^onálaš	rege^ånålasj	a
regi^unála	rege^unála	a
regiovdna#politihkalaš	regiovnna#påletihkalasj	a
registar#guovdasaš	regestar#guovddasasj	a
regulára	regulára	a
rehelaš	rehelasj	a
rekursiiva	rekursijva	a
relatiiva	relátijva	a
relatiivalaš	relátijvalasj	a
relationála	relátionála	a
relationálalaš	relátionálalasj	a
relevánta	relevánta	a
restriktiiva	restrektijva	a
retoralaš	returalasj	a
retorihkalaš	returihkalasj	a
retro#grádalaš	retro#grádálasj	a
reumáhtalaš	reumáhtalasj	a
revmáhtalaš	revmáhtalasj	a
reála	reála	a
reálistalaš	reálestalasj	a
reálisttalaš	reálestalasj	a
riddo#lagaš	riddo#lagasj	a
riebas	riebas	a
riekta	riekta	a
riektat	riektat	a
riekte#vuoimmalaš	riekte#vuojmalasj	a
riektelaš	riektelasj	a
rieppis	rieppes	a
rievdameahttun	rievddameahttun	a
rievdavaš	rievddavasj	a
rievssat	rievsat	a
rievssatheapme	rievsatheapme	a
rievssatkeahtes	rievsatkeahtes	a
rievttalaš	rievtalasj	a
rihkkasmeahttun	rihkkasmeahttun	a
rihča	rihtja	a
riikka#viidosaš	rijka#vijddusasj	a
riikkaid#gaskasaš	rijkajd#gasskasasj	a
riikkaidgaskkasaš	rijkajdgaskasasj	a
riikkasaš	rijkasasj	a
rikkas	rikkas	a
riskkaheapme	riskaheapme	a
rista#ráiddat	rissta#rájdat	a
ritmái	ritmáj	a
rittubuš	rittubusj	a
rivttes#oahpalaš	rivtes#oahpalasj	a
rišša#fiskat	rissja#fisskat	a
riššagoikkis	rissjagojkkes	a
roahkkálas	roahkkálas	a
roakkas	roakkas	a
roamššas	roamsjas	a
roanccas	roantsas	a
roassái	roassáj	a
roava	råva	a
roavis	roaves	a
roavččas	roavtjas	a
roađđat	roaddat	a
rohkkolas	råhkkulas	a
rohttejeaddji	råhttejeaddje	a
rohčat	råhtjåt	a
rojalisttalaš	råjålistalasj	a
romantalaš	råmåntalasj	a
romantihkalaš	råmåntihkalasj	a
románttalaš	råmånttalasj	a
rožas	råtjås	a
rukses#ruoná	rukses#ruoná	a
rukses-ruoná	rukses-ruoná	a
rukseslágan	rukseslágan	a
runta	runtta	a
ruobbe#coagis	ruobbe#tsoages	a
ruobbegoikkis	ruobbegojkkes	a
ruogŋái	ruoggŋáj	a
ruohppái	ruohppáj	a
ruohtis	ruohtes	a
ruojus	ruojus	a
ruoksat	ruoksat	a
ruoksájeaddji	ruoksájeaddje	a
ruonas	ruonas	a
ruoná	ruoná	a
ruonálágan	ruonálágan	a
ruossalas	ruossalas	a
ruostameahttun	ruosstameahttun	a
ruosti	ruosste	a
ruosttaheapme	ruostaheapme	a
ruovas	ruovas	a
ruovddaheapme	ruovdaheapme	a
ruovjjiheapme	ruovjeheapme	a
ruovttoheapme	ruovtuheapme	a
ruošša#beal	ruossja#biel	a
ruoŧa#giel	ruota#giel	a
russolas	russulas	a
ruvdnosaš	ruvnnusasj	a
ruvsui	ruvssuj	a
rytmálaš	rytmálasj	a
rábmii	rábbmij	a
rádi^o#aktiiva	ráde^o#aktijva	a
rádja#guovllu#guovdasaš	rádja#guovlo#guovddasasj	a
rádjilihkot	rádjelihkot	a
rádjálas	rádjálas	a
ráfiheapme	ráfeheapme	a
ráhkaduslaš	ráhkaduslasj	a
ráigioaivvat	rájggioajvvat	a
rájákeahtes	rájákeahtes	a
rámssas	rámsas	a
rámššas	rámsjas	a
rándulaš	ránddulasj	a
ránes#ruškat	ránes#russjkat	a
ránis	ránes	a
ráseheapme	ráseheapme	a
rásiheapme	ráseheapme	a
rásisttalaš	rásestalasj	a
rássái	rássáj	a
rávnnjeheapme	rávnjeheapme	a
rávnnjiheapme	rávnjeheapme	a
ráđas	rádás	a
ráđiheapme	rádeheapme	a
ráđus	rádus	a
ráđđeaddi	ráddeadde	a
sahpit	sahpet	a
saiggas	sajgas	a
sajiheapme	sajeheapme	a
salggas	salgas	a
sallalas	sallalas	a
seagas	siegas	a
seagus	siegus	a
seagáš	sægásj	a
seahkalas	siehkalas	a
seahkalis	siehkales	a
seahkálas	sæhkálas	a
seaibbiheapme	siejbeheapme	a
seainnibuš	siejnebusj	a
seakkisis	siekkeses	a
sealas	sielas	a
sealbbus	sielbus	a
sealggálas	sælgálas	a
sealggális	sælgáles	a
sealgálas	sælggálas	a
sealvi	sielvve	a
sealvvas	sielvas	a
seamma#dássásaš	siemma#dássásasj	a
seamma#govdosaš	siemma#gåvddusasj	a
seamma#háltásaš	siemma#hálltásasj	a
seamma#sullasaš	siemma#sullasasj	a
seamma#árvosaš	siemma#árvvusasj	a
seammalágan	siemmalágan	a
seammá#lágan	sæmmá#lágán	a
seammá#sullásaš	sæmmá#sullásasj	a
seammádássásaš	sæmmádássásasj	a
seammálágan	sæmmálágan	a
searválas	særvválas	a
seavdda	sievda	a
seavdnjat	sievnnjat	a
seavnnjus	sievnjus	a
seađas	siedas	a
seađus	siedus	a
seaŋgga#buorre	sieŋga#buorre	a
segmentálalaš	segmentálalasj	a
seismalaš	sejssmalasj	a
seksualálaš	seksoalálasj	a
seksuála	seksoála	a
seksuálaš	seksoálasj	a
sekundára	sekundára	a
sekventiála	sekventiála	a
selggolas	selgulas	a
selggolassii	selgulassij	a
semantihkalaš	semántihkalasj	a
semanttalaš	semánttalasj	a
semasiologalaš	semásiologalasj	a
semiohtalaš	semiohtalasj	a
semánttalaš	semánttalasj	a
sentimentála	senttementála	a
serddolaš	serdulasj	a
servodat#dieđalaš	servvudat#diedalasj	a
servodat#ekonomálaš	servvudat#ekunomálasj	a
servodat#vuostásaš	servvudat#vuosstásasj	a
servodatlaš	servvudatlasj	a
servodatlágan	servvudatlágan	a
servodatlágán	servvudatlágán	a
servvolaš	servulasj	a
sexualálaš	sexoalálasj	a
siddjii	siddjij	a
sidnui	siddnuj	a
sieddjái	sieddjáj	a
sieiva	siejvva	a
sierra	sierra	a
sierralágan	sierralágan	a
sierranas	sierranas	a
sievssaheapme	sievsaheapme	a
sieđas	siedas	a
sieđgái	sierggáj	a
sieđus	siedus	a
signifikánta	signefikánta	a
sihkar	sihkar	a
sihkkar	sihkkar	a
siiddalmas	sijdalmas	a
siido#doaibmasaš	sijddo#doajmmasasj	a
siidosaš	sijddusasj	a
siidái	sijddáj	a
siivolágan	sijvvulágan	a
siivvuheapme	sijvuheapme	a
silbasaš	silbbasasj	a
silbái	silbbáj	a
sillat	sillat	a
sinas	sinás	a
sipirjálaš	siperjálasj	a
sireráhkaduvvon	sireráhkaduvvon	a
sirkumpolára	sirkkumpolára	a
sisbuoidi	sisboojde	a
siskkaldas	siskaldas	a
siskkibuš	siskebusj	a
siskkildas	siskeldas	a
siskkit	sisket	a
siskkáldas	siskáldas	a
siskálas	sisskálas	a
siskálasti	sisskálaste	a
sivakeahtes	sivákeahtes	a
siviila#vuoigatvuođalaš	sivijla#vuojggatvuodalasj	a
siđus	sidus	a
skavžžas	skavtjas	a
skeartnja	skiernja	a
skehpposaš	skehppusasj	a
skemáhtalaš	skemáhtalasj	a
skeptihkalaš	skeptehkalasj	a
skieraskas	skieraskas	a
skievttáris	skievtáres	a
skihčas	skihtjas	a
skivnnjas	skivnjas	a
skiŋgil	skiŋggel	a
skjemáhtalaš	skjemáhtalasj	a
skoalddas	skoaldas	a
skoarras	skoarras	a
skoavddas	skoavdas	a
skohčči#bealjat	skåhttje#bieljjat	a
skolas	skålås	a
skožas	skåtjås	a
skuhttáris	skuhttáres	a
skuittas	skujtas	a
skurras	skurras	a
skurččas	skurtjas	a
skužas	skutjás	a
skáddjil	skáddjel	a
skáhppái	skáhppáj	a
skáigil	skájggel	a
skálvvas	skálvas	a
skárllat	skárllat	a
skárllat#ruoksat	skárllat#ruoksat	a
skárppis	skárpes	a
skárttas	skártas	a
smoahtis	smoahtes	a
smoalddas	smoaldas	a
smolggus	smålgus	a
smulkkas	smulkas	a
smurta#čáhppat	smurtta#tjáhppat	a
smurvvas	smurvas	a
smávislágan	smáveslágan	a
smávislágaš	smáveslágasj	a
snarras	snarras	a
snavggas	snavgas	a
snielis	snieles	a
snoakkis	snoakkes	a
snogas	snågås	a
snoras	snårås	a
snáhpis	snáhpes	a
snárkkas	snárkas	a
snárri	snárre	a
soabat#gorálaš	såbat#gårålasj	a
soadjas	soadjas	a
soadje#orddálaš	soadje#årdålasj	a
soahkkái	soahkkáj	a
soahpavaš	soahpavasj	a
soahppevaš	soahppevasj	a
soahtigiivvis	soahtegijvves	a
soajiheapme	soajeheapme	a
soalddas	soaldas	a
soameslágan	soameslágan	a
soamiheapme	soameheapme	a
soarppas	soarpas	a
soarvveheapme	soarveheapme	a
soarvviheapme	soarveheapme	a
soavllas	soavlas	a
soaččas	soattjas	a
soađe#maŋáš	soade#maŋásj	a
soađi#áigásaš	soade#ájggásasj	a
soft-gun	såft-gun	a
sohkabeal#guoskevaš	såhkåbeal#guosskevasj	a
sohkenis	såhkenes	a
soiddas	såjdås	a
soidnáris	såjnnåres	a
sojankeahtes	såjånkeahtes	a
sojuheapme	såjuheapme	a
sokkibuš	såkkebusj	a
soktái	såktåj	a
solidáralaš	såledáralasj	a
somáhtalaš	såmåhtalasj	a
sonjas	sånjås	a
soras	sårås	a
sorjankeahtes	sårjjånkeahtes	a
sorjjakeahtes	sårjåkeahtes	a
sorjjas	sårjås	a
sorjjaskeahtes	sårjåskeahtes	a
sorjjasmeahttun	sårjåsmeahttun	a
sosi^ala	såse^ala	a
sosi^alisttalaš	såse^alestalasj	a
sosi^o#ekonomálaš	såse^o#ekunomálasj	a
sosi^o#kultuvrralaš	såse^o#kulltuvrralasj	a
sosi^o-kultuvrralaš	såse^o-kulltuvrralasj	a
sosi^ologalaš	såse^ålugalasj	a
sosiál#darwinistalaš	såsiál#darwenistalasj	a
sosiála	såsiála	a
sosiála#demo^kráhtalaš	såsiála#demo^kráhtalasj	a
sosiála#politihkalaš	såsiála#påletihkalasj	a
sosiálalaš	såsiálalasj	a
sovkkenis	såvkenes	a
sovttas	såvtås	a
spakkas	spakkas	a
spalccas	spaltsas	a
spanjas	spanjás	a
spealnnjas	spielnjas	a
speanta	spientta	a
spesifalaš	spesefalasj	a
spesifihkka	spesefihkka	a
spesiála	spesiála	a
spesiála#pedagogalaš	spesiála#pedágogalasj	a
spierta#čáhppat	spiertta#tjáhppat	a
spildar#ođas	spilldar#ådås	a
spinjas	spinjás	a
spoadnái	spoaddnáj	a
spoanas	spånas	a
spontána	spånttåna	a
spáhkis	spáhkes	a
spáigil	spájggel	a
spásmmalaš	spásmalasj	a
sráŋggaheapme	sráŋgaheapme	a
statihkalaš	statehkalasj	a
statistalaš	statestalasj	a
steanžžas	stientjas	a
steavdda	stievda	a
steaččas	stiettjas	a
stereo#tiippalaš	stereo#tijpalasj	a
stiivvis	stijves	a
stilistalaš	stilestalasj	a
stilistihkalaš	stilestihkalasj	a
stirddus	stirdus	a
stohkas	ståhkås	a
stožas	ståtjås	a
strukturalisttalaš	strukturalistalasj	a
strukturála	strukturála	a
struktuvrralaš	struktuvrralasj	a
stuorebuš	stuorebusj	a
sturccas	sturtsas	a
stábat	stábát	a
stáhppái	stáhppáj	a
stáhta#eanádatlaš	stáhta#ænádatlasj	a
stáleheapme	stáleheapme	a
stáliheapme	stáleheapme	a
stáččas	státtjas	a
subjektiiva	subjektijva	a
subjektiivvalaš	subjektijvvalasj	a
subsidiára	subsediára	a
subsidiáralaš	subsediáralasj	a
subtropalaš	subtrupalasj	a
suddil	suddel	a
sudnii	suddnij	a
sudnjui	suddnjuj	a
suhkkes	suhkkes	a
suhkkol#hámat	suhkkul#hámát	a
suhppái	suhppáj	a
suksii	suksij	a
sullalas	sullalas	a
sullasaš	sullasasj	a
sullásaš	sullásasj	a
suoddjái	suoddjáj	a
suodnái	suoddnáj	a
suohkanlaš	suohkanlasj	a
suohkkul	suohkkul	a
suoibma#mohkat	suojmma#måhkåt	a
suojeheapme	suojeheapme	a
suojiheapme	suojeheapme	a
suokkis	suokkes	a
suoksái	suoksáj	a
suollemas	suollemas	a
suoma#giel	suoma#giel	a
suopmaniid#gaskasaš	suobmanijd#gasskasasj	a
suorge#joatkkalaš	suorgge#joatkkalasj	a
suorggatlaš	suorgatlasj	a
suorggi#guovdasaš	suorge#guovddasasj	a
suorgái	suorggáj	a
suovat	suovat	a
suovggas	suovgas	a
surgat	surggat	a
surgatlaš	surggatlasj	a
suvdil	suvddel	a
syklihkalaš	syklehkalasj	a
symbolalaš	symbbulalasj	a
symbolihkalaš	symbbulihkalasj	a
symmehtralaš	symmehtralasj	a
symmetrihkalaš	symmetrihkalasj	a
symptomáhtalaš	symptumáhtalasj	a
syn^kronalaš	syn^krånålasj	a
synonymalaš	synunymalasj	a
synsemánttalaš	synssemánttalasj	a
syntagmáhtalaš	synttagmáhtalasj	a
syntehtalaš	synttehtalasj	a
syntávsslaš	synttávsslasj	a
syntávttalaš	synttávttalasj	a
systemahtalaš	sysstemahtalasj	a
systemáhtalaš	sysstemáhtalasj	a
sáhkat	sáhkat	a
sáhkkit	sáhkket	a
sáhpeheapme	sáhpeheapme	a
sáhpiheapme	sáhpeheapme	a
sáhtehahtti	sáhtehahtte	a
sáhtihahtti	sáhtehahtte	a
sáiggas	sájgas	a
sáissas	sájsas	a
sákkas	sákkas	a
sálte#doallevaš	sállte#doallevasj	a
sáltteheapme	sálteheapme	a
sálttiheapme	sálteheapme	a
sálttisis	sálteses	a
sáme#giel	sáme#giel	a
sáme#politihkalaš	sáme#påletihkalasj	a
sáme#vulgosaš	sáme#vulggusasj	a
sánekeahtes	sánekeahtes	a
sániheapme	sáneheapme	a
sátne#siskkáldas	sádne#siskáldas	a
sátne#álgosaš	sádne#álggusasj	a
sávahahtti	sáváhahtte	a
sávaldat#guovdásaš	sáváldat#guovddásasj	a
taktiila	taktijla	a
teahtis	tiehtes	a
teatrálalaš	tætrálalasj	a
teknalaš	teknalasj	a
teknihkalaš	teknehkalasj	a
teknihkkalaš	teknehkkalasj	a
teknologalaš	teknulogalasj	a
tekstuála	tekstoála	a
telihkalaš	telehkalasj	a
tematalaš	temátalasj	a
temporála	temppurála	a
temáhtalaš	temáhtalasj	a
teologalaš	teolugalasj	a
termála	termála	a
territoriála	terretoriála	a
tiibmosaš	tijmmusasj	a
toleránta	tåleránta	a
topo^gráfalaš	tåpo^gráfálasj	a
tragihkalaš	tragehkalasj	a
transitiiva	transsetijva	a
transitiivvalaš	transsetijvvalasj	a
traumáhtalaš	traumáhtalasj	a
tribunála	tribunála	a
triviála	triviála	a
trohpalaš	tråhpålasj	a
trolahis	trålåhes	a
tropalaš	tråpålasj	a
tuljánis	tuljjánes	a
tullut	tullut	a
tuolloheapme	tuolluheapme	a
tupaan	tupaan	a
tuvalaš	tuválasj	a
typihkalaš	typehkalasj	a
táhpalaš	táhpalasj	a
uhcis	uhtses	a
uhcánaš	uhtsánasj	a
ulbmillaš	ulmmellasj	a
ulbmilmeahttun	ulmmelmeahttun	a
ulbmálaš	ulmmálasj	a
ulbmállaš	ulmmállasj	a
ultra^mariidna	ultra^marijnna	a
umas	umás	a
umassi	umásse	a
universála	uneversála	a
unohas	unuhas	a
utnuheapme	udnuheapme	a
uvjjaheapme	uvjaheapme	a
vadnil	vaddnel	a
vahccái	vahttsáj	a
vahkat	vahkat	a
vahkosaš	vahkusasj	a
vahátlaš	vahátlasj	a
valanis	valánes	a
valljogas	valljugas	a
valljugas	valljugas	a
valljái	valljáj	a
vanhurskkismeahttun	vanhurskismeahttun	a
varra#ruškat	varra#russjkat	a
veadjetmeahttun	viedjetmeahttun	a
veahkiheapme	viehkeheapme	a
veahkkálas	væhkkálas	a
veahtas	viehtas	a
veaittalas	viejtalas	a
veaittalis	viejtales	a
veajitmeahttun	viejetmeahttun	a
vealggiheapme	vielgeheapme	a
vealtameahttun	vielltameahttun	a
veanzzas	vientsas	a
veara	viera	a
vearddeheapme	vierdeheapme	a
vearddiheapme	vierdeheapme	a
veardidan#gelbbolaš	vierddedan#gelbulasj	a
vearditmeahttun	vierddetmeahttun	a
veardásaš	værddásasj	a
vearjjuheapme	vierjuheapme	a
vearoheapme	vieruheapme	a
vearokeahtes	vierukeahtes	a
vearrasaš	vierrasasj	a
vearre#oahpalaš	vierre#oahpalasj	a
vearri#oahpalaš	vierre#oahpalasj	a
veartasaš	vierttasasj	a
vearuheapme	vieruheapme	a
veasttabuš	viestabusj	a
veađas	viedas	a
vepselaš	vepselasj	a
verbála	verbbála	a
vertikálalaš	verttekálalasj	a
viedni	vieddne	a
viepmat	viebmat	a
vierggeheapme	viergeheapme	a
vierggiheapme	viergeheapme	a
vierro#giel	vierro#giel	a
vierttos	viertus	a
vihkkái	vihkkáj	a
vihkosaš	vihkusasj	a
viiddisis	vijdeses	a
viidosaš	vijddusasj	a
vilddus	vildus	a
vilges#áissat	vilgges#ájsat	a
violeahtta	violeahtta	a
virtuála	virttoála	a
visot	visut	a
vissismeahttun	vissesmeahttun	a
visuála	visoála	a
viđa#geardán	vida#gærddán	a
viđa#geardásaš	vida#gærddásasj	a
viŋkil#njuolgat	viŋkkel#njuolggat	a
vokálaid#gaskasaš	våkålajd#gasskasasj	a
vuddjii	vuddjij	a
vulgára	vulggára	a
vulkánalaš	vulkkánalasj	a
vuobmái	vuobbmáj	a
vuoddji#guovdasaš	vuoddje#guovddasasj	a
vuoddjul	vuoddjul	a
vuoddjái	vuoddjáj	a
vuodnái	vuoddnáj	a
vuogiheapme	vuogeheapme	a
vuogádatlaš	vuogádatlasj	a
vuohtus	vuohtus	a
vuoiddasaddjái	vuojdasaddjáj	a
vuoigat	vuojggat	a
vuoiggameahttun	vuojgameahttun	a
vuoimmalaš	vuojmalasj	a
vuoimmiheapme	vuojmeheapme	a
vuoittiheapme	vuojteheapme	a
vuojaheapme	vuojaheapme	a
vuojuheapme	vuojuheapme	a
vuojus	vuojus	a
vuoksái	vuoksáj	a
vuolit	vuolet	a
vuolit#árvosaš	vuolet#árvvusasj	a
vuolle#ahkáhaš	vuolle#ahkáhasj	a
vuolle#árvosaš	vuolle#árvvusasj	a
vuollálas	vuollálas	a
vuollálasti	vuollálaste	a
vuonabuš	vuonabusj	a
vuopmat	vuobmat	a
vuorddehahtti	vuordehahtte	a
vuordemeahttun	vuorddemeahttun	a
vuordetmeahttun	vuorddetmeahttun	a
vuordimeahttun	vuorddemeahttun	a
vuordnása#dahkan	vuornnása#dahkan	a
vuorji	vuorjje	a
vuorukeahtes	vuorukeahtes	a
vuoste#doaris	vuosste#doares	a
vuoste#fápmo#adversatiiva	vuosste#fábmo#adversatijva	a
vuosti#doaris	vuosste#doares	a
vuosttaš#riegádan	vuostasj#riegádan	a
vuostálas	vuosstálas	a
vuotnaheapme	vuodnaheapme	a
vuovssaheapme	vuovsaheapme	a
vuođoheapme	vuoduheapme	a
vuođuheapme	vuoduheapme	a
vuođđo#jurddalaš	vuoddo#jurdalasj	a
vuođđo#njuolggaduslaš	vuoddo#njuolgaduslasj	a
vuođđo#skandinávalaš	vuoddo#skanddenávalasj	a
vurrolas	vurrulas	a
vádjit#válddálaš	vádjet#váldálasj	a
váhnemahtes	váhnemahtes	a
váhnengeahtes	váhnengeahtes	a
váhčči	váhttje	a
váibmo#reađahahtti	vájmmo#riedahahtte	a
váidalahtti	vájddalahtte	a
váigat	vájggat	a
váikkuhan#válddálaš	vájkuhan#váldálasj	a
váilevaš	vájlevasj	a
váimmo#bávččas	vájmo#bávtjas	a
váimmuheapme	vájmuheapme	a
válddiheapme	váldeheapme	a
válde#gottálaš	vállde#gåttålasj	a
váldi#váillat	vállde#vájllat	a
váldo#doaibmasaš	válldo#doajmmasasj	a
váldosaš	válldusasj	a
válga#dohkálaš	válgga#dåhkålasj	a
váli#dahkan	vále#dahkan	a
válljugas	válljugas	a
válmmas	válmas	a
válmmaš	válmasj	a
vánttalaš	vántalasj	a
várddus	várdus	a
váribuš	várebusj	a
váriheapme	váreheapme	a
várveš	várvvesj	a
vásedin	váseden	a
vássevaš	vássevasj	a
vástesaš	vásstesasj	a
vástevaš	vásstevasj	a
vástideaddji	vásstedeaddje	a
vástitmeahttun	vásstetmeahttun	a
vásttuheapme	vástuheapme	a
vátni#čalmmat	vádne#tjalmat	a
váttis	váttes	a
vávjjehahtti	vávjehahtte	a
vávjjihahtti	vávjehahtte	a
váŋká	váŋkká	a
áboheapme	ábuheapme	a
áddehahtti	áddehahtte	a
áddemeahttun	áddemeahttun	a
áddetmeahttun	áddetmeahttun	a
áddevaš	áddevasj	a
áhcagas	áhtsagas	a
áhpiheapme	áhpeheapme	a
áhppar	áhppar	a
áhtis	áhtes	a
áhčeheapme	áhtjeheapme	a
áibmadas	ájmmadas	a
áibmagas	ájmmagas	a
áibmo#divttis	ájmmo#divtes	a
áicavaš	ájttsavasj	a
áiccalmas	ájtsalmas	a
áicemeahtton	ájttsemeahtton	a
áicemeahttun	ájttsemeahttun	a
áidalas	ájddalas	a
áidelas	ájddelas	a
áidna	ájnna	a
áidno#riegádan	ájnno#riegádan	a
áidnu	ájnno	a
áidonkeahtes	ájddunkeahtes	a
áigadas	ájggadas	a
áigahaš	ájggahasj	a
áigasaš	ájggasasj	a
áiggaš	ájgasj	a
áiggeheapme	ájgeheapme	a
áiggiheapme	ájgeheapme	a
áiggáš	ájgásj	a
áigodatlaš	ájggudatlasj	a
áigái#heivvolaš	ájggáj#hejvulasj	a
áitosaš	ájttusasj	a
áivan	ájvvan	a
áktánas	áktánas	a
ákusttalaš	ákustalasj	a
ákvahtalaš	ákvahtalasj	a
álbmogiid#gaskasaš	álmmugijd#gasskasasj	a
álbmot#rievttalaš	álmmut#rievtalasj	a
álbmot#válddálaš	álmmut#váldálasj	a
álbmotlaš	álmmutlasj	a
álbmái	álmmáj	a
álgo#skandinávalaš	álggo#skanddenávalasj	a
álgo#vuolggalaš	álggo#vuolgalasj	a
álgo#vurrosaš	álggo#vurrusasj	a
álgo#álgosaš	álggo#álggusasj	a
álgosaš	álggusasj	a
álkkes	álkes	a
álmmeheapme	álmeheapme	a
álmmiheapme	álmeheapme	a
álo#ruonas	álo#ruonas	a
álolaš	álulasj	a
álás	álás	a
ámmát#suorgái	ámmát#suorggáj	a
ántihkalaš	ánttehkalasj	a
árbbiheapme	árbeheapme	a
árbe#virolaš	árbbe#virulasj	a
árbe#vuoiggalaš	árbbe#vuojgalasj	a
árjjiheapme	árjeheapme	a
árpmoheapme	ármuheapme	a
árrat	árrat	a
árvitmeahttun	árvvetmeahttun	a
árvugas	árvvugas	a
áskkas	áskas	a
ásppas	ásppas	a
ásttas	ástas	a
ávda	ávdda	a
ávdin	ávdden	a
ávgat	ávggat	a
ávjjas	ávjas	a
ávjjeheapme	ávjeheapme	a
ávjjiheapme	ávjeheapme	a
ávjjoheapme	ávjuheapme	a
ávjosaš	ávjjusasj	a
ávkkeheapme	ávkeheapme	a
ávkkiheapme	ávkeheapme	a
ávnnas#guovdasaš	ávnas#guovddasasj	a
ávnnaslaš	ávnaslasj	a
áđat	ádát	a
ášše#guoskekeahtes	ássje#guosskekeahtes	a
ášše#guoskevaš	ássje#guosskevasj	a
áššái#gullevaš	ássjáj#gullevasj	a
áššái#guoskevaš	ássjáj#guosskevasj	a
økonomálaš	økunomálasj	a
čabo	tjabo	a
čabu	tjabo	a
čadnivaš	tjaddnevasj	a
čaimmahahtti	tjajmahahtte	a
čakča#seavdnjat	tjaktja#sievnnjat	a
čakčasaš	tjaktjasasj	a
čalas	tjalás	a
čalbmet#beal	tjalmmet#biel	a
čalbmái#čuohcci	tjalmmáj#tjuohttse	a
čalgatmeahttun	tjalggatmeahttun	a
čalmmiheapme	tjalmeheapme	a
čalmmus	tjalmus	a
čargálaš	tjarggálasj	a
čatnasmeahttun	tjadnasmeahttun	a
čađa#čuovgameahttun	tjada#tjuovggameahttun	a
čađa#čuovgi	tjada#tjuovgge	a
čeahkit	tjiehket	a
čeahpálas	tjæhpálas	a
čeaktu	tjiekto	a
čearddalaš	tjierdalasj	a
čearggus	tjiergus	a
čeaskat	tjiesskat	a
čemihkalaš	tjemehkalasj	a
čibmái	tjibbmáj	a
čidnái	tjiddnáj	a
čiegus	tjiegus	a
čiehkaraddjái	tjiehkaraddjáj	a
čiekŋudeaddji	tjiegŋudeaddje	a
čielggasmeahttun	tjielgasmeahttun	a
čiergálas	tjierggálas	a
čierohahtti	tjieruhahtte	a
čierrus	tjierrus	a
čievrái	tjievrráj	a
čieŋal	tjieŋal	a
čikŋosaš	tjigŋusasj	a
čilgemeahttun	tjilggemeahttun	a
čilssas	tjilsas	a
čilvvas	tjilvas	a
čimaheapme	tjimáheapme	a
čivrra	tjivra	a
čoahkkat	tjoahkkat	a
čoaliheapme	tjoaleheapme	a
čoalttas	tjoaltas	a
čoarvviheapme	tjoarveheapme	a
čoasus	tjoasus	a
čoavdemeahttun	tjoavddemeahttun	a
čoavdimeahttun	tjoavddemeahttun	a
čoavjjiheapme	tjoavjeheapme	a
čogas	tjågås	a
čortnas	tjårnås	a
čoskái	tjåsskåj	a
čujolaš	tjujulasj	a
čuoddjil	tjuoddjel	a
čuohte#buddásaš	tjuohte#buddásasj	a
čuohte#geardásaš	tjuohte#gærddásasj	a
čuohte#ruvdnosaš	tjuohte#ruvnnusasj	a
čuoikái	tjuojkkáj	a
čuojaheapme	tjuojaheapme	a
čuojoheapme	tjuojuheapme	a
čuolmmaheapme	tjuolmaheapme	a
čuovggaheapme	tjuovgaheapme	a
čuovvovaš	tjuovvuvasj	a
čuođemat	tjuodemat	a
čuođi#geardásaš	tjuode#gærddásasj	a
čuođi#proseantasaš	tjuode#pråseantasasj	a
čuožžovaš	tjuodtjuvasj	a
čuvges#fiskat	tjuvgges#fisskat	a
čuvges#ruoksat	tjuvgges#ruoksat	a
čábba	tjábba	a
čádjidahtti	tjádjedahtte	a
čáhccái	tjáhttsáj	a
čáhce#doallalas	tjáhtse#doallalas	a
čáhce#jeahkki	tjáhtse#jiehkke	a
čáhce#vuoigatvuođalaš	tjáhtse#vuojggatvuodalasj	a
čáhci#jeahkki	tjáhtse#jiehkke	a
čáhkitmeahttun	tjáhketmeahttun	a
čáhkkil	tjáhkkel	a
čáhppes#vielgat	tjáhppes#vielggat	a
čáhppes-vielgat	tjáhppes-vielggat	a
čájiheaddji	tjájeheaddje	a
čálakeahtes	tjálákeahtes	a
čálalaš	tjálálasj	a
čálekeat	tjálekeat	a
čáppa#girjjálaš	tjáppa#girjálasj	a
čáppis	tjáppes	a
čártnas	tjárnas	a
čáskameahttun	tjásskameahttun	a
čáskil	tjásskel	a
čázas	tjátsás	a
čáze#vuloš	tjátse#vulusj	a
čáziheapme	tjátseheapme	a
šaddo#dieđalaš	sjaddo#diedalasj	a
šattoheapme	sjattuheapme	a
šattuheapme	sjattuheapme	a
šearrat	sjierrat	a
šearus	sjierus	a
šiehpun	sjiehpun	a
šiehttan#válddálaš	sjiehttan#váldálasj	a
šiehtun	sjiehtun	a
šiitemeahttun	sjijttemeahttun	a
šiitimeahttun	sjijttemeahttun	a
šleaiddos	sliejdus	a
šleaippas	sliejpas	a
šlimppas	slimpas	a
šlinccas	slintsas	a
šlinzzas	slintsas	a
šluppas	sluppas	a
šluŋkkas	sluŋkas	a
šláddjás	sláddjás	a
šlávas	slávás	a
šnjalččas	sjnjaltjas	a
šnjalžžas	sjnjaltjas	a
šnjarvvas	sjnjarvas	a
šnjuokkas	sjnjuokkas	a
šoavllas	sjoavlas	a
šoavvat	sjoavvat	a
šáigil	sjájggel	a
šáikkas	sjájkas	a
šállošahtti	sjállutjahtte	a
