                                   100%
0%>>>>>>>>>>>>>>>>>>>>>>>>>>>>>>>>	pp
alde	allde	pp
badjelii	badjelij	pp
badjelis	badjeles	pp
bálddas	báldas	pp
bealde	biellde	pp
beallái	bælláj	pp
dáfus	dáfus	pp
duohkai	duohkaj	pp
duohkin	duohken	pp
gaskan	gasskan	pp
hárrái	hárráj	pp
luhtte	luhtte	pp
lusa	lusa	pp
maŋis	maŋes	pp
maŋŋái	maŋŋáj	pp
mielde	miellde	pp
ovddas	åvdås	pp
ovdii	åvddij	pp
sisa	sisa	pp
siste	sisste	pp
vuolde	vuollde	pp
vuollai	vuollaj	pp
