CE-merket	CE-merkket	v
a^krediteret	a^kredeteret	v
a^spireret	a^spireret	v
a^stringeret	a^stringeret	v
abmet	abbmet	v
abbrevi^eret	abbreve^eret	v
ac^klimatiseret	ac^klimátiseret	v
ad^stringeret	ad^stringeret	v
addit	addet	v
administreret	admenistreret	v
adresseret	adresseret	v
adopteret	adupteret	v
ađahuhttit	adáhuhttet	v
ahccohaddat	ahttsuhaddat	v
ahccohallat	ahttsuhallat	v
ahccát	ahttsát	v
ahttohallat	ahttuhallat	v
aiddostahttit	ajdustahttet	v
aiget	ajgget	v
ak^klimatiseret	ak^klimátiseret	v
aksentu^eret	aksentu^eret	v
aktiveret	akteveret	v
aktu^aliseret	akto^aleseret	v
aktu^eret	akto^eret	v
ali^eneret	ale^eneret	v
alli^eret	alle^eret	v
allut	allut	v
albmanahttit	almmanahttet	v
albmot#válljet	almmut#válljet	v
almmostahttit	almustahttet	v
almmustahttit	almustahttet	v
almmustuhttit	almustuhttet	v
alvvahuhttit	alvahuhttet	v
alarmeret	alármeret	v
amastit	amástet	v
anihahttit	anehahttet	v
anglifi^eret	anglefe^eret	v
analyseret	anályseret	v
ap^plikeret	ap^plikeret	v
ap^pliseret	ap^pliseret	v
ap^pliceret	ap^plitseret	v
ap^preteret	ap^preteret	v
ap^proberet	ap^pråberet	v
ap^propri^eret	ap^pråpre^eret	v
apo^stroferet	apo^stråferet	v
appelleret	appelleret	v
aresteret	aresteret	v
arestet	arestet	v
argumenteret	arggumenteret	v
arka^iseret	arkka^iseret	v
arresteret	arresteret	v
arvvahuhttit	arvahuhttet	v
arvvuhuhttit	arvuhuhttet	v
arvvosmahttit	arvusmahttet	v
arvvosmuhttit	arvusmuhttet	v
arvit	arvvet	v
arvohit	arvvuhet	v
arvát	arvvát	v
asehuhttit	asehuhttet	v
asehuššat	asehussjat	v
astat	asstat	v
assudit	assudet	v
assosi^eret	assuse^eret	v
assut	assut	v
associ^eret	assutse^eret	v
at^traheret	at^traheret	v
atrofi^eret	atrufe^eret	v
atta^cheret	atta^cheret	v
accentu^eret	attsentu^eret	v
auk^tioneret	auk^tioneret	v
auto#klaveret	auto#klaveret	v
automatiseret	autumatiseret	v
autoriseret	auturiseret	v
avvit	avvet	v
avastit	avástet	v
badjel#duolbmat	badjel#duolmmat	v
badjel#geahččat	badjel#giehttjat	v
badjel#árvvoštallat	badjel#árvusjtallat	v
batnit	badnet	v
bagget	bagget	v
baggát	baggát	v
bagohit	baguhet	v
bahkkehit	bahkkehet	v
bahkkestit	bahkkestet	v
bahkket	bahkket	v
bahtasuhttit	bahtasuhttet	v
bahčagahttit	bahtjagahttet	v
bahčit	bahtjet	v
bahččut	bahttjut	v
bajidit	bajedet	v
baikkahaddat	bajkahaddat	v
baikkahallat	bajkahallat	v
baikkestuvvat	bajkestuvvat	v
baikit	bajkket	v
bajás#boktit	bajás#båktet	v
bajás#doallat	bajás#doallat	v
bajás#geassit	bajás#giesset	v
bajás#hukset	bajás#hukset	v
bajás#šaddadit	bajás#sjaddadet	v
bajás#čuoččáldahttit	bajás#tjuottjáldahttet	v
bajás#čuvget	bajás#tjuvgget	v
balkkidit	balkedet	v
baldit	balldet	v
ballát	ballát	v
balvet	balvvet	v
balanseret	balánseret	v
bardit	barddet	v
barddestit	bardestet	v
barfát	barffát	v
barggastuvvat	bargastuvvat	v
barjidit	barjjedet	v
bassin#dahkat	bassen#dahkat	v
bassit	basset	v
baskut	basskut	v
basttastit	bastastet	v
basttehuhttit	bastehuhttet	v
basttestuvvat	bastestuvvat	v
basttohuhttit	bastuhuhttet	v
basttálmuhttit	bastálmuhttet	v
basttálnuhttit	bastálnuhttet	v
bažirdit	batjerdet	v
bažistit	batjestet	v
behtohallat	behtuhallat	v
beiset	bejsset	v
beivet	bejvvet	v
belket	belkket	v
beldet	belldet	v
bentet	benttet	v
berehit	berehet	v
berret	berret	v
beroštuvvat	berusjtuvvat	v
beškket	besjket	v
besset	besset	v
bestet	besstet	v
biđđit	biddet	v
biddut	biddut	v
bidjat	bidjat	v
bitnjut	bidnjut	v
biđuhit	biduhet	v
biđáhallat	bidáhallat	v
biepmahallat	biebmahallat	v
bieđaldahttit	biedaldahttet	v
beađđat	bieddat	v
beafihit	biefehet	v
bieggat	bieggat	v
bieguhit	bieguhet	v
biehtadit	biehtadet	v
beahtahaddat	biehtahaddat	v
beahtahallat	biehtahallat	v
beahttit	biehttet	v
beaitit	biejttet	v
biekkahallat	biekkahallat	v
bealaštit	bielasjtet	v
bealistit	bielestet	v
bealjehuhttit	bieljjehuhttet	v
bealkkahaddat	bielkahaddat	v
bealkkahallat	bielkahallat	v
bealkit	bielkket	v
beallidit	bielledet	v
bealljadit	bielljadet	v
beallje#merket	biellje#merkket	v
bierfát	bierffát	v
bieđgát	bierggát	v
biertnástit	biernástet	v
bearrat	bierrat	v
beaskidahttit	biesskedahttet	v
beastit	biesstet	v
biestit	biesstet	v
bievssastit	bievsastet	v
biggehaddat	biggehaddat	v
biggehallat	biggehallat	v
bigget	bigget	v
biggohallat	bigguhallat	v
biggohit	bigguhet	v
bigohaddat	biguhaddat	v
bigohallat	biguhallat	v
bihkkadit	bihkkadet	v
bihčut	bihtjut	v
bihcudit	bihtsudet	v
bihcut	bihtsut	v
biigostit	bijggustet	v
biigot	bijggut	v
biippet	bijpet	v
biipet	bijppet	v
bijahaddat	bijáhaddat	v
bijahallat	bijáhallat	v
bijahit	bijáhet	v
bijastit	bijástet	v
bikšut	biksjut	v
bikšát	biksját	v
biktit	biktet	v
bilbut	bilbbut	v
bilget	bilgget	v
bilgádit	bilggádet	v
bilket	bilkket	v
bildadit	billdadet	v
billidit	billedet	v
binnudit	binnudet	v
binnut	binnut	v
birgehit	birggehet	v
biđgehit	birggehet	v
biđgestit	birggestet	v
birgestuvvat	birggestuvvat	v
birget	birgget	v
biđget	birgget	v
biđggiidahttit	birgijdahttet	v
birpát	birppát	v
birra#čuohppat	birra#tjuohppat	v
birccostit	birtsustet	v
bircut	birttsut	v
birastahttit	birástahttet	v
biškkuhit	bisjkuhet	v
bissehit	bissehet	v
biškut	bissjkut	v
bissostit	bissustet	v
bissut	bissut	v
bissáráhttit	bissáráhttet	v
bivdit	bivddet	v
bivvát	bivvát	v
bivastuhttit	bivástuhttet	v
bláđet	bládet	v
boađihahttit	boadehahttet	v
boazzuhuhttit	boadtsuhuhttet	v
boaggut	boaggut	v
boagustahttit	boagustahttet	v
boahkkudit	boahkkudet	v
boaimmastit	boajmastet	v
boaibmut	boajmmut	v
boaimmuhit	boajmuhet	v
boaimmostit	boajmustet	v
boakkastit	boakkastet	v
boalbbastit	boalbastet	v
boalbat	boalbbat	v
boalbut	boalbbut	v
boalddáldahttit	boaldáldahttet	v
boalggahit	boalgahet	v
boalggahuhttit	boalgahuhttet	v
boaldit	boalldet	v
boarskudit	boarsskudet	v
boatkkalduhttit	boatkkalduhttet	v
boatkut	boatkut	v
boaccastit	boattsastet	v
buddet	buddet	v
buzzet	budtset	v
buzzut	budtsut	v
buđohallat	buduhallat	v
buggát	buggát	v
buhtadit	buhtadet	v
buhtistit	buhtestet	v
buhčat	buhtjat	v
buhttet	buhttet	v
buiját	bujját	v
buitit	bujttet	v
buicát	bujttsát	v
buktit	buktet	v
buljadahttit	buljjadahttet	v
buljardahttit	buljjardahttet	v
buldut	bulldut	v
bullehit	bullehet	v
bulljut	bulljut	v
bullját	bullját	v
bultet	bulltet	v
bulžudit	bulltjudet	v
bulžut	bulltjut	v
bullát	bullát	v
bulčat	bulttjat	v
bulcát	bulttsát	v
bumbet	bumbbet	v
bumpet	bumppet	v
bunset	bunsset	v
bunccastit	buntsastet	v
buntet	bunttet	v
bunžáhit	bunttjáhet	v
buncut	bunttsut	v
buođđudit	buoddudet	v
buođđut	buoddut	v
buotnjut	buodnjut	v
buozzat	buodtsat	v
buozzut	buodtsut	v
buohtastahttit	buohtastahttet	v
buohtastuvvat	buohtastuvvat	v
buohccin#dieđihit	buohttsen#diedehet	v
buohccáhit	buohttsáhet	v
buohccát	buohttsát	v
buoimmastit	buojmastet	v
buoibmat	buojmmat	v
buokčalahttit	buoktjalahttet	v
buolehuhttit	buolehuhttet	v
buollát	buollát	v
buolvvastit	buolvastet	v
buoradahttit	buoradahttet	v
buorahit	buorahet	v
buoridahttit	buoredahttet	v
buođgát	buorggát	v
buorren#dohkkehit	buorren#dåhkkehet	v
buorrin#dohkkehit	buorren#dåhkkehet	v
buorrestit	buorrestet	v
buoruštit	buorusjtet	v
buorádahttit	buorádahttet	v
buorástahttit	buorástahttet	v
buovttahit	buovtahet	v
buovččaldahttit	buovtjaldahttet	v
buovvat	buovvat	v
bures#sivdnidit	bures#sivnnedet	v
burggihit	burgehet	v
burgit	burgget	v
bušehteret	busjehteret	v
bušeteret	busjeteret	v
busset	busset	v
buštit	bussjtet	v
busket	bussket	v
bužistit	butjestet	v
buvgadit	buvggadet	v
byrå^kratiseret	byrå^krateseret	v
báddet	báddet	v
báđđit	báddet	v
bátnádit	bádnádet	v
bágirdit	bágerdet	v
bággehaddat	bággehaddat	v
bággehallat	bággehallat	v
bágget	bágget	v
bággo#lotnut	bággo#lådnut	v
bággo#lonistit	bággo#lånestet	v
báhkket	báhkket	v
báhkkot	báhkkut	v
báhraidahttit	báhrajdahttet	v
báhtarahttit	báhtarahttet	v
báhčit	báhtjet	v
báikut	bájkkut	v
báibmat	bájmmat	v
báinnahaddat	bájnahaddat	v
báinnahallat	bájnahallat	v
báidnit	bájnnet	v
báisadit	bájssadet	v
báistit	bájsstet	v
báitohit	bájttuhet	v
bájuhit	bájuhet	v
bájadit	bájádet	v
bákkuhit	bákkuhet	v
bálddastahttit	báldastahttet	v
bálkestahttit	bálkkestahttet	v
bálkestit	bálkkestet	v
bálkut	bálkkut	v
bállet	bállet	v
báltudit	bálltudet	v
báltut	bálltut	v
bálvvuštit	bálvusjtet	v
bántet	bánttet	v
bánžadit	bánttjadet	v
bánžát	bánttját	v
bárdit	bárddet	v
bárgut	bárggut	v
bárket	bárkket	v
básset	básset	v
bážihahttit	bátjehahttet	v
bážihit	bátjehet	v
bážestit	bátjestet	v
bážistit	bátjestet	v
bážáhaddat	bátjáhaddat	v
bážáhallat	bátjáhallat	v
bázestuvvat	bátsestuvvat	v
bávdnat	bávnnat	v
bávččagahttit	bávtjagahttet	v
báŋahit	báŋáhet	v
bođđet	båddet	v
bodnját	båddnjåt	v
botnit	bådnet	v
bođaštit	bådåsjtet	v
boggát	båggåt	v
bogahit	bågåhet	v
bohkit	båhket	v
bohkket	båhkket	v
bohkkut	båhkkut	v
bohkastit	båhkåstet	v
bohkat	båhkåt	v
bohruhit	båhruhet	v
bohraidahttit	båhråjdahttet	v
bohciidahttit	båhtsijdahttet	v
bohttehit	båhttehet	v
boikohttet	båjkkuhttet	v
bokset	båkset	v
boktit	båktet	v
bolfát	bålffåt	v
bolget	bålgget	v
boltut	bålltut	v
bollát	bållåt	v
bolohastit	båluhastet	v
bombet	båmbbet	v
bommehit	båmmehet	v
bonjahallat	bånjåhallat	v
bonset	bånsset	v
bontet	bånttet	v
bordit	bårddet	v
boret	båret	v
borget	bårgget	v
borgohallat	bårgguhallat	v
borgohit	bårgguhet	v
borgat	bårggåt	v
borgát	bårggåt	v
borggahaddat	bårgåhaddat	v
borggahallat	bårgåhallat	v
borggahit	bårgåhet	v
borggastit	bårgåstet	v
borjjastahttit	bårjåstahttet	v
borrohaddat	bårruhaddat	v
borrohallat	bårruhallat	v
borralahttit	bårrålahttet	v
borrat	bårråt	v
boršet	bårssjet	v
boršut	bårssjut	v
boršalahttit	bårssjålahttet	v
borvet	bårvvet	v
borastahttit	båråstahttet	v
bosket	båssket	v
bostit	båsstet	v
bostet	båsstet	v
bostohaddat	båsstuhaddat	v
bostohallat	båsstuhallat	v
bossut	båssut	v
bossalahttit	båssålahttet	v
bosttahallat	båståhallat	v
bosttahit	båståhet	v
botkehit	båtkehet	v
botkestit	båtkestet	v
botket	båtket	v
botrehttet	båtrehttet	v
bovdestit	båvddestet	v
bovdet	båvddet	v
bovrret	båvret	v
bovret	båvrret	v
bovttáhallat	båvtåhallat	v
bealkáhit	bælkkáhet	v
bearrái#geahččat	bærráj#giehttjat	v
bearrái#gohcit	bærráj#gåhtset	v
beavttálmahttit	bævtálmahttet	v
dadnet	daddnet	v
dađis#dulkot	dades#dulkkut	v
dagaldahttit	dagáldahttet	v
darfet	darffet	v
dašket	dassjket	v
dateret	dateret	v
davkat	davkkat	v
davrat	davrrat	v
davrát	davrrát	v
de^chiffreret	de^chiffreret	v
de^flateret	de^flateret	v
de^floreret	de^flåreret	v
de^graderet	de^graderet	v
de^klameret	de^klameret	v
de^klareret	de^klareret	v
de^klasseret	de^klasseret	v
de^klineret	de^klineret	v
de^o^xideret	de^o^xideret	v
de^praveret	de^praveret	v
de^primeret	de^primeret	v
de^privatiseret	de^privátiseret	v
de^stru^eret	de^stru^eret	v
de^oksideret	de^åksederet	v
deddohaddat	dedduhaddat	v
deddohallat	dedduhallat	v
defineret	defeneret	v
dekstet	dekstet	v
dele^graferet	dele^graferet	v
delegeret	delegeret	v
dellet	dellet	v
deltet	delltet	v
delabi^aliseret	delábe^aleseret	v
demo^kratiseret	demo^krateseret	v
demonstreret	demunstreret	v
dena^tionaliseret	dena^tionaliseret	v
denet	denet	v
dennet	dennet	v
dennjet	dennjet	v
dentet	denttet	v
depset	depset	v
des^armeret	des^armeret	v
des^illu^sjoneret	des^illo^sjåneret	v
des^illu^tioneret	des^illo^tioneret	v
des^illušoneret	des^illutjoneret	v
des^infiseret	des^infeseret	v
des^inficeret	des^infetseret	v
des^informeret	des^infurmeret	v
des^inte^greret	des^intte^greret	v
des^oksideret	des^åksederet	v
des^organiseret	des^årggåniseret	v
des^orienteret	des^årienteret	v
des^oxideret	des^åxederet	v
deskonderet	desskunderet	v
destamentet	desstamentet	v
destilleret	desstelleret	v
destet	desstet	v
desavu^eret	desávu^eret	v
detalj^stivret	detálj^stivrret	v
detaljeret	detáljeret	v
devdohaddat	devdduhaddat	v
devdohallat	devdduhallat	v
devi^eret	deve^eret	v
devkkodahttit	devkudahttet	v
devdnet	devnnet	v
devččohaddat	devtjuhaddat	v
devččohallat	devtjuhallat	v
devalu^eret	deválu^eret	v
di^a^gnostiseret	di^a^gnåssteseret	v
di^alyseret	di^alyseret	v
dibmet	dibbmet	v
diđoštit	didusjtet	v
deaddilahttit	dieddelahttet	v
deaddit	dieddet	v
deatnut	diednut	v
dietnut	diednut	v
dieđuštit	diedusjtet	v
diehppat	diehppat	v
dieigát	diejggát	v
deaivvahaddat	diejvahaddat	v
deaivvahallat	diejvahallat	v
deaivat	diejvvat	v
deakčut	diektjut	v
dielladit	dielladet	v
deallardit	diellardet	v
deallut	diellut	v
deamppuhit	diempuhet	v
dearppastit	dierpastet	v
dearpat	dierppat	v
dearvvahit	diervahet	v
dearvvašmahttit	diervasjmahttet	v
dearvvašnuhttit	diervasjnuhttet	v
dearvvasmahttit	diervasmahttet	v
deađvut	diervvut	v
deaškkastit	diesjkastet	v
dieskkardit	dieskardet	v
deaškut	diessjkut	v
deattastit	diettastet	v
deattuhit	diettuhet	v
dievasmahttit	dievasmahttet	v
deavdit	dievddet	v
deavččastit	dievtjastet	v
deaŋggaštit	dieŋgasjtet	v
differansi^eret	differanse^eret	v
differensi^eret	differense^eret	v
differenti^eret	differente^eret	v
digget	digget	v
diggot	diggut	v
dihkkadit	dihkkadet	v
dihkket	dihkket	v
dihkkádit	dihkkádet	v
dihppet	dihppet	v
dihtoštit	dihtusjtet	v
diidet	dijddet	v
dikšut	diksjut	v
dikteret	dikteret	v
diktit	diktet	v
diktet	diktet	v
dilket	dilkket	v
dillet	dillet	v
dilvet	dilvvet	v
diládit	diládet	v
dilát	dilát	v
dimen^tioneret	dimen^tioneret	v
dimádahttit	dimádahttet	v
dinet	dinet	v
dinodit	dinudet	v
dirigeret	diregeret	v
dis^ambigu^eret	dis^ambbegu^eret	v
dis^krediteret	dis^kredeteret	v
dis^kvalifiseret	dis^kvalefiseret	v
dis^kvalificeret	dis^kvalefitseret	v
dis^traheret	dis^traheret	v
diškkastit	disjkastet	v
diškkohaddat	disjkuhaddat	v
diškkohallat	disjkuhallat	v
dišket	dissjket	v
diškut	dissjkut	v
dissosi^eret	dissuse^eret	v
dissoci^eret	dissutse^eret	v
distribu^eret	distrebu^eret	v
divret	divrret	v
divrut	divrrut	v
divššuhit	divsjuhet	v
divsket	divssket	v
divskut	divsskut	v
divvut	divvut	v
diŋgot	diŋggut	v
doapmalahttit	doabmalahttet	v
doadjalahttit	doadjalahttet	v
doažžudit	doadtjudet	v
doahkkudit	doahkkudet	v
doahput	doahput	v
doajihit	doajehet	v
doajestit	doajestet	v
doaimmashehttet	doajmashehttet	v
doaivut	doajvvut	v
doallat	doallat	v
doalvut	doalvvut	v
doarggistahttit	doargestahttet	v
doarggistuhttit	doargestuhttet	v
doarggáhallat	doargáhallat	v
doarjut	doarjjut	v
doardnát	doarnnát	v
doarrut	doarrut	v
doarrát	doarrát	v
doarostuvvat	doarustuvvat	v
doaškut	doassjkut	v
doaŋgudit	doaŋggudet	v
drámatiseret	drámátiseret	v
du^elleret	du^elleret	v
du^pliseret	du^pliseret	v
du^pliceret	du^plitseret	v
dubbet	dubbet	v
dubmehaddat	dubbmehaddat	v
dubmehallat	dubbmehallat	v
dubmet	dubbmet	v
duđđat	duddat	v
duddet	duddet	v
duddjet	duddjet	v
duddjot	duddjut	v
duđđut	duddut	v
dudjohit	dudjuhet	v
duhaštit	duhasjtet	v
duhkkat	duhkkat	v
duhkuštit	duhkusjtet	v
duhppestit	duhppestet	v
duhppet	duhppet	v
duhrahit	duhrahet	v
duhastit	duhástet	v
duihmudit	dujhmmudet	v
duihmut	dujhmmut	v
duikudit	dujkkudet	v
duippidit	dujpedet	v
duipet	dujppet	v
duivvidit	dujvedet	v
duivet	dujvvet	v
dukset	dukset	v
duktet	duktet	v
dulbestit	dulbbestet	v
dulbet	dulbbet	v
dulket	dulkket	v
dulkot	dulkkut	v
duldestahttit	dulldestahttet	v
duldet	dulldet	v
dullehallat	dullehallat	v
dullet	dullet	v
dulljet	dulljet	v
dullát	dullát	v
dulmmohaddat	dulmuhaddat	v
dulmmohallat	dulmuhallat	v
dulpet	dulppet	v
dulvadit	dulvvadet	v
dumpet	dumppet	v
dunet	dunet	v
duobahaddat	duobahaddat	v
duobahallat	duobahallat	v
duobus#sillet	duobus#sillet	v
duođaštit	duodasjtet	v
duoddudit	duoddudet	v
duodjidit	duodjedet	v
duoguštit	duogusjtet	v
duohpat	duohpat	v
duohtan#dahkat	duohtan#dahkat	v
duohččat	duohttjat	v
duohoštit	duohusjtet	v
duoittardit	duojtardet	v
duolbbasin#jorahit	duolbasin#jåråhet	v
duolbát	duolbbát	v
duolgut	duolggut	v
duolmmahaddat	duolmahaddat	v
duolmmahallat	duolmahallat	v
duolmmahit	duolmahet	v
duolbmat	duolmmat	v
duolbmut	duolmmut	v
duolmmostuvvat	duolmustuvvat	v
duolvadit	duolvvadet	v
duorbut	duorbbut	v
duorggastit	duorgastet	v
duoršát	duorssját	v
duostut	duosstut	v
duosttastuvvat	duostastuvvat	v
duottostuvvat	duottustuvvat	v
duovgudit	duovggudet	v
duovlut	duovllut	v
durbet	durbbet	v
durdudit	durddudet	v
durdut	durddut	v
durdát	durddát	v
durddidit	durdedet	v
durget	durgget	v
durskkuhit	durskuhet	v
durahit	duráhet	v
dušát	dusját	v
dusset	dusset	v
duššadit	dussjadet	v
duššin#dahkat	dussjen#dahkat	v
dušket	dussjket	v
duššástuhttit	dussjástuhttet	v
dustet	dusstet	v
dusttohaddat	dustuhaddat	v
dusttohallat	dustuhallat	v
dutkat	dutkat	v
duvdit	duvddet	v
duvhllidit	duvhledet	v
duvllohaddat	duvluhaddat	v
duvllohallat	duvluhallat	v
duvret	duvrret	v
dápmalahttit	dábmalahttet	v
dábuhit	dábuhet	v
dáddjet	dáddjet	v
dáđđudit	dáddudet	v
dáđđut	dáddut	v
dádjut	dádjut	v
dátnjat	dádnjat	v
dággudit	dággudet	v
dággut	dággut	v
dáhkadit	dáhkadet	v
dáhkut	dáhkut	v
dáhpehallat	dáhpehallat	v
dáhpet	dáhpet	v
dáhppohallat	dáhppuhallat	v
dáhppot	dáhpput	v
dáhttut	dáhttut	v
dáhtostuvvat	dáhtustuvvat	v
dáibat	dájbbat	v
dáidit	dájddet	v
dáigudit	dájggudet	v
dáigut	dájggut	v
dáidnádit	dájnnádet	v
dáisut	dájssut	v
dájuhit	dájuhet	v
dálkat	dálkkat	v
dálkut	dálkkut	v
dálkkodahttit	dálkudahttet	v
dállastit	dállastet	v
dáldut	dálldut	v
dállet	dállet	v
dálset	dálsset	v
dálvat	dálvvat	v
dálve#biebmat	dálvve#biebbmat	v
dáláštit	dálásjtet	v
dámpet	dámppet	v
dánirdit	dánerdet	v
dánjahaddat	dánjáhaddat	v
dánjahallat	dánjáhallat	v
dánsestit	dánssestet	v
dánset	dánsset	v
dánsut	dánssut	v
dánccastit	dántsastet	v
dáncat	dánttsat	v
dárjudit	dárjjudet	v
dárjut	dárjjut	v
dárkkistahttit	dárkestahttet	v
dárkostit	dárkkustet	v
dárkot	dárkkut	v
dárkkohit	dárkuhet	v
dárkkálmuhttit	dárkálmuhttet	v
dárkkálnuhttit	dárkálnuhttet	v
dárpmehuhttit	dármehuhttet	v
dárpmohuhttit	dármuhuhttet	v
dáruidahttit	dárujdahttet	v
dáruiduhttit	dárujduhttet	v
dásset	dásset	v
dášket	dássjket	v
dáteret	dáteret	v
dávistit	dávestet	v
dávggastit	dávgastet	v
dávgut	dávggut	v
dávjjidit	dávjedet	v
dávjudit	dávjjudet	v
dávjut	dávjjut	v
dávlet	dávllet	v
dávlut	dávllut	v
dávrut	dávrrut	v
dávžat	dávttjat	v
dávžut	dávttjut	v
dáŋket	dáŋkket	v
doabastit	dåbastet	v
doabat	dåbat	v
dobbut	dåbbut	v
doddjohit	dåddjuhet	v
dohkkestuvvat	dåhkkestuvvat	v
dohkket	dåhkket	v
dohppehaddat	dåhppehaddat	v
dohppehallat	dåhppehallat	v
dohppehit	dåhppehet	v
dohppestit	dåhppestet	v
dohppet	dåhppet	v
doidit	dåjddet	v
doibmet	dåjmmet	v
dolget	dålgget	v
dolkadit	dålkkådet	v
doldet	dålldet	v
doldudit	dålldudet	v
doldut	dålldut	v
dollet	dållet	v
domisili^eret	dåmesile^eret	v
dorjestit	dårjjestet	v
dorjet	dårjjet	v
dorbmut	dårmmut	v
dorrehit	dårrehet	v
dorohaddat	dåruhaddat	v
dorohallat	dåruhallat	v
dorostahttit	dårustahttet	v
dorvvastit	dårvåstet	v
doškkohaddat	dåsjkuhaddat	v
doškkohallat	dåsjkuhallat	v
doškestit	dåssjkestet	v
došket	dåssjket	v
dosmut	dåssmut	v
dovdat	dåvddåt	v
dovdát	dåvddåt	v
dovddiidahttit	dåvdijdahttet	v
dovdnjet	dåvnnjet	v
dearšát	dærssját	v
deaškát	dæssjkát	v
deattáldahttit	dættáldahttet	v
ednet	eddnet	v
effektu^eret	effektu^eret	v
ehket	ehket	v
ehtet	ehtet	v
einnostit	ejnustet	v
eks^klameret	eks^klameret	v
eks^kluderet	eks^kluderet	v
eks^plisitteret	eks^plisetteret	v
eks^plo^ateret	eks^plo^ateret	v
eks^ploderet	eks^plåderet	v
eks^propri^eret	eks^pråpre^eret	v
eks^traheret	eks^traheret	v
ekspatri^eret	ekspatre^eret	v
ekstra#poleret	ekstra#påleret	v
elektrifi^eret	elektrife^eret	v
elimineret	elemineret	v
elljet	elljet	v
ellohit	elluhet	v
ellot	ellut	v
emi^greret	eme^greret	v
emplo^yeret	emplo^yeret	v
emuleret	emuleret	v
ennostit	ennustet	v
envegs#reguleret	envvegs#reguleret	v
enveis#reguleret	envvejs#reguleret	v
eret#bidjat	eret#bidjat	v
eret#guođđit	eret#guoddet	v
eret#cealkkihahttit	eret#tsielkehahttet	v
erret	erret	v
etter#isoleret	etter#isuleret	v
etter#synkroniseret	etter#synkruniseret	v
etymologiseret	etymologiseret	v
europe^iseret	eurupe^iseret	v
evttohit	evtuhet	v
evaku^eret	eváku^eret	v
evalu^eret	eválu^eret	v
ex^klameret	ex^klameret	v
ex^kluderet	ex^kluderet	v
ex^pliciteret	ex^plitseteret	v
ex^plo^ateret	ex^plo^ateret	v
ex^ploderet	ex^plåderet	v
ex^propri^eret	ex^pråpre^eret	v
ex^traheret	ex^traheret	v
exemplifi^eret	exemplife^eret	v
expatri^eret	expatre^eret	v
extra#poleret	extra#påleret	v
fa^scineret	fa^scineret	v
fadnát	faddnát	v
fađđut	faddut	v
fatnalahttit	fadnalahttet	v
fađustit	fadustet	v
fađastit	fadástet	v
faggut	faggut	v
fagŋát	faggŋát	v
fakŋalahttit	fagŋalahttet	v
fakŋut	fagŋut	v
fakkastit	fakkastet	v
fallehit	fallehet	v
fallet	fallet	v
fallut	fallut	v
falsifi^eret	falssefe^eret	v
fanaldahttit	fanáldahttet	v
farvellet	farvvellet	v
faskkastit	faskastet	v
faskkestit	faskestet	v
fasket	fassket	v
faskut	fasskut	v
fastut	fasstut	v
fastát	fasstát	v
favoriseret	favuriseret	v
faŋket	faŋkket	v
faŋkát	faŋkkát	v
faŋaldahttit	faŋáldahttet	v
feijet	fejjet	v
feil#vurderet	fejl#vurdderet	v
feilet	fejlet	v
feillet	fejllet	v
fembi^eret	fembbe^eret	v
feri^eret	fere^eret	v
feret	feret	v
ferget	fergget	v
ferdnet	fernnet	v
festet	fesstet	v
fidnehit	fiddnehet	v
fidnestuvvat	fiddnestuvvat	v
fidnet	fiddnet	v
fieraldahttit	fieraldahttet	v
fierdit	fierddet	v
fiergat	fierggat	v
fearkkastit	fierkastet	v
fearkut	fierkkut	v
fierbmut	fiermmut	v
fierpmástit	fiermástet	v
fearrat	fierrat	v
fierrut	fierrut	v
feastit	fiesstet	v
fievrát	fievrrát	v
fihttet	fihttet	v
fiilet	fijlet	v
fiillet	fijllet	v
fiidnet	fijnnet	v
fiidnut	fijnnut	v
fikkahit	fikkahet	v
fikset	fikset	v
fillehaddat	fillehaddat	v
fillehallat	fillehallat	v
fillestit	fillestet	v
fillet	fillet	v
filtet	filltet	v
filbmet	filmmet	v
filosoferet	filusoferet	v
filé^astit	filé^asstet	v
fintet	finttet	v
finansi^eret	finánse^eret	v
firrestit	firrestet	v
firret	firret	v
firrohit	firruhet	v
firtet	firttet	v
fiskkodahttit	fiskudahttet	v
fisket	fissket	v
fiskát	fisskát	v
fispet	fisspet	v
fiŋgut	fiŋggut	v
fluktu^eret	flukto^eret	v
fluore^sceret	fluore^sceret	v
flora#graferet	flårå#graferet	v
friddjan#dahkat	friddjan#dahkat	v
friddjet	friddjet	v
friddjot	friddjut	v
friijet	frijjet	v
fuđet	fudet	v
fuobmát	fuobbmát	v
fuopmášahttit	fuobmátjahttet	v
fuođardit	fuodardet	v
fuoikit	fuojkket	v
fuoikut	fuojkkut	v
fuolahit	fuolahet	v
fuolastuvvat	fuolastuvvat	v
fuollat	fuollat	v
fuomihit	fuomehet	v
fuomášahttit	fuomátjahttet	v
fuomášuhttit	fuomátjuhttet	v
fuonidit	fuonedet	v
fuorkut	fuorkkut	v
furket	furkket	v
fusket	fussket	v
fápmui#bidjat	fábmuj#bidjat	v
fáddet	fáddet	v
fádnet	fáddnet	v
fáđahit	fádáhet	v
fáhtehaddat	fáhtehaddat	v
fáhtehallat	fáhtehallat	v
fáhtit	fáhtet	v
fáhtet	fáhtet	v
fáiput	fájpput	v
fákset	fákset	v
fáktet	fáktet	v
fáktorastit	fákturastet	v
fálskehaddat	fálskehaddat	v
fálskehallat	fálskehallat	v
fálsket	fálsket	v
fálset	fálsset	v
fámohuhttit	fámuhuhttet	v
fámuhuhttit	fámuhuhttet	v
fárgehallat	fárggehallat	v
fárgehit	fárggehet	v
fárrehit	fárrehet	v
fárret	fárret	v
fáruhit	fáruhet	v
fárvellet	fárvvellet	v
fáškkastit	fásjkastet	v
fáskat	fásskat	v
fásttostit	fástustet	v
fátmmastit	fátmmastet	v
fátmut	fátmut	v
fávllidit	fávledet	v
fávledit	fávlledet	v
fáŋget	fáŋgget	v
foli^eret	fåle^eret	v
fonematiseret	fånematiseret	v
formaliseret	fårmåliseret	v
formateret	fårmåteret	v
fosfore^sceret	fåsfure^sceret	v
foto#kopi^eret	fåto#kåpe^eret	v
foto^graferet	fåto^graferet	v
gabahahttit	gabáhahttet	v
gadnet	gaddnet	v
gatnut	gadnut	v
gazzat	gadtsat	v
gazzut	gadtsut	v
gahkit	gahket	v
gahkkat	gahkkat	v
gahkkudit	gahkkudet	v
gahkkut	gahkkut	v
gahput	gahput	v
gahridit	gahredet	v
gahčat	gahtjat	v
gahcut	gahtsut	v
gaifát	gajffát	v
gaikut	gajkkut	v
gaikkáldahttit	gajkáldahttet	v
gaidnadit	gajnnadet	v
gaivát	gajvvát	v
gakcet	gaktset	v
gakcut	gaktsut	v
galbet	galbbet	v
galkadit	galkkadet	v
galledit	galledet	v
gallehit	gallehet	v
gallet	gallet	v
galljut	galljut	v
galmmastuhttit	galmastuhttet	v
galbmit	galmmet	v
galbmot	galmmut	v
galvaniseret	galvvaniseret	v
gantut	ganttut	v
gardit	garddet	v
garistit	garestet	v
garret	garret	v
garcestit	garttsestet	v
garcet	garttset	v
garcut	garttsut	v
garcát	garttsát	v
garuhit	garuhet	v
garvit	garvvet	v
gaskkalduhttit	gaskalduhttet	v
gaškát	gassjkát	v
gaskaluhttit	gasskaluhttet	v
gaskat#čuohppat	gasskat#tjuohppat	v
gaskit	gassket	v
gassuhit	gassuhet	v
gassut	gassut	v
gasttihit	gastehet	v
gazirdit	gatserdet	v
gaccirdit	gattserdet	v
gaccestit	gattsestet	v
gaccohaddat	gattsuhaddat	v
gaccohallat	gattsuhallat	v
gaccuhit	gattsuhet	v
gaccoldahttit	gattsuldahttet	v
gavdut	gavddut	v
gavihit	gavehet	v
gavistit	gavestet	v
gavjehit	gavjjehet	v
gavjet	gavjjet	v
gavjjuhit	gavjuhet	v
gavnnjastit	gavnjastet	v
gavdnjet	gavnnjet	v
gavret	gavrret	v
gavrát	gavrrát	v
gavvit	gavvet	v
gaŋgát	gaŋggát	v
gaŋkestit	gaŋkkestet	v
gaŋket	gaŋkket	v
gaŋkát	gaŋkkát	v
gednet	geddnet	v
geđđohit	gedduhet	v
gehlát	gehlát	v
gehmát	gehmát	v
geiget	gejgget	v
gekset	gekset	v
gelvet	gelvvet	v
generaliseret	generaliseret	v
gerget	gergget	v
geđget	gergget	v
gerjjodit	gerjudet	v
gerret	gerret	v
getkkoštit	getkkusjtet	v
gevhnut	gevhnut	v
gevlet	gevllet	v
gevrehallat	gevrrehallat	v
gevret	gevrret	v
giddet	giddet	v
gizzut	gidtsut	v
giebahuhttit	giebahuhttet	v
gieđaguššat	giedagussjat	v
geađđudit	gieddudet	v
geatnegahttit	giednegahttet	v
gieggat	gieggat	v
geahkat	giehkat	v
giehtaguššat	giehtagussjat	v
geahčastahttit	giehtjastahttet	v
geahčastit	giehtjastet	v
geahčestit	giehtjestet	v
geahcat	giehtsat	v
geahččat	giehttjat	v
geaiddahaddat	giejdahaddat	v
geaiddahallat	giejdahallat	v
geaidit	giejddet	v
geaidut	giejddut	v
gieimmastuvvat	giejmastuvvat	v
geaivut	giejvvut	v
giektat	giektat	v
giekcát	giektsát	v
gielbbardit	gielbardet	v
gielddahallat	gieldahallat	v
geallat	giellat	v
giellat	giellat	v
gealdit	gielldet	v
gieldit	gielldet	v
geandit	gienddet	v
gearahaddat	gierahaddat	v
gearahallat	gierahallat	v
gearahit	gierahet	v
gierddastuvvat	gierdastuvvat	v
geardut	gierddut	v
gearggastuvvat	giergastuvvat	v
gearjidit	gierjjedet	v
gierrat	gierrat	v
giervat	giervvat	v
geassit	giesset	v
gieškadit	giessjkadet	v
geassut	giessut	v
giessát	giessát	v
geažuhit	gietjuhet	v
gietkat	gietkat	v
geazadit	gietsadet	v
geavahit	gievahet	v
geavjadit	gievjjadet	v
gievrrasmahttit	gievrasmahttet	v
geavvadit	gievvadet	v
gievvudit	gievvudet	v
gigget	gigget	v
gihlidit	gihledet	v
gihppet	gihppet	v
gihppudit	gihppudet	v
gihttet	gihttet	v
giiket	gijkket	v
giibmut	gijmmut	v
giitit	gijttet	v
giivváskahttit	gijváskahttet	v
giksadit	giksadet	v
giktadit	giktadet	v
giktit	giktet	v
giktet	giktet	v
gikcut	giktsut	v
gilget	gilgget	v
gildát	gilldát	v
gillestuvvat	gillestuvvat	v
gillet	gillet	v
gilljut	gilljut	v
gillástit	gillástet	v
gillástuvvat	gillástuvvat	v
gillásuhttit	gillásuhttet	v
gillát	gillát	v
gilvvohaddat	gilvuhaddat	v
gilvvohallat	gilvuhallat	v
gilvvoldahttit	gilvuldahttet	v
gilvit	gilvvet	v
gimpet	gimppet	v
gimssordit	gimsurdet	v
gimastuvvat	gimástuvvat	v
ginccuhit	gintsuhet	v
ginccástahttit	gintsástahttet	v
gincut	ginttsut	v
ginuhit	ginuhet	v
ginustit	ginustet	v
girdodit	girddudet	v
girddáldahttit	girdáldahttet	v
girjet	girjjet	v
girjudit	girjjudet	v
girdnet	girnnet	v
girdnut	girnnut	v
gišket	gissjket	v
givdnjut	givnnjut	v
givrut	givrrut	v
givrát	givrrát	v
givttahit	givtahet	v
givžžastit	givtjastet	v
giŋgot	giŋggut	v
giŋggástahttit	giŋgástahttet	v
globaliseret	glåbåliseret	v
glorifi^eret	glårefe^eret	v
goapmárahttit	goabmárahttet	v
goadnát	goaddnát	v
goađđut	goaddut	v
goahcat	goahtsat	v
goaivut	goajvvut	v
goallostit	goallustet	v
goallát	goallát	v
goalvát	goalvvát	v
goalgŋat	goalŋŋat	v
goambaluššat	goambbalussjat	v
goanzát	goanttsát	v
goardit	goarddet	v
goargguhit	goarguhet	v
goarjidit	goarjjedet	v
goarját	goarjját	v
goarkat	goarkkat	v
goarkit	goarkket	v
goarpmohit	goarmuhet	v
goarpmuhit	goarmuhet	v
goarrut	goarrut	v
goartudit	goarttudet	v
goarvvastit	goarvastet	v
goastit	goasstet	v
goassudit	goassudet	v
goavddustuhttit	goavdustuhttet	v
goavrát	goavrrát	v
goaŋkát	goaŋkkát	v
gradu^eret	grado^eret	v
graveret	graveret	v
grávet	grávet	v
gudnejahttit	guddnejahttet	v
gudnet	guddnet	v
gudnijahttit	guddnijahttet	v
gutnehuhttit	gudnehuhttet	v
gužžat	gudtjat	v
gužžet	gudtjet	v
guđoldahttit	guduldahttet	v
gugget	gugget	v
guhkkut	guhkkut	v
guhppet	guhppet	v
guiget	gujgget	v
guisut	gujssut	v
guittidit	gujtedet	v
guitet	gujttet	v
guljet	guljjet	v
gulkat	gulkkat	v
gulladit	gulladet	v
gullet	gullet	v
gullát	gullát	v
gulpet	gulppet	v
gulcat	gulttsat	v
gulahallat	guláhallat	v
gummi^eret	gumme^eret	v
guobirdit	guoberdet	v
guopmat	guobmat	v
guođđelit	guoddelet	v
guoddit	guoddet	v
guođđit	guoddet	v
guođostahttit	guodustahttet	v
guođostuvvat	guodustuvvat	v
guođáhallat	guodáhallat	v
guoggát	guoggát	v
guohkastit	guohkastet	v
guohkkat	guohkkat	v
guohppudit	guohppudet	v
guohčat	guohtjat	v
guohčut	guohtjut	v
guohcagahttit	guohtsagahttet	v
guohcut	guohtsut	v
guohtut	guohtut	v
guoimmuhit	guojmuhet	v
guoiradit	guojradet	v
guolggidit	guolgedet	v
guolga#merket	guolgga#merkket	v
guoljastit	guoljjastet	v
guolljut	guolljut	v
guolmmastit	guolmastet	v
guorbadit	guorbbadet	v
guorbát	guorbbát	v
guorrat	guorrat	v
guosahit	guosahet	v
guossalahttit	guossalahttet	v
guostát	guosstát	v
guossut	guossut	v
guottestuvvat	guottestuvvat	v
guovdduštit	guovdusjtet	v
guovgát	guovggát	v
guovdnjudit	guovnnjudet	v
guovzat	guovttsat	v
guovttálduhttit	guovtálduhttet	v
gurdit	gurddet	v
gurehit	gurehet	v
gurgát	gurggát	v
guđjet	gurjjet	v
gurbmet	gurmmet	v
gurbmut	gurmmut	v
gurpmodit	gurmudet	v
gurpat	gurppat	v
gurpet	gurppet	v
gurput	gurpput	v
gurpát	gurppát	v
gurrestit	gurrestet	v
gurret	gurret	v
gurtet	gurttet	v
guržet	gurttjet	v
gurvut	gurvvut	v
gurastit	gurástet	v
guštestit	gussjtestet	v
guštet	gussjtet	v
gustet	gusstet	v
gustohit	gusstuhet	v
gustot	gusstut	v
guččahit	guttjahet	v
guččastahttit	guttjastahttet	v
guččastit	guttjastet	v
guččastuvvat	guttjastuvvat	v
guvdnjut	guvnnjut	v
guvdnut	guvnnut	v
guvrut	guvrrut	v
guvrát	guvrrát	v
guvzat	guvttsat	v
gáddit	gáddet	v
gáđđet	gáddet	v
gáddái#skihkidit	gáddáj#skihkedet	v
gádjat	gádjat	v
gádjut	gádjut	v
gážžut	gádtjut	v
gáfestuhttit	gáfestuhttet	v
gággat	gággat	v
gáhkket	gáhkket	v
gáhkut	gáhkut	v
gáhrostit	gáhrustet	v
gáhtardit	gáhtardet	v
gáhčaldahttit	gáhtjaldahttet	v
gáhttet	gáhttet	v
gáidádit	gájddádet	v
gáitut	gájttut	v
gáivvastit	gájvastet	v
gáivut	gájvvut	v
gákčat	gáktjat	v
gálket	gálkket	v
gálladit	gálladet	v
gáldet	gálldet	v
gállehit	gállehet	v
gállet	gállet	v
gálljut	gálljut	v
gáldnadit	gálnnadet	v
gálvát	gálvvát	v
gámput	gámpput	v
gámodahttit	gámudahttet	v
gánet	gánet	v
gárdut	gárddut	v
gárddohaddat	gárduhaddat	v
gárddohallat	gárduhallat	v
gárihuhttit	gárehuhttet	v
gárgehit	gárggehet	v
gárget	gárgget	v
gárgát	gárggát	v
gárggiidahttit	gárgijdahttet	v
gárbmudit	gármmudet	v
gárret	gárret	v
gárrudit	gárrudet	v
gárrut	gárrut	v
gársat	gárssat	v
gáržžohallat	gártjuhallat	v
gártadit	gárttadet	v
gártet	gárttet	v
gáržudit	gárttjudet	v
gáržut	gárttjut	v
gáđvat	gárvvat	v
gárvet	gárvvet	v
gárgŋát	gárŋŋát	v
gásidit	gásedet	v
gáskkahaddat	gáskahaddat	v
gáskkahallat	gáskahallat	v
gáskkáhallat	gáskáhallat	v
gásset	gásset	v
gáskit	gássket	v
gásttašahttit	gástatjahttet	v
gávkat	gávkkat	v
gávkát	gávkkát	v
gávlut	gávllut	v
gávnnahaddat	gávnahaddat	v
gávnnahallat	gávnahallat	v
gávnnastuvvat	gávnastuvvat	v
gávdnjut	gávnnjut	v
gávrut	gávrrut	v
gávrát	gávrrát	v
gávččastit	gávtjastet	v
gávuhit	gávuhet	v
gobmát	gåbbmåt	v
goddit	gåddet	v
goddet	gåddet	v
gođđit	gåddet	v
godnjet	gåddnjet	v
gožžet	gådtjet	v
gožžat	gådtjåt	v
gogŋet	gåggŋet	v
gohkket	gåhkket	v
gohpat	gåhpåt	v
gohčohaddat	gåhtjuhaddat	v
gohčohallat	gåhtjuhallat	v
gohcut	gåhtsut	v
gohttet	gåhttet	v
gohččodit	gåhttjudet	v
gohččut	gåhttjut	v
gohccát	gåhttsåt	v
goidadit	gåjddådet	v
goiget	gåjgget	v
goiket	gåjkket	v
goikkohallat	gåjkuhallat	v
goistet	gåjsstet	v
goivet	gåjvvet	v
goksit	gåkset	v
gokset	gåkset	v
goksat	gåksåt	v
gokčat	gåktjåt	v
golkehaddat	gålkkehaddat	v
golkehallat	gålkkehallat	v
golket	gålkket	v
goldit	gålldet	v
gollet	gållet	v
golludit	gålludet	v
goldnadit	gålnnådet	v
goluiduhttit	gålujduhttet	v
golvet	gålvvet	v
golastuvvat	gålåstuvvat	v
golgŋet	gålŋŋet	v
goret	gåret	v
gorket	gårkket	v
gorbmet	gårmmet	v
gorpmoldahttit	gårmuldahttet	v
gordne#ráidnet	gårnne#rájnnet	v
gordnet	gårnnet	v
gorret	gårret	v
gorrat	gårråt	v
gorkŋoldahttit	gårŋuldahttet	v
gorgŋehit	gårŋŋehet	v
gorgŋet	gårŋŋet	v
gozustit	gåtsustet	v
goččastahttit	gåttjåstahttet	v
goččastuvvat	gåttjåstuvvat	v
gottáhaddat	gåttåhaddat	v
gottáhallat	gåttåhallat	v
govdet	gåvddet	v
govdodit	gåvddudet	v
govdut	gåvddut	v
govdadit	gåvddådet	v
govket	gåvkket	v
govlut	gåvllut	v
govdnadit	gåvnnådet	v
govret	gåvrret	v
govset	gåvsset	v
govssahallat	gåvsåhallat	v
govssáhallat	gåvsåhallat	v
govvet	gåvvet	v
govvát	gåvvåt	v
goŋkehit	gåŋkkehet	v
geaigát	gæjggát	v
gearrát	gærrát	v
geavrát	gævrrát	v
hapmat	habmat	v
hapmudit	habmudet	v
hahpadit	hahpadet	v
haksit	hakset	v
harmoneret	harmuneret	v
harret	harret	v
harcet	harttset	v
harcut	harttsut	v
harcát	harttsát	v
havssahit	havsahet	v
havssihit	havsehet	v
havssestit	havsestet	v
haŋkkuhit	haŋkuhet	v
hedjonahttit	hedjunahttet	v
hehppet	hehppet	v
hehttet	hehttet	v
hehttut	hehttut	v
hehttot	hehttut	v
heikkahit	hejkahet	v
heidnet	hejnnet	v
heivet	hejvvet	v
hekto^graferet	hekto^graferet	v
hellehit	hellehet	v
helpet	helppet	v
hero^iseret	hero^iseret	v
hervet	hervvet	v
heŋget	heŋgget	v
heŋgostit	heŋggustet	v
hiddjidit	hiddjedet	v
hidjidit	hidjedet	v
hitnardit	hidnardet	v
hieđuhit	hieduhet	v
heađuštit	hiedusjtet	v
heahkastuhttit	hiehkastuhttet	v
hiehtat	hiehtat	v
heahtit	hiehtet	v
heaibbuhit	hiejbuhet	v
heailalahttit	hiejlalahttet	v
hieibmat	hiejmmat	v
heaittahallat	hiejtahallat	v
heaitit	hiejttet	v
heajudit	hiejudet	v
heajosmahttit	hiejusmahttet	v
heakkahuhttit	hiekkahuhttet	v
healbadit	hielbbadet	v
healssastit	hielsastet	v
healsut	hielssut	v
hierdit	hierddet	v
hearjidit	hierjjedet	v
hearcut	hierttsut	v
heavahit	hievahet	v
heaŋggaidahttit	hieŋgajdahttet	v
heaŋggastit	hieŋgastet	v
heaŋgut	hieŋggut	v
heaŋgguhit	hieŋguhet	v
hihttát	hihttát	v
hihtudit	hihtudet	v
hihtut	hihtut	v
hilbudit	hilbbudet	v
hilgut	hilggut	v
hilljudit	hilljudet	v
hilljut	hilljut	v
hilsket	hilsket	v
himmát	himmát	v
hirpmahit	hirmahet	v
hirpmáhuhttit	hirmáhuhttet	v
hirpmástuhttit	hirmástuhttet	v
hirdnut	hirnnut	v
hirret	hirret	v
hirrut	hirrut	v
hirrát	hirrát	v
hivludit	hivlludet	v
hivlut	hivllut	v
hivvehit	hivvehet	v
hivástahttit	hivástahttet	v
hoahkat	hoahkat	v
hoahkidit	hoahkedet	v
hoahpuhit	hoahpuhet	v
hoaidit	hoajddet	v
hoalkadit	hoalkkadet	v
hoalkut	hoalkkut	v
hoallat	hoallat	v
hoassat	hoassat	v
hupmat	hubmat	v
huhpat	huhpat	v
huhttát	huhttát	v
huidut	hujddut	v
huiggirdit	hujgerdet	v
huilát	hujlát	v
hukset	hukset	v
humaidahttit	humájdahttet	v
hunet	hunet	v
huobmát	huobbmát	v
huoikit	huojkket	v
huoikut	huojkkut	v
huollat	huollat	v
huomáhahttit	huomáhahttet	v
hurvut	hurvvut	v
huškkastit	husjkastet	v
huškkohaddat	husjkuhaddat	v
huškkohallat	husjkuhallat	v
huškut	hussjkut	v
hutkat	hutkat	v
huvdet	huvddet	v
huvlut	huvllut	v
hypnotiseret	hypnutiseret	v
hábmet	hábbmet	v
hábbudit	hábbudet	v
hábbut	hábbut	v
hápmet	hábmet	v
háddjet	háddjet	v
háđirdit	háderdet	v
hátnut	hádnut	v
hágget	hágget	v
háhkat	háhkat	v
háhpárahttit	háhpárahttet	v
háhpármahttit	háhpármahttet	v
háhttet	háhttet	v
háhccet	háhttset	v
háhccut	háhttsut	v
háhccát	háhttsát	v
háikit	hájkket	v
háistit	hájsstet	v
háisut	hájssut	v
háitit	hájttet	v
hájuhit	hájuhet	v
hálbut	hálbbut	v
hálget	hálgget	v
háldet	hálldet	v
hállet	hállet	v
hálset	hálsset	v
hálsát	hálssát	v
hámssastit	hámsastet	v
hámsut	hámssut	v
hámssuhit	hámsuhet	v
háppuhit	háppuhet	v
hárdit	hárddet	v
hárjehallat	hárjjehallat	v
hárret	hárret	v
hárrut	hárrut	v
hárrát	hárrát	v
hárččuhit	hártjuhet	v
hárčet	hárttjet	v
hárčut	hárttjut	v
hárčát	hárttját	v
hárvvedit	hárvedet	v
hárvet	hárvvet	v
hárvut	hárvvut	v
háset	háset	v
háskkidit	háskedet	v
háskkirdit	háskerdet	v
háššet	hássjet	v
hásket	hássket	v
hástit	hásstet	v
hávdut	hávddut	v
hávkut	hávkkut	v
hávrut	hávrrut	v
hávskut	hávsskut	v
hávvut	hávvut	v
hávvádahttit	hávvádahttet	v
hávváduhttit	hávváduhttet	v
háŋggaštit	háŋgasjtet	v
háŋgut	háŋggut	v
háŋket	háŋkket	v
hobehit	håbehet	v
hoddet	håddet	v
hoagahit	hågahet	v
hohkahit	håhkåhet	v
hohpohit	håhpuhet	v
hoigat	håjggåt	v
hoiggahaddat	håjgåhaddat	v
hoiggahallat	håjgåhallat	v
hoitát	håjttåt	v
hokset	håkset	v
hoksát	håksåt	v
holbat	hålbbåt	v
holket	hålkket	v
holdet	hålldet	v
holvut	hålvvut	v
hommet	håmmet	v
hommát	håmmåt	v
homo#geniseret	håmo#geneseret	v
hospiteret	håsspeteret	v
hovdet	håvddet	v
hoŋket	håŋkket	v
heahppášuhttit	hæhppátjuhttet	v
heahpášuhttit	hæhpátjuhttet	v
heaittáhallat	hæjtáhallat	v
hearvásmahttit	hærvvásmahttet	v
hearvát	hærvvát	v
heaŋgát	hæŋggát	v
i^oniseret	i^åneseret	v
ide^aliseret	ide^aleseret	v
ide^ologiseret	ide^ålugiseret	v
identifi^eret	identife^eret	v
itnut	idnut	v
eaddudit	ieddudet	v
eahpebasuhit	iehpebasuhet	v
eahpegudnejahttit	iehpegudnejahttet	v
eahccit	iehttset	v
eaidadit	iejddadet	v
eallit	iellet	v
ealvat	ielvvat	v
ealvit	ielvvet	v
eardudit	ierddudet	v
earbmut	iermmut	v
earuhit	ieruhet	v
ieš#motiveret	iesj#måteveret	v
ieš#ovdánahttit	iesj#åvddånahttet	v
eastit	iesstet	v
iežáhuhttit	ietjáhuhttet	v
eavttuhit	ievtuhet	v
ihttohaddat	ihttuhaddat	v
ihttohallat	ihttuhallat	v
iilet	ijlet	v
iiset	ijsset	v
ijastit	ijástet	v
iktit	iktet	v
illudahttit	illudahttet	v
illustreret	illustreret	v
illá#movet	illá#måvet	v
illástit	illástet	v
im^planteret	im^plantteret	v
im^plementeret	im^plementeret	v
im^pliseret	im^pliseret	v
im^pliceret	im^plitseret	v
im^ploderet	im^plåderet	v
im^pregneret	im^pregneret	v
im^proviseret	im^pråveseret	v
imaštahttit	imasjtahttet	v
imaštuhttit	imasjtuhttet	v
imiteret	imeteret	v
immi^greret	imme^greret	v
in^aktiveret	in^akteveret	v
in^augureret	in^augureret	v
in^flammeret	in^flammeret	v
in^flateret	in^flateret	v
in^flu^eret	in^flu^eret	v
in^jiseret	in^jiseret	v
in^jiceret	in^jitseret	v
in^juri^eret	in^jure^eret	v
in^klineret	in^klineret	v
in^kluderet	in^kluderet	v
in^spekteret	in^spekteret	v
in^spireret	in^spireret	v
in^spiseret	in^spiseret	v
in^stalleret	in^stalleret	v
in^stitu^eret	in^stito^eret	v
in^stitusjonaliseret	in^stitusjonaliseret	v
in^stitutionaliseret	in^stitutionaliseret	v
in^stitušonaliseret	in^stitutjonaliseret	v
in^stitušunaliseret	in^stitutjunaliseret	v
in^stru^eret	in^stru^eret	v
individu^aliseret	inddevidu^aleseret	v
industri^aliseret	inddustre^aleseret	v
initi^eret	inete^eret	v
infiltreret	infeltreret	v
informeret	infurmeret	v
insinu^eret	inssenu^eret	v
intrigeret	intregeret	v
inte^greret	intte^greret	v
intellektu^aliseret	inttellektu^aleseret	v
inter^preteret	intter^preteret	v
interfoli^eret	intterfole^eret	v
inventeret	invventeret	v
investeret	invvesteret	v
irdahuhttit	irddahuhttet	v
irdašuhttit	irddatjuhttet	v
irrut	irrut	v
iskkahit	iskahet	v
iskat	isskat	v
isoleret	isuleret	v
ivdnet	ivnnet	v
jabbut	jabbut	v
jazzifi^eret	jadtsefe^eret	v
jakŋadit	jagŋadet	v
jahlidit	jahledet	v
jahtat	jahtat	v
jalget	jalgget	v
jalkát	jalkkát	v
jallet	jallet	v
jallut	jallut	v
janzut	janttsut	v
janzát	janttsát	v
jarfut	jarffut	v
jarfát	jarffát	v
jađgohit	jargguhet	v
jarrudit	jarrudet	v
jarrut	jarrut	v
jađgŋohit	jarŋŋuhet	v
jaskkodahttit	jaskudahttet	v
javlat	javllat	v
javzat	javttsat	v
javzedit	javttsedet	v
jeđđet	jeddet	v
jevdet	jevddet	v
jeŋget	jeŋgget	v
jidnet	jiddnet	v
jietna#addit	jiedna#addet	v
jeahkit	jiehket	v
jieltudit	jielltudet	v
jienastan#vuoigadit	jienastan#vuojggadet	v
jearahallat	jierahallat	v
jearrat	jierrat	v
jiervvastit	jiervastet	v
jiessagahttit	jiessagahttet	v
jiessudit	jiessudet	v
jievladit	jievlladet	v
jievžat	jievttjat	v
jigŋet	jiggŋet	v
jirkut	jirkkut	v
joatkit	joatket	v
joavgat	joavggat	v
joavkudit	joavkkudet	v
jubmet	jubbmet	v
jugahahttit	jugáhahttet	v
jugaldahttit	jugáldahttet	v
juksat	juksat	v
julggaštit	julgasjtet	v
julbmát	julmmát	v
juntet	junttet	v
juođahit	juodahet	v
juokŋadit	juogŋadet	v
juoiggahit	juojgahet	v
juorbbuhit	juorbuhet	v
juovssahit	juovsahet	v
juovzzuhit	juovtsuhet	v
juovzudit	juovttsudet	v
jurdit	jurddet	v
jurbmát	jurmmát	v
jurssastit	jursastet	v
jurssistit	jursestet	v
jursat	jurssat	v
jursit	jursset	v
jury^eret	jury^eret	v
jusset	jusset	v
justit	jusstet	v
jussut	jussut	v
juvlet	juvllet	v
juvrát	juvrrát	v
juvssahaddat	juvsahaddat	v
jábmohallat	jábbmuhallat	v
játnadit	jádnadet	v
jáfet	jáfet	v
jáffohuhttit	jáffuhuhttet	v
jáfohuhttit	jáfuhuhttet	v
jáget	jáget	v
jáhkahaddat	jáhkahaddat	v
jáhkahallat	jáhkahallat	v
jáhkestuvvat	jáhkestuvvat	v
jáhkkit	jáhkket	v
jáhkuhit	jáhkuhet	v
jáhcut	jáhtsut	v
jáhtut	jáhtut	v
jámestuvvat	jámestuvvat	v
jámmet	jámmet	v
jástit	jásstet	v
játtastuvvat	játtastuvvat	v
jávkadahttit	jávkkadahttet	v
jávohuhttit	jávuhuhttet	v
jobbet	jåbbet	v
jođálmahttit	jådålmahttet	v
jođálnuhttit	jådålnuhttet	v
jogŋet	jåggŋet	v
johttát	jåhttåt	v
johtui#bidjat	jåhtuj#bidjat	v
jolgat	jålggåt	v
jolggaštit	jålgåsjtet	v
jollut	jållut	v
joppaldahttit	jåppåldahttet	v
jorbet	jårbbet	v
jorbát	jårbbåt	v
jorbbodahttit	jårbudahttet	v
jorddet	jårdet	v
jorddamuret	jårdåmuret	v
jorgut	jårggut	v
jorgalahttit	jårggålahttet	v
jorggiidahttit	jårgijdahttet	v
jorttet	jårtet	v
jostit	jåsstet	v
jovgohaddat	jåvgguhaddat	v
jovgohallat	jåvgguhallat	v
jovgohit	jåvgguhet	v
jovret	jåvrret	v
jovssahaddat	jåvsåhaddat	v
jovssahallat	jåvsåhallat	v
kadmi^eret	kadme^eret	v
kalli^graferet	kalle^graferet	v
kamu^fleret	kamo^fleret	v
kanaliseret	kanáliseret	v
kausativiseret	kausativiseret	v
kevret	kevrret	v
kihttet	kihttet	v
kiiket	kijkket	v
kirdnet	kirnnet	v
klihppet	klihppet	v
kláret	kláret	v
knihppet	knihppet	v
ko^aguleret	ko^aguleret	v
koailát	koajlát	v
koordineret	koorddeneret	v
kritiseret	kriteseret	v
kruvnnidit	kruvnedet	v
kryptifi^eret	kryptefe^eret	v
kuitet	kujttet	v
kumppostit	kumpustet	v
kuohcagahttit	kuohtsagahttet	v
kuovlat	kuovllat	v
kustet	kusstet	v
kvantifi^eret	kvanttefe^eret	v
kvihteret	kvihteret	v
kálket	kálkket	v
kállet	kállet	v
kámput	kámpput	v
káret	káret	v
kártet	kárttet	v
kodifi^eret	kådefe^eret	v
kodet	kådet	v
kohkket	kåhkket	v
koloni^aliseret	kålune^aleseret	v
koloniseret	kåluniseret	v
kom^primeret	kåm^primeret	v
kom^promitteret	kåm^pråmetteret	v
komfirmeret	kåmfermeret	v
kommenteret	kåmmenteret	v
kommersi^aliseret	kåmmerse^aleseret	v
komponeret	kåmppuneret	v
kompostet	kåmppustet	v
kon^fronteret	kån^fråntteret	v
kon^gru^eret	kån^gru^eret	v
kon^kluderet	kån^kluderet	v
kon^skriberet	kån^skriberet	v
kon^spireret	kån^spireret	v
kon^stitu^eret	kån^stito^eret	v
kon^stru^eret	kån^stru^eret	v
kon^traheret	kån^traheret	v
konfirmeret	kånfermeret	v
konkretiseret	kånkretiseret	v
konserveret	kånsserveret	v
konsulteret	kånssulteret	v
kontribu^eret	kåntrebu^eret	v
kontrolleret	kåntrulleret	v
kontra#signeret	kåntrå#signeret	v
kontinu^eret	kånttenu^eret	v
konvoi^eret	kånvvuj^eret	v
kopi^eret	kåpe^eret	v
kore^o^graferet	kåre^o^graferet	v
korket	kårkket	v
korreleret	kårreleret	v
koseret	kåseret	v
koŋkehit	kåŋkkehet	v
labmát	labbmát	v
labi^aliseret	labe^aleseret	v
lapmudit	labmudet	v
lapmut	labmut	v
ladnjet	laddnjet	v
latnjat	ladnjat	v
lađasmahttit	ladásmahttet	v
lahpaštuhttit	lahpasjtuhttet	v
lahpastuhttit	lahpastuhttet	v
lahcit	lahtset	v
lahttet	lahttet	v
lahttudit	lahttudet	v
laigadit	lajggadet	v
laiget	lajgget	v
laigut	lajggut	v
laktadit	laktadet	v
laktit	laktet	v
lanjahit	lanjáhet	v
lasset	lasset	v
laskehaddat	lasskehaddat	v
laskehallat	lasskehallat	v
laskestit	lasskestet	v
lasket	lassket	v
lastet	lasstet	v
lassut	lassut	v
lavdit	lavddet	v
lavdnjet	lavnnjet	v
lebbet	lebbet	v
legitimeret	legetimeret	v
legget	legget	v
lehehit	lehehet	v
lehttohit	lehttuhet	v
leháhit	leháhet	v
leibet	lejbbet	v
leikehit	lejkkehet	v
leikestit	lejkkestet	v
leiket	lejkket	v
leiret	lejret	v
leđget	lergget	v
levget	levgget	v
levdnohaddat	levnnuhaddat	v
levdnohallat	levnnuhallat	v
leŋgestit	leŋggestet	v
leŋget	leŋgget	v
lidnestit	liddnestet	v
lidnet	liddnet	v
litnudit	lidnudet	v
litnut	lidnut	v
leabastit	liebastet	v
leabbut	liebbut	v
leađit	liedet	v
leahkkut	liehkkut	v
liehppadit	liehppadet	v
leaibat	liejbbat	v
leaikut	liejkkut	v
leaikkuhit	liejkuhet	v
liekčát	liektját	v
leappuhit	lieppuhet	v
lievludit	lievlludet	v
leavdnut	lievnnut	v
liggestit	liggestet	v
ligget	ligget	v
lihkahit	lihkahet	v
lihkastahttit	lihkastahttet	v
lihkestahttit	lihkestahttet	v
lihkkidit	lihkkedet	v
lihkkohit	lihkkuhet	v
lihppet	lihppet	v
lihpput	lihpput	v
lihcohaddat	lihtsuhaddat	v
lihcohallat	lihtsuhallat	v
lihtto#láigohit	lihtto#lájgguhet	v
lihccut	lihttsut	v
liigut	lijggut	v
liikostuvvat	lijkkustuvvat	v
liikot	lijkkut	v
liibmet	lijmmet	v
liippát	lijpát	v
liiset	lijsset	v
liitut	lijttut	v
likšat	liksjat	v
likšut	liksjut	v
liktestit	liktestet	v
liktet	liktet	v
liktudit	liktudet	v
liktut	liktut	v
lilluhit	lilluhet	v
lillut	lillut	v
liluhit	liluhet	v
limpet	limppet	v
limškut	limssjkut	v
lincát	linttsát	v
lisensi^eret	lisense^eret	v
liškkohallat	lisjkuhallat	v
liškut	lissjkut	v
listet	lisstet	v
lito^graferet	lito^graferet	v
licensi^eret	litsense^eret	v
livdet	livddet	v
livjáhit	livjjáhet	v
livlet	livllet	v
livdnet	livnnet	v
livššastit	livsjastet	v
livžut	livttjut	v
livvot	livvut	v
livvut	livvut	v
liŋggustit	liŋgustet	v
loažžadit	loadtjadet	v
loaggát	loaggát	v
loahppa#árvvoštallat	loahppa#árvusjtallat	v
loahttudit	loahttudet	v
loaktit	loaktet	v
loarfát	loarffát	v
loavdit	loavddet	v
loavdudit	loavddudet	v
loavkašuhttit	loavkkatjuhttet	v
loavkidit	loavkkedet	v
loavskát	loavsskát	v
loavuhit	loavuhet	v
lubbet	lubbet	v
lubmet	lubbmet	v
luddehit	luddehet	v
luddestit	luddestet	v
luddet	luddet	v
ludnet	luddnet	v
luđet	ludet	v
luhčut	luhtjut	v
luhččehaddat	luhttjehaddat	v
luhččehallat	luhttjehallat	v
luhččet	luhttjet	v
luistet	lujsstet	v
luistát	lujsstát	v
lulidit	luledet	v
lullát	lullát	v
lummet	lummet	v
lumpehaddat	lumppehaddat	v
lumpehallat	lumppehallat	v
lumpet	lumppet	v
luoddut	luoddut	v
luogustit	luogustet	v
luohpadit	luohpadet	v
luohpudit	luohpudet	v
luohcadit	luohtsadet	v
luoitit	luojttet	v
luokčat	luoktjat	v
luonddahallat	luondahallat	v
luoskut	luosskut	v
luottahuhttit	luottahuhttet	v
luovvat	luovvat	v
lusket	lussket	v
lutket	lutket	v
luččuhit	luttjuhet	v
luvdestit	luvddestet	v
luvdet	luvddet	v
luvdnját	luvnnját	v
luvset	luvsset	v
luvvet	luvvet	v
luŋkáhit	luŋkkáhet	v
luŋkát	luŋkkát	v
lyd#isoleret	lyd#isuleret	v
lábmehit	lábbmehet	v
lábmet	lábbmet	v
lápmudit	lábmudet	v
lápmut	lábmut	v
láddiluhttit	láddeluhttet	v
láddet	láddet	v
láđđet	láddet	v
láddjet	láddjet	v
ládjudit	ládjudet	v
látnjat	ládnjat	v
látnjut	ládnjut	v
lágiidit	lágijdet	v
láhka#geatnegahttit	láhka#giednegahttet	v
láhka#mearridit	láhka#mierredet	v
láhka#vuođđudit	láhka#vuoddudet	v
láhkadit	láhkadet	v
láhkket	láhkket	v
láhkkodit	láhkkudet	v
láhkkostit	láhkkustet	v
láhkut	láhkut	v
láhppit	láhppet	v
láhpáhaddat	láhpáhaddat	v
láhpáhallat	láhpáhallat	v
láhttet	láhttet	v
láhtut	láhtut	v
láibbastit	lájbastet	v
láibut	lájbbut	v
láidehaddat	lájddehaddat	v
láidehallat	lájddehallat	v
láidestit	lájddestet	v
láidet	lájddet	v
láikut	lájkkut	v
láiret	lájret	v
láitit	lájttet	v
láivudit	lájvvudet	v
láivut	lájvvut	v
lákcut	láktsut	v
lállit	lállet	v
lállet	lállet	v
lálláhit	lálláhet	v
lámastuhttit	lámástuhttet	v
lánastuhttit	lánástuhttet	v
lášmmodahttit	lásjmudahttet	v
lássehallat	lássehallat	v
lásset	lásset	v
lástet	lásstet	v
lásttidit	lástedet	v
lávdadit	lávddadet	v
lávggehit	lávgehet	v
lávgut	lávggut	v
lávket	lávkket	v
lávkut	lávkkut	v
lávlet	lávllet	v
lávlut	lávllut	v
lávžžástit	lávtjástet	v
lávvet	lávvet	v
lobmet	låbbmet	v
loddet	låddet	v
lodnet	låddnet	v
lodnjet	låddnjet	v
lodnjáhit	låddnjåhet	v
lodnját	låddnjåt	v
lodjut	lådjut	v
lotnjudit	lådnjudet	v
lotnjut	lådnjut	v
lotnut	lådnut	v
ložžet	lådtjet	v
loget	låget	v
logget	lågget	v
loggut	låggut	v
lohkket	låhkket	v
lohkuhit	låhkuhet	v
lohppehit	låhppehet	v
lohppet	låhppet	v
lohpádahttit	låhpådahttet	v
lohttet	låhttet	v
lohtat	låhtåt	v
loiket	låjkket	v
lokkuhit	låkkuhet	v
lokkastit	låkkåstet	v
lokset	låkset	v
loktestit	låktestet	v
loktit	låktet	v
loktet	låktet	v
loktut	låktut	v
lokaliseret	låkåliseret	v
lollat	lållåt	v
lonehit	lånehet	v
lonet	lånet	v
lonjohallat	lånjuhallat	v
loasastit	låsastet	v
losidahttit	låsedahttet	v
lostet	låsstet	v
lossut	låssut	v
lotkkodahttit	låtkkudahttet	v
lovppet	låvpet	v
lovpet	låvppet	v
lovsset	låvset	v
lovset	låvsset	v
leabbát	læbbát	v
leaggát	læggát	v
leanzát	lænttsát	v
ma^skineret	ma^skineret	v
mađđet	maddet	v
mal^trakteret	mal^trakteret	v
mannet	mannet	v
mannut	mannut	v
marseret	marsseret	v
maršut	marssjut	v
mašin#lohkat	masjen#låhkåt	v
masse#produseret	masse#pråduseret	v
massit	masset	v
maskeret	masskeret	v
materi^aliseret	matere^aleseret	v
matrikuleret	matrekuleret	v
maŋidahttit	maŋedahttet	v
maŋŋe#kalkuleret	maŋŋe#kalkkuleret	v
mediteret	medeteret	v
meinet	mejnet	v
meinnet	mejnet	v
meidnet	mejnnet	v
meisket	mejssket	v
mekaniseret	mekániseret	v
menstru^eret	menstro^eret	v
merket	merkket	v
merkot	merkkut	v
merret	merret	v
meroštit	merusjtet	v
mi^greret	mi^greret	v
meaddel#vuodjit	mieddel#vuodjet	v
mieddut	mieddut	v
meatnut	miednut	v
mieđuštit	miedusjtet	v
miehtat	miehtat	v
meaidit	miejddet	v
mieigát	miejggát	v
miel#vuollái#čállit	miel#vuolláj#tjállet	v
miel#váikkuhit	miel#vájkuhet	v
mielahuhttit	mielahuhttet	v
mielddis#buktit	mieldes#buktet	v
mielddistit	mieldestet	v
mieldduhit	mielduhet	v
mielddustahttit	mieldustahttet	v
mielddustit	mieldustet	v
mielde#váikkuhit	miellde#vájkuhet	v
mieldes#buktit	mielldes#buktet	v
mearkkašahttit	mierkatjahttet	v
mearkkašuhttit	mierkatjuhttet	v
mearkut	mierkkut	v
mearrat	mierrat	v
meassat	miessat	v
meastit	miesstet	v
mihtidahttit	mihtedahttet	v
mihttet	mihttet	v
mihttohit	mihttuhet	v
mikro#skoperet	mikro#skåperet	v
millet	millet	v
mini^atyriseret	mine^atyriseret	v
mintet	minttet	v
mirkkohahttit	mirkuhahttet	v
mirkkohit	mirkuhet	v
mirkkohuhttit	mirkuhuhttet	v
misset	misset	v
misttahit	mistahet	v
moaitit	moajttet	v
moardit	moarddet	v
moarrat	moarrat	v
moarrudit	moarrudet	v
moaráhuhttit	moaráhuhttet	v
muddehit	muddehet	v
muddet	muddet	v
muggut	muggut	v
muhkut	muhkut	v
muhttit	muhttet	v
muhttohallat	muhttuhallat	v
muidet	mujddet	v
muitit	mujttet	v
muitát	mujttát	v
muittuhit	mujtuhet	v
muktit	muktet	v
mulgut	mulggut	v
muldet	mulldet	v
multi^pliseret	mullte^pliseret	v
multi^pliceret	mullte^plitseret	v
mumifi^eret	mumefe^eret	v
munnet	munnet	v
muohkkat	muohkkat	v
muohcut	muohtsut	v
muohttát	muohttát	v
muosehuhttit	muosehuhttet	v
muosvvistit	muosvvestet	v
muosáhit	muosáhet	v
muotkkuhit	muotkkuhet	v
muotkut	muotkut	v
muozastit	muotsastet	v
murddáldahttit	murdáldahttet	v
murjet	murjjet	v
murret	murret	v
muttardit	muttardet	v
muvret	muvrret	v
muvtit	muvttet	v
muŋkát	muŋkkát	v
mystifi^eret	mysstefe^eret	v
máddat	máddat	v
máguhit	máguhet	v
máhkkot	máhkkut	v
máhtestuvvat	máhtestuvvat	v
máhttit	máhttet	v
máhccut	máhttsut	v
máhttáhit	máhttáhet	v
máhttát	máhttát	v
máihlut	májhllut	v
máidnut	májnnut	v
máinnustit	májnustet	v
máistit	májsstet	v
máizadit	májttsadet	v
máizet	májttset	v
máksit	mákset	v
málet	málet	v
máladit	máládet	v
mánidit	mánedet	v
mánet	mánet	v
mánnat	mánnat	v
mánahallat	mánáhallat	v
márfut	márffut	v
márkan#fievrridit	márkkan#fievredet	v
márret	márret	v
márseret	mársseret	v
márset	mársset	v
máset	máset	v
mášuiduhttit	másjujduhttet	v
mášastuvvat	másjástuvvat	v
máskeret	másskeret	v
másket	mássket	v
máttahit	máttahet	v
mávrut	mávrrut	v
máŋggastahttit	máŋgastahttet	v
máŋgehit	máŋggehet	v
máŋget	máŋgget	v
mobbet	måbbet	v
moađaidahttit	mådajdahttet	v
moddjet	måddjet	v
moddját	måddjåt	v
modifi^eret	mådefe^eret	v
moderniseret	måderniseret	v
mozzut	mådtsut	v
mohtudit	måhtudet	v
mohtut	måhtut	v
moivet	måjvvet	v
moivašuhttit	måjvvåtjuhttet	v
molet	målet	v
molket	målkket	v
moldet	målldet	v
mollet	mållet	v
molladahttit	mållådahttet	v
mollat	mållåt	v
molsut	målssut	v
molsašuhttit	målssåtjuhttet	v
monnet	månnet	v
monnut	månnut	v
morihahttit	mårehahttet	v
moriidahttit	mårijdahttet	v
mortifi^eret	mårttefe^eret	v
moraštit	måråsjtet	v
moskkohallat	måskuhallat	v
moskát	måsskåt	v
mostut	måsstut	v
motiveret	måteveret	v
movet	måvet	v
movttidahttit	måvtedahttet	v
movttiidahttit	måvtijdahttet	v
meattá#vuodjit	mættá#vuodjet	v
nađđadit	naddadet	v
naffát	naffát	v
nagastuvvat	nagástuvvat	v
nahkehit	nahkehet	v
nahkihit	nahkehet	v
nakšát	naksját	v
nallát	nallát	v
namuhit	namuhet	v
nannet	nannet	v
nannut	nannut	v
nanosmahttit	nanusmahttet	v
nanusmahttit	nanusmahttet	v
nanostahttit	nanustahttet	v
nargit	nargget	v
naskkestit	naskestet	v
nationaliseret	nationaliseret	v
nazifi^eret	natsefe^eret	v
navdit	navddet	v
navrat	navrrat	v
navvet	navvet	v
navvit	navvet	v
navválstuvvat	navválstuvvat	v
netto#budjeteret	netto#budjeteret	v
netto#budsjetteret	netto#budsjetteret	v
netto#budšetteret	netto#budsjetteret	v
netto#bušeteret	netto#busjeteret	v
netto#busjetteret	netto#busjetteret	v
netto#bušetteret	netto#busjetteret	v
niejahit	niejahet	v
neaktit	niektet	v
nealgudahttit	nielggudahttet	v
nealggostuvvat	nielgustuvvat	v
nearrat	nierrat	v
nearohuhttit	nieruhuhttet	v
neaskit	niessket	v
neastit	niesstet	v
nievkat	nievkkat	v
neavzzuhit	nievtsuhet	v
neavzut	nievttsut	v
neavvuhit	nievvuhet	v
neavvut	nievvut	v
nihlistit	nihlestet	v
nihttit	nihttet	v
niidet	nijddet	v
niitit	nijttet	v
nikseret	nikseret	v
niktit	niktet	v
niktet	niktet	v
nildit	nilldet	v
nirvet	nirvvet	v
nirvut	nirvvut	v
nirvát	nirvvát	v
nistet	nisstet	v
nissut	nissut	v
nisttihit	nistehet	v
nivkut	nivkkut	v
njabbet	njabbet	v
njabbát	njabbát	v
njaddet	njaddet	v
njađđit	njaddet	v
njazzut	njadtsut	v
njaguštit	njagusjtet	v
njahkkát	njahkkát	v
njahpastit	njahpastet	v
njahpat	njahpat	v
njahpestit	njahpestet	v
njahpistit	njahpestet	v
njahppet	njahppet	v
njakčát	njaktját	v
njalget	njalgget	v
njaldit	njalldet	v
njallet	njallet	v
njallut	njallut	v
njalpit	njalppet	v
njalsát	njalssát	v
njalččidit	njaltjedet	v
njamastuvvat	njamástuvvat	v
njanzát	njanttsát	v
njartadit	njarttadet	v
njarvát	njarvvát	v
njassat	njassat	v
njaskut	njasskut	v
njavget	njavgget	v
njavket	njavkket	v
njaŋget	njaŋgget	v
njaŋgát	njaŋggát	v
njezzet	njedtset	v
njiđahaddat	njidáhaddat	v
njiđahallat	njidáhallat	v
njeadjut	njiedjut	v
njeahkut	njiehkut	v
njiehcadit	njiehtsadet	v
njiejahit	njiejahet	v
njeaidit	njiejddet	v
njielahaddat	njielahaddat	v
njielahallat	njielahallat	v
njeađgat	njierggat	v
njeaššut	njiessjut	v
njihkut	njihkut	v
njihtat	njihtat	v
njireštit	njiresjtet	v
njirget	njirgget	v
njirttastit	njirtastet	v
njirtut	njirttut	v
njiskkastit	njiskastet	v
njiškut	njissjkut	v
njiskut	njisskut	v
njivlut	njivllut	v
njoahcut	njoahtsut	v
njoallut	njoallut	v
njoalcát	njoalttsát	v
njoammudahttit	njoammudahttet	v
njoammudit	njoammudet	v
njoarrat	njoarrat	v
njoarostit	njoarustet	v
njoađvudit	njoarvvudet	v
njoađvut	njoarvvut	v
njoaskát	njoasskát	v
njuhttet	njuhttet	v
njuikehit	njujkkehet	v
njuikestit	njujkkestet	v
njuiket	njujkket	v
njuikut	njujkkut	v
njuikkuhit	njujkuhet	v
njulgehit	njulggehet	v
njulget	njulgget	v
njulčet	njulttjet	v
njulčut	njulttjut	v
njunne#surret	njunne#surret	v
njunnet	njunnet	v
njunuhit	njunuhet	v
njuozzit	njuodtset	v
njuozzut	njuodtsut	v
njuoggát	njuoggát	v
njuohpat	njuohpat	v
njuohtat	njuohtat	v
njuolgut	njuolggut	v
njuolgát	njuolggát	v
njuorasmahttit	njuorasmahttet	v
njuordit	njuorddet	v
njuorddáhallat	njuordáhallat	v
njuorradit	njuorradet	v
njuorvadit	njuorvvadet	v
njuoskadahttit	njuosskadahttet	v
njuovahaddat	njuovahaddat	v
njuovahallat	njuovahallat	v
njurget	njurgget	v
njurgut	njurggut	v
njuvdit	njuvddet	v
njáđđudit	njáddudet	v
njáđđut	njáddut	v
njágaldahttit	njágáldahttet	v
njáigut	njájggut	v
njálgut	njálggut	v
njállet	njállet	v
njálmmardit	njálmardet	v
njálbmadit	njálmmadet	v
njálbmat	njálmmat	v
njálbmut	njálmmut	v
njárbut	njárbbut	v
njáškát	njássjkát	v
njáskat	njásskat	v
njávgut	njávggut	v
njáŋget	njáŋgget	v
njáŋgát	njáŋggát	v
njohcut	njåhtsut	v
njokkardit	njåkkårdet	v
njolvut	njålvvut	v
njolvát	njålvvåt	v
njođget	njårgget	v
njorrehit	njårrehet	v
njorrestit	njårrestet	v
njorret	njårret	v
njozastit	njåtsåstet	v
njeazzát	njædtsát	v
njeaiddáhaddat	njæjdáhaddat	v
njeaiddáhallat	njæjdáhallat	v
njeakcát	njæktsát	v
noađoštit	noadusjtet	v
noađástit	noadástet	v
noahkut	noahkut	v
noaidut	noajddut	v
noaiddástit	noajdástet	v
noarvat	noarvvat	v
noastit	noasstet	v
noastáhit	noasstáhet	v
noavkkastit	noavkastet	v
noavkut	noavkkut	v
noavkkuhit	noavkuhet	v
nugget	nugget	v
nuhkuštit	nuhkusjtet	v
nuhttet	nuhttet	v
nulpet	nulppet	v
nuohttut	nuohttut	v
nuohtástit	nuohtástet	v
nuonddahaddat	nuondahaddat	v
nuonddahallat	nuondahallat	v
nuondadit	nuonddadet	v
nuorasmahttit	nuorasmahttet	v
nuorasmuhttit	nuorasmuhttet	v
nuorrat	nuorrat	v
nuossadit	nuossadet	v
nuoskudit	nuosskudet	v
nuppástuhttit	nuppástuhttet	v
nurridit	nurredet	v
nuvsset	nuvset	v
nuvzat	nuvttsat	v
nuvvat	nuvvat	v
ny^anseret	ny^ansseret	v
náđđahit	náddahet	v
náđđudit	náddudet	v
náđđut	náddut	v
náđđát	náddát	v
nággehaddat	nággehaddat	v
nággehallat	nággehallat	v
nágget	nágget	v
náitalstuvvat	nájttalstuvvat	v
náitastuvvat	nájttastuvvat	v
náitit	nájttet	v
nájadit	nájádet	v
nákkáhallat	nákkáhallat	v
nákcet	náktset	v
nálget	nálgget	v
nállahuhttit	nállahuhttet	v
nállašuhttit	nállatjuhttet	v
nálset	nálsset	v
náláštuhttit	nálásjtuhttet	v
nárpmastit	nármastet	v
nárridit	nárredet	v
nárret	nárret	v
nárrohaddat	nárruhaddat	v
nárrohallat	nárruhallat	v
nárvvodahttit	nárvudahttet	v
náššat	nássjat	v
náskodit	násskudet	v
návdet	návddet	v
návdut	návddut	v
návlet	návllet	v
noddet	nåddet	v
nođđudit	nåddudet	v
noiddohallat	nåjduhallat	v
nollát	nållåt	v
nominaliseret	nåmenaliseret	v
non^chaleret	nån^chaleret	v
nordat	nårddåt	v
norddahaddat	nårdåhaddat	v
norddahallat	nårdåhallat	v
norkut	nårkkut	v
normeret	nårmeret	v
notkat	nåtkåt	v
novket	nåvkket	v
novret	nåvrret	v
oaddudit	oaddudet	v
oađđát	oaddát	v
oažžut	oadtjut	v
oaffaruššat	oaffarussjat	v
oaggut	oaggut	v
oahppat	oahppat	v
oahpásmuhttit	oahpásmuhttet	v
oahpásnuhttit	oahpásnuhttet	v
oainnahallat	oajnahallat	v
oaidnit	oajnnet	v
oainnusin#dahkat	oajnusin#dahkat	v
oainnusmahttit	oajnusmahttet	v
oainnáhallat	oajnáhallat	v
oajuhit	oajuhet	v
oaktut	oaktut	v
oallut	oallut	v
oardnjudit	oarnnjudet	v
oasse#ruhtadit	oasse#ruhtadet	v
oastit	oasstet	v
oasuhit	oasuhet	v
oasástit	oasástet	v
oaččostuvvat	oattjustuvvat	v
oaččástuhttit	oattjástuhttet	v
pa^troniseret	pa^tråneseret	v
para^fraseret	para^fraseret	v
para^graferet	para^graferet	v
parodi^eret	parude^eret	v
passiveseret	passeveseret	v
patrulleret	patrulleret	v
pelket	pelkket	v
pen^sioneret	pen^sioneret	v
pen^sjoneret	pen^sjåneret	v
pentet	penttet	v
per^spireret	per^spireret	v
persi^fleret	persse^fleret	v
personifi^eret	perssunife^eret	v
piru^etteret	piro^etteret	v
pivlot	pivllut	v
plagi^eret	plage^eret	v
plánet	plánet	v
ploget	plåget	v
plokket	plåkket	v
po^cheret	po^cheret	v
po^engteret	po^engteret	v
po^etiseret	po^eteseret	v
po^ängteret	po^ängteret	v
pre^skriberet	pre^skriberet	v
premi^eret	preme^eret	v
prentet	prenttet	v
pri^oriteret	pri^åreteret	v
pro^gnoseret	pro^gnåseret	v
pro^gnostiseret	pro^gnåssteseret	v
pro^grammeret	pro^grammeret	v
pro^klameret	pro^klameret	v
pro^skriberet	pro^skriberet	v
pro^spekteret	pro^spekteret	v
pro^stitu^eret	pro^stito^eret	v
profileret	pråfeleret	v
projiseret	pråjeseret	v
protesteret	pråtesteret	v
provi^anteret	pråve^antteret	v
prøvet	prøvet	v
psyko#analyseret	psyko#anályseret	v
pumpet	pumppet	v
pusset	pusset	v
páhkket	páhkket	v
pántet	pánttet	v
pásset	pásset	v
politihkket	påletihkket	v
porno^grafiseret	pårno^grafeseret	v
postet	påsstet	v
potrehttet	påtrehttet	v
radnet	raddnet	v
radi^eret	rade^eret	v
radi^o#merket	rade^o#merkket	v
raffineret	raffeneret	v
raguhit	raguhet	v
rakŋut	ragŋut	v
rahkkát	rahkkát	v
rahkut	rahkut	v
rahpastit	rahpastet	v
rakčut	raktjut	v
ramput	rampput	v
ramsut	ramssut	v
rančut	rantjut	v
rančát	rantját	v
rasset	rasset	v
raššut	rassjut	v
rastet	rasstet	v
rasttidit	rastedet	v
rasaidahttit	rasájdahttet	v
rationaliseret	rationaliseret	v
ravdadit	ravddadet	v
ravget	ravgget	v
ravgut	ravggut	v
ravdnut	ravnnut	v
raŋistit	raŋestet	v
raŋgát	raŋggát	v
re^ageret	re^ageret	v
re^aktiveret	re^akteveret	v
re^assureret	re^assureret	v
re^flekseviseret	re^flekseviseret	v
re^flekteret	re^flekteret	v
re^flexeviseret	re^flexeviseret	v
re^gjeret	re^gjeret	v
re^investeret	re^invvesteret	v
re^klameret	re^klameret	v
re^kreeret	re^kreeret	v
re^pliseret	re^pliseret	v
re^pliceret	re^plitseret	v
re^presenteret	re^presenteret	v
re^produseret	re^pråduseret	v
re^produceret	re^prådutseret	v
re^spekteret	re^spekteret	v
re^spireret	re^spireret	v
re^stitu^eret	re^stito^eret	v
re^organiseret	re^årggåniseret	v
redu^pliseret	redo^pliseret	v
reformeret	refurmeret	v
regi^onaliseret	rege^ånåliseret	v
registarastet	regestarastet	v
registarastot	regestarastot	v
registreret	regestreret	v
regget	regget	v
reguleret	reguleret	v
regummi^eret	regumme^eret	v
rehkenuššat	rehkenussjat	v
rehkket	rehkket	v
rehttet	rehttet	v
reidet	rejddet	v
reiket	rejkket	v
reiset	rejsset	v
reistet	rejsstet	v
reistát	rejsstát	v
rektifi^eret	rektefe^eret	v
rekčohit	rektjuhet	v
rekommenderet	rekummenderet	v
rekon^stru^eret	rekun^stru^eret	v
rem^plasseret	rem^plasseret	v
rematiseret	remátiseret	v
rentehit	renttehet	v
rentet	renttet	v
reporteret	repurteret	v
repareret	repáreret	v
repatri^eret	repátre^eret	v
rešisseret	resjesseret	v
resta^ureret	ressta^ureret	v
resoneret	resuneret	v
resonneret	resunneret	v
resosi^aliseret	resuse^aleseret	v
resoci^aliseret	resutse^aleseret	v
retket	retket	v
revitaliseret	revetaliseret	v
revalu^eret	reválu^eret	v
reágeret	reágeret	v
reŋgot	reŋggut	v
ridnát	riddnát	v
ritnudit	ridnudet	v
ritnohallat	ridnuhallat	v
ritnut	ridnut	v
riegádahttit	riegádahttet	v
reahkanuššat	riehkanussjat	v
riehkidit	riehkedet	v
reahttadit	riehttadet	v
riehtudit	riehtudet	v
riekkistit	riekkestet	v
riektadit	riektadet	v
realiseret	rieleseret	v
reanttidit	rientedet	v
riessat	riessat	v
riestit	riesstet	v
riessut	riessut	v
reasttahaddat	riestahaddat	v
reasttahallat	riestahallat	v
rievdadit	rievddadet	v
rievidit	rievedet	v
reavžut	rievttjut	v
rievvut	rievvut	v
rigeret	rigeret	v
riggodahttit	riggudahttet	v
riggudit	riggudet	v
riggut	riggut	v
rihkkuhit	rihkkuhet	v
rihkkut	rihkkut	v
rihkostit	rihkustet	v
rihkustit	rihkustet	v
rihpastit	rihpastet	v
rihpihit	rihpehet	v
rihppet	rihppet	v
rihpput	rihpput	v
rihttet	rihttet	v
rihccut	rihttsut	v
rihccát	rihttsát	v
riidit	rijddet	v
riidet	rijddet	v
riimmostit	rijmustet	v
riitát	rijttát	v
rikkeret	rikkeret	v
rillet	rillet	v
rimsut	rimssut	v
rinčut	rintjut	v
rinčát	rintját	v
rissehaddat	rissehaddat	v
rissehallat	rissehallat	v
risset	risset	v
riškut	rissjkut	v
riskeret	risskeret	v
risket	rissket	v
ristat	risstat	v
ristet	risstet	v
risttašahttit	ristatjahttet	v
ritu^aliseret	rito^aleseret	v
rivnnjuhit	rivnjuhet	v
rivzát	rivttsát	v
rivvet	rivvet	v
riŋget	riŋgget	v
roađđát	roaddát	v
roahkasmahttit	roahkasmahttet	v
roahkastit	roahkastet	v
roahpihit	roahpehet	v
roaibát	roajbbát	v
roaiskut	roajsskut	v
roaivvastit	roajvastet	v
roakčut	roaktjut	v
roandit	roanddet	v
roancat	roanttsat	v
roancát	roanttsát	v
roasmmohuhttit	roasmuhuhttet	v
roasmmuhuhttit	roasmuhuhttet	v
roaškut	roassjkut	v
roavvudit	roavvudet	v
roaŋgut	roaŋggut	v
roaŋkát	roaŋkkát	v
ru^ineret	ru^ineret	v
ruddet	ruddet	v
ruddjet	ruddjet	v
rudnet	ruddnet	v
ruddudit	ruddudet	v
ruddut	ruddut	v
rutnut	rudnut	v
ružžut	rudtjut	v
ruđuhit	ruduhet	v
rugáhit	rugáhet	v
ruhkket	ruhkket	v
ruhcat	ruhtsat	v
ruhttet	ruhttet	v
ruibut	rujbbut	v
ruibát	rujbbát	v
ruibbuhit	rujbuhet	v
ruivet	rujvvet	v
ruivut	rujvvut	v
rukses#soadjá#merket	rukses#soadjá#merkket	v
rullehit	rullehet	v
rullet	rullet	v
rulljet	rulljet	v
rumet	rumet	v
rumpet	rumppet	v
rundit	runddet	v
runddihit	rundehet	v
runddáldahttit	rundáldahttet	v
runcet	runttset	v
runzet	runttset	v
ruodnát	ruoddnát	v
ruohkahaddat	ruohkahaddat	v
ruohkahallat	ruohkahallat	v
ruohtaldahttit	ruohtaldahttet	v
ruohtastahttit	ruohtastahttet	v
ruohtastuhttit	ruohtastuhttet	v
ruohčalahttit	ruohtjalahttet	v
ruoibát	ruojbbát	v
ruoibbuhit	ruojbuhet	v
ruoidnadit	ruojnnadet	v
ruoidnát	ruojnnát	v
ruoksát	ruoksát	v
ruossanahttit	ruossanahttet	v
ruossuhit	ruossuhet	v
ruossut	ruossut	v
ruškkodahttit	rusjkudahttet	v
russat	russat	v
russifi^eret	russefe^eret	v
russet	russet	v
russii#návlet	russij#návllet	v
ruššat	russjat	v
ruskestit	russkestet	v
rusket	russket	v
rustet	russtet	v
rustát	russtát	v
russut	russut	v
rusttegahttit	rustegahttet	v
ruttidit	ruttedet	v
ruttet	ruttet	v
ruccistit	ruttsestet	v
ruvdet	ruvddet	v
ruvjet	ruvjjet	v
ruvkot	ruvkkut	v
ruvnnidit	ruvnedet	v
ruvvet	ruvvet	v
rábmehit	rábbmehet	v
rábmet	rábbmet	v
rábmot	rábbmut	v
rábmát	rábbmát	v
rábidit	rábedet	v
rápmadit	rábmadet	v
rápmot	rábmut	v
rápmut	rábmut	v
rábustit	rábustet	v
rábáhuhttit	rábáhuhttet	v
rábáluhttit	rábáluhttet	v
rábastit	rábástet	v
ráđđet	ráddet	v
ráddjet	ráddjet	v
rádnet	ráddnet	v
rádnát	ráddnát	v
ráddut	ráddut	v
rátnut	rádnut	v
rážžadit	rádtjadet	v
rážžet	rádtjet	v
ráđahit	rádáhet	v
ráfehuhttit	ráfehuhttet	v
ráfut	ráfut	v
ráfáidahttit	ráfájdahttet	v
ráfáiduhttit	ráfájduhttet	v
rágget	rágget	v
rággut	rággut	v
rággát	rággát	v
ráhkadahttit	ráhkadahttet	v
ráhkadit	ráhkadet	v
ráhkestit	ráhkestet	v
ráhkistit	ráhkestet	v
ráhket	ráhket	v
ráhkkanahttit	ráhkkanahttet	v
ráhkket	ráhkket	v
ráhkkot	ráhkkut	v
ráhkut	ráhkut	v
ráhput	ráhput	v
ráikut	rájkkut	v
ráimmahaddat	rájmahaddat	v
ráimmahallat	rájmahallat	v
ráibmat	rájmmat	v
ráidnet	rájnnet	v
ráiskkidit	rájskedet	v
ráisket	rájssket	v
ráivvastit	rájvastet	v
ráivut	rájvvut	v
rájahit	rájáhet	v
rákset	rákset	v
rámbut	rámbbut	v
rámidit	rámedet	v
rámmehit	rámmehet	v
rámmet	rámmet	v
rámpet	rámppet	v
rámpot	rámpput	v
rámškut	rámssjkut	v
rámšut	rámssjut	v
rámsket	rámssket	v
ránsáhket	ránssáhket	v
ránsáhkket	ránssáhkket	v
ránčut	rántjut	v
ránčát	rántját	v
ráppet	ráppet	v
rásset	rásset	v
ráskestuvvat	rásskestuvvat	v
rásket	rássket	v
rássut	rássut	v
rátkit	rátket	v
rávdadit	rávddadet	v
rávdat	rávddat	v
rávjjastit	rávjastet	v
rávjut	rávjjut	v
rávdnjut	rávnnjut	v
rávrat	rávrrat	v
rávžadit	rávttjadet	v
rávvet	rávvet	v
ráŋgut	ráŋggut	v
ráŋggohaddat	ráŋguhaddat	v
ráŋggohallat	ráŋguhallat	v
ráŋggáštit	ráŋgásjtet	v
ráŋket	ráŋkket	v
robmahit	råbbmåhet	v
robmát	råbbmåt	v
ropmudit	råbmudet	v
ropmut	råbmut	v
rodjadit	rådjådet	v
rohkut	råhkut	v
rohčut	råhtjut	v
rohttet	råhttet	v
rohččet	råhttjet	v
roibet	råjbbet	v
roiskkohaddat	råjskuhaddat	v
roiskkohallat	råjskuhallat	v
roisket	råjssket	v
rokčehit	råktjehet	v
rokčet	råktjet	v
romfet	råmfet	v
rosset	råsset	v
rošket	råssjket	v
rostet	råsstet	v
rosvudit	råsvudet	v
rožoldahttit	råtjuldahttet	v
roŋget	råŋgget	v
roŋgát	råŋggåt	v
roŋket	råŋkket	v
readnját	ræddnját	v
reahkkát	ræhkkát	v
reahccát	ræhttsát	v
realsát	rælssát	v
reavrát	rævrrát	v
reavžát	rævttját	v
røntgen#foto^graferet	røntgen#fåto^graferet	v
sabmát	sabbmát	v
saddit	saddet	v
saddjehit	saddjehet	v
saddjet	saddjet	v
sahet	sahet	v
sahkanahttit	sahkanahttet	v
sahčat	sahtjat	v
sahčit	sahtjet	v
sahttit	sahttet	v
sahččit	sahttjet	v
sahát	sahát	v
sajihuhttit	sajehuhttet	v
saiget	sajgget	v
sainnahit	sajnahet	v
saidnadit	sajnnadet	v
sajuštit	sajusjtet	v
sajustit	sajustet	v
sajáiduhttit	sajájduhttet	v
sajálduhttit	sajálduhttet	v
saktut	saktut	v
salget	salgget	v
salkkáhallat	salkáhallat	v
salderet	sallderet	v
sallet	sallet	v
sallut	sallut	v
saldnit	salnnet	v
saluhit	saluhet	v
sam#eksisteret	sam#eksesteret	v
saneret	saneret	v
sarret	sarret	v
sarčut	sarttjut	v
sartudit	sarttudet	v
sartut	sarttut	v
saskit	sassket	v
satisfi^eret	satesfe^eret	v
satmet	satmet	v
savdnjit	savnnjet	v
savvit	savvet	v
saŋgit	saŋgget	v
se^gregeret	se^gregeret	v
segoldahttit	seguldahttet	v
sehket	sehket	v
sehkket	sehkket	v
seilet	sejlet	v
seillet	sejllet	v
selehit	selehet	v
selget	selgget	v
selvehit	selvvehet	v
sendet	senddet	v
sesong#debuteret	sesung#debuteret	v
sevlet	sevllet	v
sevnnjodahttit	sevnjudahttet	v
sex#debuteret	sex#debuteret	v
seŋket	seŋkket	v
shaket	shaket	v
sibirdit	siberdet	v
siđđut	siddut	v
sitnut	sidnut	v
siedjudit	siedjudet	v
seatnadit	siednadet	v
seaguhit	sieguhet	v
seakŋudit	siegŋudet	v
seahkut	siehkut	v
seahpat	siehpat	v
seailluhit	siejlluhet	v
seailudit	siejludet	v
siektadit	siektadet	v
seaktit	siektet	v
seaktut	siektut	v
sealggahit	sielgahet	v
sealgadit	sielggadet	v
seallat	siellat	v
sealdnit	sielnnet	v
sierranahttit	sierranahttet	v
sierkŋadit	sierŋadet	v
seassat	siessat	v
seastit	siesstet	v
seavlut	sievllut	v
sievttastit	sievtastet	v
seavvit	sievvet	v
sihkkut	sihkkut	v
sihtit	sihtet	v
siiget	sijgget	v
sikkerhets#klareret	sikkerhets#klareret	v
siktet	siktet	v
silbet	silbbet	v
sildit	silldet	v
sillet	sillet	v
sillut	sillut	v
sildnit	silnnet	v
sim^plifi^eret	sim^plife^eret	v
sim^plifiseret	sim^plifeseret	v
simput	simpput	v
sirdit	sirddet	v
sirdát	sirddát	v
sirddáldahttit	sirdáldahttet	v
sirret	sirret	v
siđvut	sirvvut	v
siđvát	sirvvát	v
sirgŋadit	sirŋŋadet	v
siđgŋadit	sirŋŋadet	v
sis#doallat	sis#doallat	v
sisa#buktit	sisa#buktet	v
sisa#fievrredit	sisa#fievredet	v
sisa#fievrridit	sisa#fievredet	v
sisa#gáibidit	sisa#gájbbedet	v
sisa#gohččut	sisa#gåhttjut	v
sisa#hukset	sisa#hukset	v
sisa#máksit	sisa#mákset	v
sisa#raporteret	sisa#rapurteret	v
sisa#sáddet	sisa#sáddet	v
sisa#čálihit	sisa#tjálehet	v
sisa#váldit	sisa#válldet	v
sisa#válljet	sisa#válljet	v
siskkidit	siskedet	v
siskkuštit	siskusjtet	v
sistat	sisstat	v
sistut	sisstut	v
sisttis#doallat	sistes#doallat	v
sivttet	sivtet	v
sivahit	siváhet	v
šalket	sjalkket	v
šalkudit	sjalkkudet	v
šalkut	sjalkkut	v
šaldut	sjalldut	v
šalmmastit	sjalmastet	v
sjarmeret	sjarmeret	v
šattastuvvat	sjattastuvvat	v
šekket	sjekket	v
šelget	sjelgget	v
šelggodahttit	sjelgudahttet	v
šelljet	sjelljet	v
šerpet	sjerppet	v
šerret	sjerret	v
šetket	sjetket	v
šieđđalahttit	sjieddalahttet	v
šiehtastuvvat	sjiehtastuvvat	v
šiehttat	sjiehttat	v
šealmmastahttit	sjielmastahttet	v
šealmmastit	sjielmastet	v
šealbmut	sjielmmut	v
šearasmahttit	sjierasmahttet	v
šiervvidit	sjiervedet	v
šiervudit	sjiervvudet	v
šeatkkastit	sjietkkastet	v
šeatkkuhit	sjietkkuhet	v
šeatkut	sjietkut	v
šigget	sjigget	v
šiggut	sjiggut	v
šihttet	sjihttet	v
šiitit	sjijttet	v
šikkastit	sjikkastet	v
šikkohaddat	sjikkuhaddat	v
šikkohallat	sjikkuhallat	v
šimuhit	sjimuhet	v
šiššat	sjissjat	v
šnjagget	sjnjagget	v
šnjalžadit	sjnjalltjadet	v
šnjalžut	sjnjalltjut	v
šnjalžžahit	sjnjaltjahet	v
šnjalčadit	sjnjalttjadet	v
šnjalčát	sjnjalttját	v
šnjarvát	sjnjarvvát	v
šnjilžut	sjnjilltjut	v
šnjirgut	sjnjirggut	v
šnjirralahttit	sjnjirralahttet	v
šnjirrehit	sjnjirrehet	v
šnjoalcát	sjnjoalttsát	v
šnjoargguhit	sjnjoarguhet	v
šnjuoggát	sjnjuoggát	v
šoavludit	sjoavlludet	v
šuđđut	sjuddut	v
šuibmat	sjujmmat	v
šulšet	sjulssjet	v
šármeret	sjármeret	v
šárralahttit	sjárralahttet	v
šárahit	sjáráhet	v
šávget	sjávgget	v
šávgut	sjávggut	v
šávahit	sjáváhet	v
šohkut	sjåhkut	v
šokčat	sjåktjåt	v
šolget	sjålgget	v
šollet	sjållet	v
šovlet	sjåvllet	v
šealgát	sjælggát	v
šearrát	sjærrát	v
skatnat	skadnat	v
skahčut	skahtjut	v
skallet	skallet	v
skalbmet	skalmmet	v
skavdut	skavddut	v
skavvehit	skavvehet	v
skebmehaddat	skebbmehaddat	v
skebmehallat	skebbmehallat	v
skebmet	skebbmet	v
skeittát	skejtát	v
skevvehit	skevvehet	v
skeŋket	skeŋkket	v
skielgát	skielggát	v
skielttardit	skieltardet	v
skievttardit	skievtardet	v
skievttidit	skievtedet	v
skeaŋkut	skieŋkkut	v
skihkidit	skihkedet	v
skihkket	skihkket	v
skihppát	skihppát	v
skihtardit	skihtardet	v
skihččát	skihttját	v
skiivut	skijvvut	v
skilggehit	skilgehet	v
skilget	skilgget	v
skillalahttit	skillalahttet	v
skilžut	skilltjut	v
skilttardit	skiltardet	v
skirrát	skirrát	v
skirvehit	skirvvehet	v
skivlet	skivllet	v
skivdnjet	skivnnjet	v
skivžut	skivttjut	v
skivvehit	skivvehet	v
skoađđut	skoaddut	v
skoahččát	skoahttját	v
skoavdudit	skoavddudet	v
skoavhludit	skoavhlludet	v
skoavdnjut	skoavnnjut	v
skruvet	skruvet	v
skruvvet	skruvvet	v
skubbet	skubbet	v
skuđđet	skuddet	v
skudnet	skuddnet	v
skuđđut	skuddut	v
skuhppet	skuhppet	v
skuhččet	skuhttjet	v
skuhččát	skuhttját	v
skuibát	skujbbát	v
skulkat	skulkkat	v
skulket	skulkket	v
skuldohaddat	skullduhaddat	v
skuldohallat	skullduhallat	v
skuldot	skulldut	v
skuldut	skulldut	v
skulljet	skulljet	v
skummet	skummet	v
skumpet	skumppet	v
skuodnját	skuoddnját	v
skuolfát	skuolffát	v
skuoljastit	skuoljjastet	v
skuolkut	skuolkkut	v
skuolljut	skuolljut	v
skuorgat	skuorggat	v
skuožurdit	skuotjurdet	v
skurdnjut	skurnnjut	v
skurdnját	skurnnját	v
skurret	skurret	v
skurrát	skurrát	v
skuvllet	skuvlet	v
skuvlet	skuvllet	v
skuvdnjut	skuvnnjut	v
skuvdnját	skuvnnját	v
skuvrret	skuvret	v
skuvret	skuvrret	v
skuvttet	skuvtet	v
skáđđehaddat	skáddehaddat	v
skáđđehallat	skáddehallat	v
skáđđet	skáddet	v
skáđet	skádet	v
skádjat	skádjat	v
skáhppet	skáhppet	v
skáhppot	skáhpput	v
skáhčut	skáhtjut	v
skáhttet	skáhttet	v
skáidet	skájddet	v
skáidnehaddat	skájnnehaddat	v
skáidnehallat	skájnnehallat	v
skáidnet	skájnnet	v
skálmmastit	skálmastet	v
skálbmestit	skálmmestet	v
skálbmet	skálmmet	v
skálbmut	skálmmut	v
skálvat	skálvvat	v
skálahit	skáláhet	v
skánnet	skánnet	v
skárbat	skárbbat	v
skárdnjut	skárnnjut	v
skárrat	skárrat	v
skártet	skárttet	v
skártut	skárttut	v
skárastit	skárástet	v
skážastit	skátjástet	v
skávgadit	skávggadet	v
skávgat	skávggat	v
skávžut	skávttjut	v
skávvut	skávvut	v
skoađastit	skådastet	v
skohttet	skåhttet	v
skohččet	skåhttjet	v
skolet	skålet	v
skoldet	skålldet	v
skollet	skållet	v
skolladit	skållådet	v
skolput	skålpput	v
skolpát	skålppåt	v
skoarahit	skårahet	v
skoret	skåret	v
skorpet	skårppet	v
skortehaddat	skårttehaddat	v
skortehallat	skårttehallat	v
skortet	skårttet	v
skeavžát	skævttját	v
šlahttát	slahttát	v
šlehppet	slehppet	v
šleŋget	sleŋgget	v
šlieddadit	slieddadet	v
šlieddát	slieddát	v
šleaivut	sliejvvut	v
šleambit	sliembbet	v
šleambut	sliembbut	v
šliettuhit	sliettuhet	v
šleaŋgut	slieŋggut	v
šliippet	slijpet	v
šliipet	slijppet	v
šliittet	slijtet	v
šliitet	slijttet	v
šliivut	slijvvut	v
šlimput	slimpput	v
šlivggastit	slivgastet	v
šlivget	slivgget	v
šlivgut	slivggut	v
šloahkkut	sloahkkut	v
šloavvat	sloavvat	v
šloaŋgát	sloaŋggát	v
šlubbet	slubbet	v
šlubbudit	slubbudet	v
šlubbut	slubbut	v
šlubbát	slubbát	v
šlubistit	slubestet	v
šlubahaddat	slubáhaddat	v
šlubahallat	slubáhallat	v
šluhpat	sluhpat	v
šluhttet	sluhttet	v
šlundudit	slunddudet	v
šlundut	slunddut	v
šlundát	slunddát	v
šluččuhit	sluttjuhet	v
šluvgit	sluvgget	v
šluŋkáhit	sluŋkkáhet	v
šluŋkát	sluŋkkát	v
šláddjet	sláddjet	v
šláktet	sláktet	v
šlárbmet	slármmet	v
šlárvet	slárvvet	v
šlávehit	slávehet	v
šlávet	slávet	v
šlohkket	slåhkket	v
šloavaldahttit	slåvaldahttet	v
šloavastit	slåvastet	v
šlovet	slåvet	v
šleancát	slænttsát	v
smarfet	smarffet	v
smarret	smarret	v
smartet	smarttet	v
smarvet	smarvvet	v
smeltet	smelltet	v
smiđđut	smiddut	v
smiehtahit	smiehtahet	v
smiehttat	smiehttat	v
smierrudit	smierrudet	v
smilčut	smilttjut	v
smoarrat	smoarrat	v
smoarrut	smoarrut	v
smuhččát	smuhttját	v
smulket	smulkket	v
smurtet	smurttet	v
smáhket	smáhket	v
smáhkket	smáhkket	v
smáitut	smájttut	v
smávuhit	smávuhet	v
smávvet	smávvet	v
smávvut	smávvut	v
smoggut	småggut	v
smoggát	småggåt	v
smoldet	smålldet	v
smollet	smållet	v
smovhlet	småvhllet	v
smovllet	småvlet	v
snađđet	snaddet	v
snadjat	snadjat	v
snahppot	snahpput	v
snarrot	snarrut	v
snelket	snelkket	v
snelkkohaddat	snelkuhaddat	v
snelkkohallat	snelkuhallat	v
sneaidadit	sniejddadet	v
snealkut	snielkkut	v
snihkket	snihkket	v
snihpastit	snihpastet	v
snihpput	snihpput	v
sniikket	snijket	v
sniiket	snijkket	v
snillet	snillet	v
snoaggudit	snoaggudet	v
snoahpat	snoahpat	v
snoahput	snoahput	v
snuđđut	snuddut	v
snuggat	snuggat	v
snuhttet	snuhttet	v
snuittet	snujtet	v
snuohtardit	snuohtardet	v
snuolggidit	snuolgedet	v
snuordudit	snuorddudet	v
snuordát	snuorddát	v
snurtet	snurttet	v
snuvsset	snuvset	v
snuvtet	snuvttet	v
snáitet	snájttet	v
snárkudit	snárkkudet	v
snárkut	snárkkut	v
snohkkát	snåhkkåt	v
snolkát	snålkkåt	v
snorrehit	snårrehet	v
soažžudit	soadtjudet	v
soakŋut	soagŋut	v
soahttát	soahttát	v
soaikut	soajkkut	v
soaimmahaddat	soajmahaddat	v
soaimmahallat	soajmahallat	v
soaibmat	soajmmat	v
soaldudit	soalldudet	v
soallut	soallut	v
soardidit	soarddedet	v
soardit	soarddet	v
soarddáhaddat	soardáhaddat	v
soarddáhallat	soardáhallat	v
soarpudit	soarppudet	v
soarcat	soarttsat	v
soatkat	soatkat	v
soavludit	soavlludet	v
spatnat	spadnat	v
spaggat	spaggat	v
spagget	spagget	v
spahčat	spahtjat	v
spaiget	spajgget	v
spaigut	spajggut	v
spaigguhit	spajguhet	v
spalcadit	spalttsadet	v
sparret	sparret	v
sparahit	sparáhet	v
sparaidahttit	sparájdahttet	v
spažahit	spatjáhet	v
spežžet	spedtjet	v
spekuleret	spekuleret	v
spellet	spellet	v
spesi^aliseret	spese^aleseret	v
spesifi^eret	spesefe^eret	v
speci^aliseret	spetse^aleseret	v
spi^oneret	spi^åneret	v
spiddet	spiddet	v
spiddut	spiddut	v
spitnjut	spidnjut	v
speadjat	spiedjat	v
speažžut	spiedtjut	v
spealastit	spielastet	v
spielastit	spielastet	v
speallat	spiellat	v
spiellat	spiellat	v
spihket	spihket	v
spihččet	spihttjet	v
spiidet	spijddet	v
spiiddet	spijdet	v
spiilet	spijlet	v
spiillet	spijllet	v
spiidne#guođohit	spijnne#guoduhet	v
spildut	spilldut	v
spillet	spillet	v
spivkket	spivket	v
spivket	spivkket	v
spoahttat	spoahttat	v
sprajjet	sprajjet	v
sprájjet	sprájjet	v
spulet	spulet	v
spulžudit	spulltjudet	v
spulžut	spulltjut	v
spuŋget	spuŋgget	v
spádjut	spádjut	v
spággudit	spággudet	v
spáhččet	spáhttjet	v
spáikkastit	spájkastet	v
spáikut	spájkkut	v
spáikkohaddat	spájkuhaddat	v
spáikkohallat	spájkuhallat	v
spáitet	spájttet	v
spálžudit	spálltjudet	v
spálžut	spálltjut	v
spálžát	spálltját	v
spálčudit	spálttjudet	v
spálčut	spálttjut	v
spálčát	spálttját	v
spánderet	spándderet	v
spánžadit	spánttjadet	v
spáret	spáret	v
spárkadit	spárkkadet	v
spárket	spárkket	v
spárvet	spárvvet	v
spáseret	spáseret	v
sponset	spånsset	v
spontet	spånttet	v
spovet	spåvet	v
srevet	srevet	v
sreŋget	sreŋgget	v
sriiket	srijkket	v
sriŋget	sriŋgget	v
sruhpat	sruhpat	v
sruvet	sruvet	v
stajidit	stajedet	v
stalkadit	stalkkadet	v
standardiseret	standdardiseret	v
standárdiseret	standdárdiseret	v
starggasmahttit	stargasmahttet	v
starggasnuhttit	stargasnuhttet	v
stargadit	starggadet	v
statu^eret	stato^eret	v
stavkáhit	stavkkáhet	v
stežžet	stedtjet	v
steikket	stejket	v
steiket	stejkket	v
stemmet	stemmet	v
steno^graferet	steno^graferet	v
steno^grafet	steno^grafet	v
stenžet	stenttjet	v
stere^o#typeret	stere^o#typeret	v
steriliseret	stereliseret	v
stevdnehaddat	stevnnehaddat	v
stevdnehallat	stevnnehallat	v
stevdnet	stevnnet	v
steŋget	steŋgget	v
steažžut	stiedtjut	v
stielgudit	stielggudet	v
stielkudit	stielkkudet	v
steavlidit	stievlledet	v
steavdnut	stievnnut	v
steaŋgut	stieŋggut	v
stihkadit	stihkadet	v
stihkket	stihkket	v
stiivvet	stijvet	v
stiivet	stijvvet	v
stiivut	stijvvut	v
stilččuhit	stiltjuhet	v
stilčut	stilttjut	v
stimuleret	stimuleret	v
stirdudit	stirddudet	v
stirdut	stirddut	v
stirrát	stirrát	v
stircut	stirttsut	v
stizaidahttit	stitsájdahttet	v
stivrret	stivret	v
stivret	stivrret	v
stivát	stivát	v
stoalpát	stoalppát	v
stratifi^eret	stratefe^eret	v
strebmet	strebbmet	v
streiket	strejkket	v
strevet	strevet	v
streŋget	streŋgget	v
striiket	strijkket	v
struhpat	struhpat	v
struktureret	struktureret	v
stráffet	stráffet	v
studeret	studeret	v
stuđeret	studeret	v
stuibmet	stujmmet	v
stulljet	stulljet	v
stumpát	stumppát	v
stunžet	stunttjet	v
sturjet	sturjjet	v
stuvset	stuvsset	v
stuŋgadit	stuŋggadet	v
stuŋgehit	stuŋggehet	v
stuŋget	stuŋgget	v
státnat	stádnat	v
stáđásmahttit	stádásmahttet	v
stágget	stágget	v
stággudit	stággudet	v
stáhppet	stáhppet	v
stáiput	stájpput	v
stáipát	stájppát	v
stálet	stálet	v
stállet	stállet	v
stándet	stánddet	v
stánžet	stánttjet	v
stánžudit	stánttjudet	v
stánžut	stánttjut	v
stárret	stárret	v
stártet	stárttet	v
stávet	stávet	v
stávrát	stávrrát	v
stávžut	stávttjut	v
stáŋget	stáŋgget	v
stohkket	ståhkket	v
stohkkut	ståhkkut	v
stohkkadit	ståhkkådet	v
stohppet	ståhppet	v
stohččet	ståhttjet	v
stohččát	ståhttjåt	v
stolkkihit	stålkehet	v
stolpet	stålppet	v
storbmet	stårmmet	v
storret	stårret	v
storrát	stårråt	v
stovet	ståvet	v
steađđát	stæddát	v
steanžát	stænttját	v
sub^skriberet	sub^skriberet	v
sub^stitu^eret	sub^stito^eret	v
sub^traheret	sub^traheret	v
sub^ordineret	sub^årddeneret	v
submet	subbmet	v
subsidi^eret	subsede^eret	v
substanti^eret	substante^eret	v
substantiviseret	substantiviseret	v
suđđit	suddet	v
suddjet	suddjet	v
sudnet	suddnet	v
sudduduhttit	sudduduhttet	v
suddohallat	sudduhallat	v
suf^fleret	suf^fleret	v
sugadahttit	sugádahttet	v
sugaldahttit	sugáldahttet	v
suhkalahttit	suhkalahttet	v
suhkkát	suhkkát	v
suhppet	suhppet	v
suhčut	suhtjut	v
suilut	sujlut	v
suidnet	sujnnet	v
suitit	sujttet	v
suitet	sujttet	v
suivvastuhttit	sujvastuhttet	v
suivvástuhttit	sujvástuhttet	v
sujahit	sujáhet	v
sukkát	sukkát	v
sukčet	suktjet	v
sulladit	sulladet	v
suldit	sulldet	v
sulastahttit	sulástahttet	v
sulástahttit	sulástahttet	v
sunddaguššat	sundagussjat	v
suođđadit	suoddadet	v
suohpput	suohpput	v
suohtastahttit	suohtastahttet	v
suoibbuhit	suojbuhet	v
suokkardit	suokkardet	v
suollagahttit	suollagahttet	v
suolle#fievrridit	suolle#fievredet	v
suolle#vákšut	suolle#váksjut	v
suolláduhttit	suolláduhttet	v
suollágahttit	suollágahttet	v
suolbmudit	suolmmudet	v
suoldnudit	suolnnudet	v
suoládahttit	suoládahttet	v
suoláduhttit	suoláduhttet	v
suordit	suorddet	v
suorggahit	suorgahet	v
suorggidit	suorgedet	v
suortudit	suorttudet	v
suossadit	suossadet	v
suosttuhit	suostuhet	v
suožahit	suotjahet	v
suovastuhttit	suovastuhttet	v
suovrát	suovrrát	v
suovvat	suovvat	v
suovvudit	suovvudet	v
sup^plikeret	sup^plikeret	v
sup^plikkeret	sup^plikkeret	v
sup^pliceret	sup^plitseret	v
sup^primeret	sup^primeret	v
supple^eret	supple^eret	v
surfet	surffet	v
surgehit	surggehet	v
surgit	surgget	v
surggiidahttit	surgijdahttet	v
surret	surret	v
sustit	susstet	v
suvdit	suvddet	v
suvget	suvgget	v
suvjadit	suvjjadet	v
suvlet	suvllet	v
suvrragahttit	suvragahttet	v
suvrut	suvrrut	v
suvccastit	suvttsastet	v
sveiset	svejsset	v
sváret	sváret	v
symboliseret	symbbuliseret	v
syn^kroniseret	syn^kråneseret	v
systematiseret	sysstematiseret	v
sáddet	sáddet	v
sággut	sággut	v
sáhkket	sáhkket	v
sáhkkuhit	sáhkkuhet	v
sáhkuhit	sáhkuhet	v
sáhpput	sáhpput	v
sáhčat	sáhtjat	v
sáhcut	sáhtsut	v
sáhtostit	sáhtustet	v
sáiget	sájgget	v
sáimmastit	sájmastet	v
sáiset	sájsset	v
sáivadit	sájvvadet	v
sáktet	sáktet	v
sálket	sálkket	v
sállat	sállat	v
sállet	sállet	v
sáltet	sálltet	v
sáltudit	sálltudet	v
sáltut	sálltut	v
sámáidahttit	sámájdahttet	v
sáneret	sáneret	v
sárget	sárgget	v
sárgut	sárggut	v
sárdnut	sárnnut	v
sárastit	sárástet	v
sázastit	sátsástet	v
sávdnjet	sávnnjet	v
sávdnjut	sávnnjut	v
sávdnut	sávnnut	v
sávrudit	sávrrudet	v
sávrut	sávrrut	v
soabastuvvat	såbastuvvat	v
sodnját	såddnjåt	v
sodjalahttit	sådjålahttet	v
sotnjut	sådnjut	v
sotnadit	sådnådet	v
sogget	sågget	v
sogahuhttit	sågåhuhttet	v
sohttet	såhttet	v
sohtut	såhtut	v
soidit	såjddet	v
soiccuhit	såjtsuhet	v
soicát	såjttsåt	v
sojahit	såjåhet	v
sojaldahttit	såjåldahttet	v
sokčat	såktjåt	v
soktudit	såktudet	v
soktut	såktut	v
solgat	sålggåt	v
soldut	sålldut	v
sollet	sållet	v
sollat	sållåt	v
solát	sålåt	v
sorját	sårjjåt	v
sorbmet	sårmmet	v
sorrat	sårråt	v
sorteret	sårtteret	v
soradit	sårådet	v
sosi^aliseret	såse^aleseret	v
sotket	såtket	v
soci^aliseret	såtse^aleseret	v
sovlet	såvllet	v
seabbát	sæbbát	v
seavdnját	sævnnját	v
tapiseret	tapeseret	v
tatu^eret	tato^eret	v
te^oretiseret	te^åretiseret	v
teknifi^eret	teknefe^eret	v
tekstet	tekstet	v
tele^graferet	tele^graferet	v
teltet	telltet	v
tennjedit	tennjedet	v
tennjet	tennjet	v
tentet	tenttet	v
testamentet	tesstamentet	v
testet	tesstet	v
tevdnet	tevnnet	v
teahtistit	tiehtestet	v
tigget	tigget	v
tihppet	tihppet	v
tiidet	tijddet	v
tiibmet	tijmmet	v
tinet	tinet	v
tiŋgot	tiŋggut	v
čabardit	tjabárdet	v
čagalduhtestit	tjagálduhtestet	v
čagalduhttit	tjagálduhttet	v
čagarduhtestit	tjagárduhtestet	v
čagarduhttit	tjagárduhttet	v
čahkkadit	tjahkkadet	v
čahkket	tjahkket	v
čahkut	tjahkut	v
čahpat	tjahpat	v
čaimmáhallat	tjajmáhallat	v
čakčut	tjaktjut	v
čalgadit	tjalggadet	v
čallidit	tjalledet	v
čalmmehuhttit	tjalmehuhttet	v
čalbmadit	tjalmmadet	v
čalbmat	tjalmmat	v
čalmmustahttit	tjalmustahttet	v
čalmmustuhttit	tjalmustuhttet	v
čanahaddat	tjanáhaddat	v
čanahahttit	tjanáhahttet	v
čanahallat	tjanáhallat	v
čarvvahit	tjarvahet	v
časkkahallat	tjaskahallat	v
časkkáhallat	tjaskáhallat	v
časkit	tjassket	v
čavdet	tjavddet	v
čavdudit	tjavddudet	v
čavdut	tjavddut	v
čavget	tjavgget	v
čavgut	tjavggut	v
čegŋet	tjeggŋet	v
čellet	tjellet	v
čeret	tjeret	v
čerget	tjergget	v
čerset	tjersset	v
českkodahttit	tjeskudahttet	v
čitnut	tjidnut	v
čieđđát	tjieddát	v
čiehkat	tjiehkat	v
čeahkut	tjiehkut	v
čiehkádahttit	tjiehkádahttet	v
čeahppudit	tjiehppudet	v
čiehttat	tjiehttat	v
čiekčat	tjiektjat	v
čielggasmahttit	tjielgasmahttet	v
čealuhit	tjieluhet	v
čearidit	tjieredet	v
čierrut	tjierrut	v
čierostuvvat	tjierustuvvat	v
čeasahit	tjiesahet	v
čievččahaddat	tjievtjahaddat	v
čievččahallat	tjievtjahallat	v
čigŋát	tjiggŋát	v
čihttet	tjihttet	v
čiktit	tjiktet	v
čilgehit	tjilggehet	v
čilgestit	tjilggestet	v
čilget	tjilgget	v
čilvet	tjilvvet	v
čilvut	tjilvvut	v
čindot	tjinddut	v
čippostit	tjippustet	v
čippustit	tjippustet	v
čirradit	tjirradet	v
čirrostit	tjirrustet	v
čirsát	tjirssát	v
čiŋkut	tjiŋkkut	v
čiŋkkuhit	tjiŋkuhet	v
čiŋahit	tjiŋáhet	v
čiŋaldahttit	tjiŋáldahttet	v
čoabmudit	tjoabbmudet	v
čoapmuhit	tjoabmuhet	v
čoaggit	tjoagget	v
čoahkkái#geassit	tjoahkkáj#giesset	v
čoahkáidit	tjoahkájdet	v
čoakčut	tjoaktjut	v
čoalehuhttit	tjoalehuhttet	v
čoallit	tjoallet	v
čoallut	tjoallut	v
čoalčát	tjoalttját	v
čoarrát	tjoarrát	v
čoavdit	tjoavddet	v
čoavjudit	tjoavjjudet	v
čužžehit	tjudtjehet	v
čuggestit	tjuggestet	v
čugget	tjugget	v
čuihnut	tjujhnnut	v
čuiket	tjujkket	v
čuimmoldahttit	tjujmuldahttet	v
čujuhit	tjujuhet	v
čukkohaddat	tjukkuhaddat	v
čukkohallat	tjukkuhallat	v
čulket	tjulkket	v
čuldet	tjulldet	v
čulbmet	tjulmmet	v
čuntut	tjunttut	v
čuopmat	tjuobmat	v
čuođđát	tjuoddát	v
čuodjalahttit	tjuodjalahttet	v
čuogastuvvat	tjuogastuvvat	v
čuoggut	tjuoggut	v
čuohkudit	tjuohkudet	v
čuohpahaddat	tjuohpahaddat	v
čuohpahallat	tjuohpahallat	v
čuojahit	tjuojahet	v
čuojaldahttit	tjuojaldahttet	v
čuoiggaldahttit	tjuojgaldahttet	v
čuoigalahttit	tjuojggalahttet	v
čuoigát	tjuojggát	v
čuoibmut	tjuojmmut	v
čuoimmuhit	tjuojmuhet	v
čuojustit	tjuojustet	v
čuokkehit	tjuokkehet	v
čuokkihit	tjuokkehet	v
čuolahaddat	tjuolahaddat	v
čuolahallat	tjuolahallat	v
čuolddahit	tjuoldahet	v
čuolddastit	tjuoldastet	v
čuoldit	tjuolldet	v
čuollát	tjuollát	v
čuolbmat	tjuolmmat	v
čuorgát	tjuorggát	v
čuorvut	tjuorvvut	v
čuoččaldahttit	tjuottjaldahttet	v
čuoččáldahttit	tjuottjáldahttet	v
čuovgát	tjuovggát	v
čuovvulahttit	tjuovvulahttet	v
čuovvut	tjuovvut	v
čurtet	tjurttet	v
čurtut	tjurttut	v
čurtát	tjurttát	v
čurvet	tjurvvet	v
čuskkoldahttit	tjuskuldahttet	v
čusket	tjussket	v
čuvdet	tjuvddet	v
čuvget	tjuvgget	v
čuvggiidahttit	tjuvgijdahttet	v
čuvket	tjuvkket	v
čuvkudit	tjuvkkudet	v
čuvkut	tjuvkkut	v
čuvoldahttit	tjuvuldahttet	v
čábbut	tjábbut	v
čádjidahttit	tjádjedahttet	v
čákŋadit	tjágŋadet	v
čáhkadit	tjáhkadet	v
čáhkket	tjáhkket	v
čáhppát	tjáhppát	v
čáhpodahttit	tjáhpudahttet	v
čáhcudit	tjáhtsudet	v
čáhcut	tjáhtsut	v
čáhccet	tjáhttset	v
čájehit	tjájehet	v
čállit	tjállet	v
čánset	tjánsset	v
čáđgit	tjárgget	v
čárdnadit	tjárnnadet	v
čárvvastit	tjárvastet	v
čárvvohaddat	tjárvuhaddat	v
čárvvohallat	tjárvuhallat	v
čárvvuhit	tjárvuhet	v
čárvehit	tjárvvehet	v
čárvet	tjárvvet	v
čárvut	tjárvvut	v
čáráhaddat	tjáráhaddat	v
čáráhallat	tjáráhallat	v
čáskadit	tjásskadet	v
čávvet	tjávvet	v
čáŋahit	tjáŋáhet	v
čobmet	tjåbbmet	v
čobmát	tjåbbmåt	v
čođđudit	tjåddudet	v
čođđut	tjåddut	v
čogastahttit	tjågåstahttet	v
čohkkestit	tjåhkkestet	v
čohkket	tjåhkket	v
čohkkát	tjåhkkåt	v
čohkodahttit	tjåhkudahttet	v
čohkut	tjåhkut	v
čohkaluhttit	tjåhkåluhttet	v
čohkat	tjåhkåt	v
čolgat	tjålggåt	v
čolggahaddat	tjålgåhaddat	v
čolggahallat	tjålgåhallat	v
čollet	tjållet	v
čoltet	tjålltet	v
čollut	tjållut	v
čolčet	tjålttjet	v
čorget	tjårgget	v
čorbmat	tjårmmåt	v
čorpmahaddat	tjårmåhaddat	v
čorpmahallat	tjårmåhallat	v
čorostahttit	tjårustahttet	v
čovlut	tjåvllut	v
čovvát	tjåvvåt	v
čeagŋát	tjæggŋát	v
čearsát	tjærssát	v
čeaskát	tjæsskát	v
toardnát	toarnnát	v
tou^cheret	tou^cheret	v
tran^cheret	tran^cheret	v
tran^scenderet	tran^scendderet	v
tran^skriberet	tran^skriberet	v
tran^spireret	tran^spireret	v
trans^fereret	trans^fereret	v
trans^figureret	trans^figureret	v
trans^funderet	trans^fundderet	v
trans^formeret	trans^fårmeret	v
trans^iteret	trans^iteret	v
trans^littereret	trans^littereret	v
trans^mitteret	trans^mitteret	v
trans^planteret	trans^plantteret	v
trans^poneret	trans^påneret	v
trans^porteret	trans^pårtteret	v
tregget	tregget	v
trenet	trenet	v
tri^anguleret	tri^anguleret	v
tri^umferet	tri^umferet	v
triivvet	trijvet	v
triivet	trijvvet	v
trillet	trillet	v
trimmet	trimmet	v
trivi^aliseret	trive^aleseret	v
tránet	tránet	v
caddjodit	tsaddjudet	v
caddjohallat	tsaddjuhallat	v
cadjat	tsadjat	v
cadjit	tsadjet	v
caggat	tsaggat	v
caggát	tsaggát	v
cahkiidahttit	tsahkijdahttet	v
cahkkát	tsahkkát	v
cahpat	tsahpat	v
cahppát	tsahppát	v
cakkahaddat	tsakkahaddat	v
cakkahallat	tsakkahallat	v
calmmustahttit	tsalmustahttet	v
cavggestit	tsavgestet	v
cavgit	tsavgget	v
cavgguhit	tsavguhet	v
cegget	tsegget	v
cehkket	tsehkket	v
certifi^eret	tserttefe^eret	v
cibmut	tsibbmut	v
ceaggut	tsieggut	v
ceahkastit	tsiehkastet	v
ceahkkut	tsiehkkut	v
ceahkuhit	tsiehkuhet	v
ciehkut	tsiehkut	v
ciekkahahttit	tsiekkahahttet	v
ceakkuhit	tsiekkuhet	v
cielahaddat	tsielahaddat	v
cielahallat	tsielahallat	v
cielaldahttit	tsielaldahttet	v
cealkkihit	tsielkehet	v
cealkkestit	tsielkestet	v
cealkit	tsielkket	v
ciellalahttit	tsiellalahttet	v
cieládahttit	tsieládahttet	v
ceavzzestuvvat	tsievtsestuvvat	v
ceavvit	tsievvet	v
ceavvut	tsievvut	v
cihcit	tsihtset	v
cihccat	tsihttsat	v
cikcet	tsiktset	v
cikcut	tsiktsut	v
cilahit	tsiláhet	v
cimirdit	tsimerdet	v
cimput	tsimpput	v
cinnuhit	tsinnuhet	v
cirgalahttit	tsirggalahttet	v
cirget	tsirgget	v
cirgut	tsirggut	v
cirkát	tsirkkát	v
cirpmastit	tsirmastet	v
cirbmut	tsirmmut	v
cissastuvvat	tsissastuvvat	v
cissat	tsissat	v
ciskat	tsisskat	v
cissuhit	tsissuhet	v
cizihit	tsitsehet	v
civccastit	tsivttsastet	v
civccohaddat	tsivttsuhaddat	v
civccohallat	tsivttsuhallat	v
civccuhit	tsivttsuhet	v
coahllat	tsoahllat	v
coakcudit	tsoaktsudet	v
cubadit	tsubádet	v
cuhpat	tsuhpat	v
cuigehaddat	tsujggehaddat	v
cuigehallat	tsujggehallat	v
cuiget	tsujgget	v
cuilut	tsujlut	v
cuipát	tsujppát	v
culláhit	tsulláhet	v
cullát	tsullát	v
cummestit	tsummestet	v
cummistit	tsummestet	v
cummet	tsummet	v
cummát	tsummát	v
cuoigut	tsuojggut	v
cuovkut	tsuovkkut	v
cuovvut	tsuovvut	v
curbmet	tsurmmet	v
curbmát	tsurmmát	v
cuvistit	tsuvestet	v
cuvket	tsuvkket	v
cuvccastit	tsuvttsastet	v
cuvzat	tsuvttsat	v
cy^anidiseret	tsy^anediseret	v
cábmit	tsábbmet	v
cábmohaddat	tsábbmuhaddat	v
cábmohallat	tsábbmuhallat	v
cápmahahttit	tsábmahahttet	v
cápmahallat	tsábmahallat	v
cápmit	tsábmet	v
cápmáhallat	tsábmáhallat	v
cáhkit	tsáhket	v
cáhcut	tsáhtsut	v
cákcut	tsáktsut	v
cázastit	tsátsástet	v
cohkkohit	tsåhkkuhet	v
coicát	tsåjttsåt	v
covdnat	tsåvnnåt	v
ceaggáhit	tsæggáhet	v
ceaggát	tsæggát	v
tugget	tugget	v
tuhččet	tuhttjet	v
tulkot	tulkkut	v
tullehallat	tullehallat	v
tullet	tullet	v
tulljet	tulljet	v
turistet	turestet	v
typifi^eret	typefe^eret	v
tyranniseret	tyránniseret	v
táhket	táhket	v
táhpehaddat	táhpehaddat	v
táhpehallat	táhpehallat	v
táhpet	táhpet	v
tákseret	tákseret	v
táŋket	táŋkket	v
topikaliseret	tåpekaliseret	v
uddet	uddet	v
udnot	uddnut	v
uhkidit	uhkedet	v
uhcedit	uhtsedet	v
uhccudit	uhttsudet	v
uhccut	uhttsut	v
uidnut	ujnnut	v
ulbmil#stivret	ulmmel#stivrret	v
ulbmáluššat	ulmmálussjat	v
ulahit	uláhet	v
unnudit	unnudet	v
unnut	unnut	v
unohastit	unuhastet	v
urdit	urddet	v
urddistit	urdestet	v
urbmut	urmmut	v
urdnjut	urnnjut	v
uskkidit	uskedet	v
uštit	ussjtet	v
usket	ussket	v
uvhridit	uvhredet	v
uvjet	uvjjet	v
uŋggardit	uŋgardet	v
vadnát	vaddnát	v
vađđut	vaddut	v
vadjáluhttit	vadjáluhttet	v
vatnalahttit	vadnalahttet	v
vađustit	vadustet	v
vađastit	vadástet	v
vagŋát	vaggŋát	v
vakŋalahttit	vagŋalahttet	v
vakŋut	vagŋut	v
vahcut	vahtsut	v
vahágahttit	vahágahttet	v
vaháguhttit	vaháguhttet	v
vajahit	vajáhet	v
vajáldahttit	vajáldahttet	v
vajálduhttit	vajálduhttet	v
vaksit	vakset	v
vallet	vallet	v
valljut	valljut	v
vallut	vallut	v
valastit	valástet	v
vardát	varddát	v
vari^eret	vare^eret	v
varradit	varradet	v
varsut	varssut	v
varastit	varástet	v
vaŋket	vaŋkket	v
vaŋkát	vaŋkkát	v
vaŋaldahttit	vaŋáldahttet	v
vejolaštit	vejulasjtet	v
veivvet	vejvet	v
veivet	vejvvet	v
velgohit	velgguhet	v
vellehit	vellehet	v
veltet	velltet	v
venzet	venttset	v
verifi^eret	verefe^eret	v
verjet	verjjet	v
verdnet	vernnet	v
versifi^eret	verssefe^eret	v
vervet	vervvet	v
vevvet	vevvet	v
vižžet	vidtjet	v
veađđat	vieddat	v
veaddit	vieddet	v
veadjehahttit	viedjehahttet	v
veagal#váldit	viegal#válldet	v
viegaldahttit	viegaldahttet	v
veaguhit	vieguhet	v
viehkalahttit	viehkalahttet	v
veahtit	viehtet	v
veahttadit	viehttadet	v
veajahahttit	viejahahttet	v
veajehit	viejehet	v
veajihit	viejehet	v
veaigut	viejggut	v
veaisidit	viejssedet	v
veajuiduhttit	viejujduhttet	v
vealahit	vielahet	v
vielgalahttit	vielggalahttet	v
vealgut	vielggut	v
vielgát	vielggát	v
vealtadit	vielltadet	v
vealtit	vielltet	v
vealčalahttit	vielttjalahttet	v
vealčut	vielttjut	v
vealuhit	vieluhet	v
veardidit	vierddedet	v
viergat	vierggat	v
vearjudit	vierjjudet	v
vearjjohuhttit	vierjuhuhttet	v
vearjjuhuhttit	vierjuhuhttet	v
vierradit	vierradet	v
vearuiduhttit	vierujduhttet	v
viessadit	viessadet	v
viesso#bassat	viesso#bassat	v
veastit	viesstet	v
veašidit	vietjedet	v
veažirdit	vietjerdet	v
vieččahaddat	viettjahaddat	v
vieččahallat	viettjahallat	v
vieccistit	viettsestet	v
veavdit	vievddet	v
vievgŋadit	vievgŋadet	v
vihkkehit	vihkkehet	v
vihkket	vihkket	v
vihkut	vihkut	v
vihahit	viháhet	v
viidut	vijddut	v
viidáset#fievrridit	vijddáset#fievredet	v
viidne#juhkat	vijnne#juhkat	v
viiset	vijsset	v
viisudit	vijssudet	v
viisut	vijssut	v
vikšadit	viksjadet	v
vikšet	viksjet	v
vikari^eret	vikáre^eret	v
vilggodahttit	vilgudahttet	v
vildadit	villdadet	v
vildudit	villdudet	v
vinšet	vinsjet	v
vintet	vinttet	v
virgái#bidjat	virggáj#bidjat	v
virgái#nammadit	virggáj#nammadet	v
virkkosmahttit	virkusmahttet	v
virradit	virradet	v
virtet	virttet	v
visu^aliseret	viso^aleseret	v
vispet	visspet	v
vistit	visstet	v
visostit	visustet	v
vitkat	vitkat	v
vuhtii#váldit	vuhtij#válldet	v
vuigestit	vujggestet	v
vuiget	vujgget	v
vulos#dásástit	vulus#dásástet	v
vuoddját	vuoddját	v
vuodjalahttit	vuodjalahttet	v
vuodjilahttit	vuodjelahttet	v
vuodjut	vuodjut	v
vuodjálahttit	vuodjálahttet	v
vuođuštit	vuodusjtet	v
vuogáidahttit	vuogájdahttet	v
vuogáiduhttit	vuogájduhttet	v
vuohkadit	vuohkadet	v
vuohppát	vuohppát	v
vuohčut	vuohtjut	v
vuohttit	vuohttet	v
vuohttut	vuohttut	v
vuohttát	vuohttát	v
vuojahit	vuojahet	v
vuojaldahttit	vuojaldahttet	v
vuojehit	vuojehet	v
vuojihit	vuojehet	v
vuojestit	vuojestet	v
vuoigadahttit	vuojggadahttet	v
vuoigadit	vuojggadet	v
vuoigatvuođa#vuođđudit	vuojggatvuoda#vuoddudet	v
vuoimmehuhttit	vuojmehuhttet	v
vuoisat	vuojssat	v
vuoittahahttit	vuojtahahttet	v
vuoittahallat	vuojtahallat	v
vuoittehahttit	vuojtehahttet	v
vuoittihahttit	vuojtehahttet	v
vuoitit	vuojttet	v
vuoittáhallat	vuojtáhallat	v
vuojuhit	vuojuhet	v
vuojádit	vuojádet	v
vuoiŋŋidit	vuojŋedet	v
vuoksit	vuokset	v
vuolggestuvvat	vuolgestuvvat	v
vuollel#árvvoštallat	vuollel#árvusjtallat	v
vuollái#sárggastit	vuolláj#sárgastet	v
vuollái#sárget	vuolláj#sárgget	v
vuollái#sárgut	vuolláj#sárggut	v
vuollái#sázastit	vuolláj#sátsástet	v
vuollái#čállit	vuolláj#tjállet	v
vuollánahttit	vuollánahttet	v
vuollástit	vuollástet	v
vuolšudit	vuolssjudet	v
vuoluštit	vuolusjtet	v
vuordit	vuorddet	v
vuordát	vuorddát	v
vuorjat	vuorjjat	v
vuorkut	vuorkkut	v
vuordnut	vuornnut	v
vuorrástuhttit	vuorrástuhttet	v
vuođgŋit	vuorŋŋet	v
vuoššastit	vuossjastet	v
vuoste#beallái#gaskkustit	vuosste#bælláj#gaskustet	v
vuoste#hágostit	vuosste#hágustet	v
vuoste#jienastit	vuosste#jienastet	v
vuostá#čuožžut	vuosstá#tjuodtjut	v
vuostá#váldit	vuosstá#válldet	v
vuostái#váldit	vuosstáj#válldet	v
vuovdit	vuovddet	v
vuovgit	vuovgget	v
vuovssestuvvat	vuovsestuvvat	v
vuovssuhit	vuovsuhet	v
vuovzit	vuovttset	v
vurdet	vurddet	v
vurket	vurkket	v
vurtnoldahttit	vurnuldahttet	v
vustet	vusstet	v
váddudit	váddudet	v
váddut	váddut	v
vátnat	vádnat	v
vátnudit	vádnudet	v
vátnut	vádnut	v
vázzilahttit	vádtselahttet	v
vázzát	vádtsát	v
váfistit	váfestet	v
váhtit	váhtet	v
váhččet	váhttjet	v
váidit	vájddet	v
váidut	vájddut	v
váiddáhaddat	vájdáhaddat	v
váiddáhallat	vájdáhallat	v
váikkuhit	vájkuhet	v
váilut	vájlut	v
váinnuhit	vájnuhet	v
váiput	vájpput	v
váivvahit	vájvahet	v
váksat	váksat	v
vákset	vákset	v
vákšut	váksjut	v
vákšot	váksjut	v
vákšát	váksját	v
váksádit	váksádet	v
válddáhallat	váldáhallat	v
válddáhit	váldáhet	v
válgat	válggat	v
válget	válgget	v
váldit	válldet	v
válljet	válljet	v
vállut	vállut	v
válmmaštit	válmasjtet	v
válmmastit	válmastet	v
válbmet	válmmet	v
válset	válsset	v
vánastit	vánástet	v
várdahit	várddahet	v
várdudit	várddudet	v
várdát	várddát	v
váret	váret	v
várgehallat	várggehallat	v
várgehit	várggehet	v
várret	várret	v
várskuvet	vársskuvet	v
várskuvvet	vársskuvvet	v
várssuhit	vársuhet	v
várvet	várvvet	v
várát	várát	v
váttisin#dahkat	váttesin#dahkat	v
váccáldahttit	váttsáldahttet	v
váttásmahttit	váttásmahttet	v
vávjjahallat	vávjahallat	v
vávjit	vávjjet	v
vávjjáhallat	vávjáhallat	v
vávlet	vávllet	v
vávllostit	vávlustet	v
vávllustit	vávlustet	v
vávvát	vávvát	v
vovnnet	våvnet	v
vovdnet	våvnnet	v
veaddját	væddját	v
veagáiduhttit	vægájduhttet	v
veallát	vællát	v
veanzát	vænttsát	v
vearránahttit	værránahttet	v
veavvát	vævvát	v
xe^ro^graferet	xe^ro^graferet	v
xy^lo^graferet	xy^lo^graferet	v
ábbudit	ábbudet	v
ábbut	ábbut	v
ábuhit	ábuhet	v
áddehaddat	áddehaddat	v
áddehallat	áddehallat	v
áddestuvvat	áddestuvvat	v
áddet	áddet	v
áđđet	áddet	v
ádjit	ádjet	v
átnut	ádnut	v
áfáiduhttit	áfájduhttet	v
áhkoderet	áhkuderet	v
áhpegolgadit	áhpegolgadet	v
áhpáiduhttit	áhpájduhttet	v
áhpásmahttit	áhpásmahttet	v
áhpásmuhttit	áhpásmuhttet	v
áhtat	áhtat	v
áhtestuhttit	áhtestuhttet	v
áhcagahttit	áhtsagahttet	v
áhcut	áhtsut	v
áibadit	ájbbadet	v
áiddastit	ájdastet	v
áidut	ájddut	v
áiddohaddat	ájduhaddat	v
áiddohallat	ájduhallat	v
áiddostit	ájdustet	v
ájihit	ájehet	v
áige#ráddjet	ájgge#ráddjet	v
áigodahttit	ájggudahttet	v
áigut	ájggut	v
áigái#oažžut	ájggáj#oadtjut	v
áimmahuššat	ájmahussjat	v
áibmat	ájmmat	v
áidnet	ájnnet	v
áittardit	ájtardet	v
áiccahaddat	ájtsahaddat	v
áiccahallat	ájtsahallat	v
áiccalmahttit	ájtsalmahttet	v
áitit	ájttet	v
áicát	ájttsát	v
ákkastit	ákkastet	v
ákšuneret	áksjuneret	v
áktet	áktet	v
álkidahttit	álkkedahttet	v
álkidit	álkkedet	v
álkiduhttit	álkkeduhttet	v
álkkásmahttit	álkásmahttet	v
állestit	állestet	v
állet	állet	v
állát	állát	v
álmmastit	álmastet	v
álbmut	álmmut	v
álbmot#válljet	álmmut#válljet	v
áluhit	áluhet	v
álustit	álustet	v
áppuhit	áppuhet	v
árbestit	árbbestet	v
árbet	árbbet	v
árgudit	árggudet	v
árgut	árggut	v
árpmihit	ármehet	v
árbmát	ármmát	v
árpmoštit	ármusjtet	v
árpašuhttit	árppatjuhttet	v
árpet	árppet	v
árrit	árret	v
árvvus#atnit	árvus#adnet	v
árvvoštallat	árvusjtallat	v
árvvoštit	árvusjtet	v
árvvosmahttit	árvusmahttet	v
árvedahttit	árvvedahttet	v
árvidahttit	árvvedahttet	v
árvo#bidjat	árvvo#bidjat	v
árvádahttit	árvvádahttet	v
áradit	árádet	v
áráhaddat	áráhaddat	v
áráhallat	áráhallat	v
ášše#čuoččuhit	ássje#tjuottjuhet	v
ášše#čuoččáldahttit	ássje#tjuottjáldahttet	v
áššudit	ássjudet	v
áššut	ássjut	v
áššáiduhttit	ássjájduhttet	v
áššáskuhttit	ássjáskuhttet	v
ássut	ássut	v
ásustit	ásustet	v
ásahit	ásáhet	v
ásaiduhttit	ásájduhttet	v
áŧestahttit	átestahttet	v
áŧestit	átestet	v
áccáhuššat	áttsáhussjat	v
ávaštit	ávasjtet	v
ávildit	áveldet	v
ávjat	ávjjat	v
ávnnastit	ávnastet	v
ávdnidit	ávnnedet	v
ávdnet	ávnnet	v
ávžžuhit	ávtjuhet	v
ávžut	ávttjut	v
áŋggaštit	áŋgasjtet	v
áŋket	áŋkket	v
obbet	åbbet	v
obbát	åbbåt	v
obehit	åbehet	v
obstru^eret	åbstro^eret	v
ođđa#válljet	åddå#válljet	v
ođđasis#investeret	åddåsis#invvesteret	v
ođđasis#prentet	åddåsis#prenttet	v
ođđasis#organiseret	åddåsis#årggåniseret	v
ođasmahttit	ådåsmahttet	v
ođasmuhttit	ådåsmuhttet	v
ođasnuhttit	ådåsnuhttet	v
ođastuhttit	ådåstuhttet	v
ohpehit	åhpehet	v
ohcat	åhtsåt	v
oidit	åjddet	v
oktet	åktet	v
oktii#bidjat	åktij#bidjat	v
oktii#heivehit	åktij#hejvvehet	v
oktii#časkit	åktij#tjassket	v
oktii#ordnet	åktij#årnnet	v
oktii#ovttastahttit	åktij#åvtåstahttet	v
okto#ráđđet	åkto#ráddet	v
oktanahttit	åktånahttet	v
olestuvvat	ålestuvvat	v
olgehit	ålggehet	v
olgodit	ålggudet	v
olggos#addit	ålgus#addet	v
olggos#buktit	ålgus#buktet	v
olggos#golludit	ålgus#gålludet	v
olggos#oažžut	ålgus#oadtjut	v
olggos#oaidnit	ålgus#oajnnet	v
olggos#čállit	ålgus#tjállet	v
olggos#válljet	ålgus#válljet	v
olgguštit	ålgusjtet	v
oljet	åljjet	v
oldet	ålldet	v
ollestuvvat	ållestuvvat	v
ollet	ållet	v
ollahuhttit	ållåhuhttet	v
ollašuhttit	ållåtjuhttet	v
ollášuhttit	ållåtjuhttet	v
olmmožahttit	ålmutjahttet	v
oláhit	ålåhet	v
omardit	åmårdet	v
opereret	åpereret	v
opponeret	åppuneret	v
oppastahttit	åppåstahttet	v
opale^sceret	åpåle^sceret	v
or^ienteret	år^ientteret	v
ordet	årddet	v
organiseret	årggåniseret	v
ortnegis#doallat	årnegis#doallat	v
ortnet#ráŋggáštit	årnet#ráŋgásjtet	v
ordnet	årnnet	v
orrot	årrut	v
orrut	årrut	v
orustahttit	årustahttet	v
oskut	åsskut	v
ostet	åsstet	v
ožoldit	åtjuldet	v
oččohaddat	åttjuhaddat	v
oččohallat	åttjuhallat	v
ovdehit	åvddehet	v
ovda#láigohit	åvddå#lájgguhet	v
ovdan#bidjat	åvddån#bidjat	v
ovdan#buktit	åvddån#buktet	v
ovdan#divvut	åvddån#divvut	v
ovdan#doallat	åvddån#doallat	v
ovdan#čájehit	åvddån#tjájehet	v
ovdánahttit	åvddånahttet	v
ovddos#dikšut	åvdus#diksjut	v
ovddalgihtii#máksit	åvdålgihtij#mákset	v
ovet	åvet	v
ovtta#geardánahttit	åvtå#gærddánahttet	v
ovttaidahttit	åvtåjdahttet	v
ovttaiduhttit	åvtåjduhttet	v
ovttas#orrut	åvtås#årrut	v
ovttastahttit	åvtåstahttet	v
ovttastit	åvtåstet	v
eaiggáduššat	æjgádussjat	v
eallát	ællát	v
ealáskahttit	æláskahttet	v
ealáskuhttit	æláskuhttet	v
ealásmahttit	ælásmahttet	v
earáhuhttit	æráhuhttet	v
eaškálahttit	æssjkálahttet	v
eaškáluhttit	æssjkáluhttet	v
