tjilla	čilla	n
sjilla	šilla	n
dållå	dolla	n
nållå	nolla	n
gavlla	gavla	n
bievlla	bievla	n
jåvllå	jovla	n
ståvllå	stovla	n
juvlla	juvla	n
lávlla	lávla	n
tjála	čála	n
giehtatjála	giehtačála	n
vuollájtjála	vuolláičála	n
tjuokkestjála	čuokkisčála	n
vinjotjála	vinjučála	n
jåhtotjála	johtučála	n
leapma	liebma	n
liepma	liebma	n
doajmma	doaibma	n
museadoajmma	museadoaibma	n
gielladoajmma	gielladoaibma	n
stivrradoajmma	stivradoaibma	n
låssådoajmma	lossadoaibma	n
gássadoajmma	gássadoaibma	n
vuovddedoajmma	vuovdidoaibma	n
ámmátdoajmma	ámmátdoaibma	n
guovdásjdoajmma	guovddášdoaibma	n
lijmma	liibma	n
rijmma	riibma	n
tijmma	tiibma	n
filmma	filbma	n
videofilmma	videofilbma	n
tjuolmma	čuolbma	n
suodnatjuolmma	suotnačuolbma	n
varratjuolmma	varračuolbma	n
ruossjatjuolmma	ruoššačuolbma	n
mánnátjuolmma	mánnáčuolbma	n
hálmma	hálbma	n
málmma	málbma	n
pálmma	pálbma	n
sálmma	sálbma	n
čuopma	tjuobma	n
luopma	luobma	n
suopma	suobma	n
suormma	suorbma	n
gasskasuormma	gaskasuorbma	n
tjårmmå	čorbma	n
jupma	jubma	n
